なんだ、おまえたちは！	Who goes there!?		scene_01
ジェシー	Jessie		scene_01
今はもう神羅（しんら）をやめちまって俺たちの仲間ってわけさ	But he quit and is with us now.	今神羅俺仲間	scene_01
あんたたちの名前なんて興味ないね。どうせこの仕事が終わったらお別れだ	I don't care what your names are. Once this job's over…I'm outta here.	名前興味仕事終別	scene_01
【キャンセル】ボタン（初期状態では×）を押しながら方向ボタンを押せば速く走ることができる。遅れずについてこい！	Press the Directional buttons while pushing [CANCEL] to run.	初期状態押方向速走遅	scene_01
スイッチオン	Switch On.		scene_01
たのんだぜソルジャーさんよ！	Don't mess up SOLDIER-boy!		scene_01
この星は魔晄（まこう）エネルギーに満ちている。住民はその魔晄エネルギーを使って日々生活している	The Planet's full of Mako energy. People here use it everyday.	星魔晄満住民使日生活	scene_01
クッ……	@#&^%$!		scene_01
悪いけど興味がないな	It's not my problem.	悪興味	scene_01
ビッグスがいないとコード解除できない	Can't decipher code without Biggs	解除	scene_01
サンキュー！	Thanks!		scene_01
はしごの前では【決定ボタン】を押して。そうすればはしごにつかまるわ。後は【方向キー】の上下で、のぼりおりするの	Push [OK] in front of a ladder to grab on to it. Then use the [Directional button] to climb up and down.	前決定押後方向上下	scene_01
ジェシーがまだあがって来てないんだ！	Jessie still isn't back yet!	来	scene_01
オレ？　オレは見張らせてもらう。おまえさんがおかしなマネをしないようにな	Jus' do it! I gotta watch to make sure you don't pull nothin'.	見張	scene_01
…………うした？	What's wrong?		scene_01
本格的にやってくるぜ	Heads up, here they come!	本格的	scene_01
爆発　１０　分前	Ten minutes to detonation!	爆発分前	scene_01
残り　１０　秒	Ten seconds remaining	残秒	scene_01
残り　２　秒	Two seconds remaining	残秒	scene_01
……TIFA	…TIFA.		scene_01
わかってるさ。あんたは俺の見張りだろ？	I know. You're my chaperon‚ right?	俺見張	scene_01
急ぎましょう、CLOUD	Let's hurry‚CLOUD.	急	scene_01
８番街	Sector 8	番街	scene_01
金の話なら無事にアジトに帰ってからだ	If it's about your money, wait 'til we get back.	金話無事帰	scene_01
逃げたほうがいい	You'd better get out of here	逃	scene_01
花なんて、めずらしいな	Don't see many flowers around here	花	scene_01
もらおう	Buy one		scene_01
はい！	Here you are!		scene_01
いったい何がおこったって言うのよ	Just what the hell's going on!?	何言	scene_01
魔晄は星の命！	Mako is the Planet's life source!	魔晄星命	scene_01
兵士	Soldier	兵士	scene_01
こっちだ！！	Over here!!		scene_01
たわごとを……よし捕らえろ！！	Enough babbling… Grab him!!	捕	scene_01
めんどくさいから逃げる	Later!	逃	scene_01