CLOUDさんこなかったっすね	CLOUD never came.		scene_02
なあ、CLOUDってさ…最後まで、おれたち…アバランチのために戦ってくれんのか？	Say, do you think CLOUD's… going to stay on and fight for AVALANCHE!?	最後戦	scene_02
あ、BARRETさん俺たちの給料……	Hey, BARRET! What about our money?	俺給料	scene_02
おい！　遅刻野郎！！	You damn right, you're late!!	遅刻野郎	scene_02
心配させやがって勝手な野郎だ！	Havin' everyone worried like that. You don't give a damn 'bout no one but yourself!	心配勝手野郎	scene_02
おい、おめえら！	Wake up!		scene_02
あぶないから閉めとくね	Careful, I'll shut this.	閉	scene_02
ああ……	Yeah…		scene_02
感謝などされても困る。これも仕事のうちだからな	It bugs me when you thank me. It's just a part of my job.	感謝困仕事	scene_02
このまま、スイッチをお切りください	Shut-off the switch in this position.	切	scene_02
失敗３回目	3rd failure	失敗回目	scene_02
ミッドガル発最終列車	Last Train from Midgar	発最終列車	scene_02
空中に浮かぶ都市か……。おちつかない風景だな	A floating city… Pretty unsettling scenery.	空中浮都市風景	scene_02
あのくさったピザのせいで下の人間がどんなに苦しんでることか……	It's 'cuz of that &^#$# 'pizza' that people underneath are sufferin'!	下人間苦	scene_02
おかげで土地は枯れる一方だ。空気をきれいにする力もなくしちまった	Thanks to that, the land is dying.	土地枯一方空気力	scene_02
わかってるさ…。好きでスラムに住んでるやつなどいない	I know… no one lives in the slums because they want to.	好住	scene_02
ミッドガル列車路線図ディスプレイ。二人で見ればきっと楽しいと思うの。私、説明してあげるね	It's a map of the Midgar Rail System. Let's look at it together. I'll explain it to you.	列車路線図二人見楽思私説明	scene_02
今度、私の手作り作品をプレゼントしちゃおうかな	Next time, I'll make one just for you.	今度私手作品	scene_02
うん、じゃ、腕によりをかけてドッカ～ンと制作するわ	Okay, then I'll put a little extra effort in and make it with a BANG.	腕制作	scene_02
ひそひそ……（暗くなるからチカンが多いのよ。ＩＤ検知エリアは……）	…whisper…whisper… (When the lights go off, you never know what kind of creeps'll come out.)	暗多検知	scene_02
さすがにつかれたよ。駅に着くまで、眠らせてくれ	…YAWN…that sure took its toll on me. I'm gonna sleep till we get to the station.	駅着眠	scene_02
俺にも明るい未来がまってるっすよね？	Don't ya think I got a bright future ahead of me?	俺明未来	scene_02
でも、アバランチにはいって、星の生命を救えばこんな俺でも……いろいろとね	But, after joinin' AVALANCHE and tryin' to save the Planet, I feel like I can do lots of things.	星生命救俺	scene_02
さ、CLOUD！こっちむいて	CLOUD! Look over here.		scene_02
上のプレートは、地上から約５０Ｍ離れているの	The top plate is about 50 meters above ground.	上地約離	scene_02
そこから順番に２、３……８番魔晄炉まで	Then there's No. 2, No. 3 all the way up to the No. 8 Reactor.	順番魔晄炉	scene_02
ふぅ…、次はこれ！ほら、見て	Phew, look what's next! Look!	次見	scene_02
各通過ポイントにはＩＤ検知エリアが設置されてるの	Each checkpoint has an ID sensor device.	各通過検知設置	scene_02
おう！！みんな、集まれ！！	Yo!! Get over here, all'ya!!	集	scene_02
アジトに集合だ！！いくぞ！	Meet back at the hideout!! Move out!	集合	scene_02
ダメだったっす。俺たちには、できないっす	We can't do it. We just can't do it.	俺	scene_02
みんなでお休みとって温泉でもいかない？	Why don't all of us take a long vacation. Maybe we could go to a hot springs somewhere?	休温泉	scene_02
先のことなんか、わからないな	You never know what lies ahead.	先	scene_02
いけ！列車にのりこめ！	Go! Get on that train!	列車	scene_02
ともだちになることなんかねえんだ	Don't care 'bout bein' nobody's friend.		scene_02
いや、休暇が取り消しになっただけかもしれない。	No, I'm sure his leave was just canceled.	休暇取消	scene_02
AERISを安全なところへ。	Please take AERIS somewhere safe.	安全	scene_02
AERISを家に連れて帰ることにしたんだ。	So I took AERIS home with me.	家連帰	scene_02
でも、このあたり列車基場しかないし。オバケでるっていうし	There's only the train graveyard around here. And they say there's ghosts around too!	列車基場	scene_02
いいだろ？	Who cares?		scene_02
僕、もうたえられない	I've had it!	僕	scene_02
それじゃ…	Well then, shall we?		scene_02
出会い、別れ、よろこび、悲しみ……少々のことじゃおどろきません	People meeting, parting, joy, sadness… After a while, it doesn't even get to you anymore.	出会別悲少	scene_02
戦争中のことでしたね。あのころは、つらい場面が多かったです…	Back during the war, I remember there was a lot of painful scenes then.	戦争中場面多	scene_02
けがしないよう、お気をつけて。いってらっしゃい	You be careful not to get hurt. Come on back again, hear?	気	scene_02
７番街スラム	Sector 7 Slums	番街	scene_02
よし！！おめえら、先入ってろ！！	All right!! You losers go on ahead!!	先入	scene_02
幼なじみ？	Little baby?	幼	scene_02
ヘッ！！とぼけちゃってよ	Hey! Don't act like you don't know what I mean!		scene_02
開けないよ！！帰ってちょうだい	I'm not opening up. Go away!!	開帰	scene_02
酒かっくらいながら、ニュースを見てりゃよ。突然、店を追い出される。たまんねぇよなぁ！！	I was jes sittin' here drinkin', watchin' the news by myself. n' all of a sudden I get kicked outta the &*%$ store. What's up with that!?	酒見突然店追出	scene_02
知らないよ	No, what?	知	scene_02
事情通の私にいわせればね	Ya see, I keep on top of these things, an' if ya ask me…	事情通私	scene_02
爆破が真夜中だったから、まだいいわ。眠ってた人はそのまま目が覚めないだけね	If the explosion had been in the middle of the night, that woulda been one thing. At least the people coulda gone in their sleep.	爆破真夜中眠人目覚	scene_02
あっ！！ウヘヘヘヘ……やっぱ、かわいいなぁ。マイラブリーエンジェルちゃん…	Hey!! Heh heh heh… Say, you're kinda cute. Cutie pie…		scene_02
あなた、知ってる？	Did you hear?	知	scene_02
私は事情通のうえに、おせっかいだからいろいろ知ってるのよね	I'm not only informed, I'm kinda nosey too. Anyhow, I got the scoop.	私事情通知	scene_02
突然、お客を追い出してゴチャゴチャやってるの。なんか、あやしいのよ。火薬のにおいとかするのよね	Suddenly, they throw out a customer and start talking trash to him. It's strange, if you ask me. And that place always smells like gun powder.	突然客追出火薬	scene_02
そういえばよ。この７番街スラムにも街頭テレビがあったんだけどよ	Now that you mention it, there used to be an outside TV monitor here in the slums.	番街頭	scene_02
今日のニュースでもプレジデント神羅が出るだろうからよ	He was on again this morning, too, you know.	今日神羅出	scene_02
おい！！ちょっとまてよ！！-	SHHH!! Wait a minute!!		scene_02
いまはさ？	And now?		scene_02
なんで、俺じゃなくてお前にたのむんだよ	Why does she ask you n' not me?	俺前	scene_02
せいぜいあるのは、毎日お店に通ってお酒ついでもらったことぐらいさ	About all I got is the sake that she poured me everyday I went to the bar.	毎日店通酒	scene_02
そうかよ！！	Oh yeah!?		scene_02
やい！　幼なじみ！！TIFAちゃんを大切にな！	Hey! Childhood friend! You better take good care of TIFA!	幼大切	scene_02
それだけが、気がかりだなあ	That worries me the most.	気	scene_02
TIFAちゃんの幼なじみだなんてにくいにくい！	TIFA's childhood friend. That's a good one!	幼	scene_02
おっおい！マリンちゃんには手を出すなよ！！	H, hey!! Keep your mitts off of Marlene!!	手出	scene_02
神羅にだまされるな！魔晄エネルギーは永遠ではない！魔晄は星の命！いつか終わりがやってくる！星の救世主：アバランチ	Don't be taken in by the Shinra. Mako energy will not last forever. Mako is the life of the Planet and that life is finite. The end is coming. Saviors of the Planet:  AVALANCHE	神羅魔晄永遠星命終救世主	scene_02
ほら、マリン！CLOUDにおかえりなさいは？	Marlene! Aren't you going to say anything to CLOUD?		scene_02
ガマンした	Not this time		scene_02
ふ～ん。CLOUDもおとなになったのね。子供のころは、すぐケンカだったのに	Hmm. You've grown up. When you were little you used to get into fights at the drop of a hat.	子供	scene_02
でも……	But…		scene_02
マリン、あげる	Give it to Marlene		scene_02
マリン	Marlene		scene_02
おめえら！！会議をはじめっぞ！！	Get in here, fools!! We're startin' the meetin'!!	会議	scene_02
……CLOUDにもらったの	CLOUD gave it to me.		scene_02
ちゃんとお世話するからね	We'll take care of you.	世話	scene_02
いまはそんな気分じゃないな	I don't feel like it	気分	scene_02
お客さんだって、TIFAちゃんのつくるお酒はおいしいよっていってくれるんだから！	Everyone says my drinks taste the best!	客酒	scene_02
そうね……	I guess not…		scene_02
ねえ、CLOUD。気分はどう？	CLOUD. Are you feeling all right?	気分	scene_02
アバランチアジト	AVALANCHE Hideout		scene_02
ずいぶんと自信たっぷりじゃねえか	You sound pretty sure.	自信	scene_02
確かにおまえは強い	Yeah, you're strong.	確強	scene_02
俺は上で待っている。報酬の話がしたい	I'm going upstairs. I want to talk about my money.	俺上待報酬話	scene_02
だまれ！	Shut up!		scene_02
もしかして、俺、カタマってます？	You think I'm a little too uptight?	俺	scene_02
もしかして何も感じないとか？エヘヘ…そんなわけないっすよね	Or are you like, impervious to feelings? Naw, that couldn't be it.	何感	scene_02
CLOUDさん……ほんとは友だちほしいんっすよね	CLOUD… You just want friends.	友	scene_02
そうかなあ。なんか、さびしそうなんだけど	Yeah, well. You look kind of lonely to me.		scene_02
見てよ、このニュース……。こんなに爆発してる	Hey, look at the news… What a blast.	見爆発	scene_02
報酬……	Money…	報酬	scene_02
プレジデント神羅	President Shinra	神羅	scene_02
我々神羅カンパニーはこのような暴力からみなさんを守るためにソルジャーの投入を決定しました。これで……	I have immediately mobilized SOLDIER to protect our citizenry against this senseless violence. Thank you and good night.	我神羅暴力守投入決定	scene_02
【セーブポイント】	Save Point		scene_02
星が病んでるの。このままじゃ死んじゃう	The Planet is dying. Slowly but surely, it's dying.	星病死	scene_02
……壱番魔晄炉破壊事件に関してアバランチと名乗る組織から犯行声明が出されています。声明によるとアバランチは今後も同様のテロを続けることを予告しております。	The terrorist group called AVALANCHE has claimed responsibility for today's bombing of the No. 1 Mako Reactor. It is also predicted that they will continue with similar terrorist activities in the future.	壱番魔晄炉破壊事件関名乗組織犯行声明出今後同様続予告	scene_02
CLOUD、助けてくれるのね？	CLOUD, then you'll help us?	助	scene_02
そんなこと言いにきたの？	You came to tell me that?	言	scene_02
おはよ！　CLOUD！	Good Morning! CLOUD!		scene_02
ひそひそ……	…psst…		scene_02
マリン、お店たのむね！	Marlene, you watch the store while we're gone!	店	scene_02
ああ～！！仕事の後の一杯はこたえらんねぇなぁ	Aaah!! Nothin' like that first drink after a job.	仕事後一杯	scene_02
そうだな、もらおうか	Yeah, why not?		scene_02
元ソルジャーだからってお高くとまってんじゃねえぞ！	Don't act big-headed jus' because you were in SOLDIER!	元高	scene_02
あ、CLOUDさん！	Oh, CLOUD!		scene_02
お前の話なんて興味ないね	I'm not interested in your stories	前話興味	scene_02
CLOUDさん……。……いや、なんでもないっす	Oh well… forget it then.		scene_02
おれたち、ほんとは不安なんだ。ソルジャーが出てきたらおれたち、みんなやられちまう	We're really unstable right now. If SOLDIER were to show up, they'd whoop us.	不安出	scene_02
どうなってる……？やけにゆれるな……	What's goin' on? It's really shakin' a lot…		scene_02
あ～あ！本当に行っちゃうんだ！	So! You're really leaving!?	本当行	scene_02
……わるいな	…Sorry		scene_02
思い出して……CLOUD。あれは７年前よ……	Remember? CLOUD, it was seven years ago…	思出年前	scene_02
ああ……あの時か	Yeah…back then.	時	scene_02
俺……春になったら村を出てミッドガルへ行くよ	Come this Spring…I'm leaving town for Midgar.	俺春村出行	scene_02
セフィロスみたいな最高のソルジャーに	I'm going to be the best there is, just like Sephiroth!	最高	scene_02
ね、それより約束は？	But, what about our promise?	約束	scene_02
大活躍したら新聞にものるかな？	If you make it, will you be in the newspapers?	大活躍新聞	scene_02
CLOUD、私を助けに来てね	you'll come save me, all right?	私助来	scene_02
ハハハハ！なんだよ、それ！	Ha, ha, ha! What's that?		scene_02
俺は英雄でも有名でもない。約束は……守れない	I'm not a hero and I'm not famous. So I can't keep our promise.	俺英雄有名約束守	scene_02
こんな、しけた報酬じょうだんじゃないな	This is my pay? Don't make me laugh.	報酬	scene_02
いいからいいから	It's OK, it's OK.		scene_02
標的は【五番魔晄炉】だ。まず、駅へ行く	Our target's the Sector 5 Reactor. Head for the station first.	標的五番魔晄炉駅行	scene_02
おう！　おかしなマネをしたら……わかってんだろうな	Yo! If you pull somethin' funny… you now what I'll do to ya, right?		scene_02
おう！　CLOUD！	Yo! CLOUD!		scene_02
さて……	…sigh…		scene_02
まあ、いいだろう。あとで、ジェシーにでも聞いておくからな。だがな、マテリアはおまえが管理しろ！	Ok. I'll ask Jessie again later. But you're in charge of the Materia!	聞管理	scene_02
CLOUD！武器屋２階のおじさんから伝言よ	CLOUD! I got a message from the Weapon Shop man upstairs.	武器屋階伝言	scene_02
７番街・道具屋	Sector 7 Item Store	番街道具屋	scene_02
おっ！！こりゃこりゃ！こりゃ、めずらしい。あんた、まさか客かね？	Oh!! Look at this! This doesn't happen everyday. Are you…a customer?	客	scene_02
７番街・武器屋１階	Sector 7 Weapon Shop	番街武器屋階	scene_02
俺に話しかけるってことは、しろうとだな？	Anyone talking to me must be a novice.	俺話	scene_02
俺は元ソルジャーのCLOUDだ。おまえに用などない	The name's CLOUD. Used to be with SOLDIER, I got no business with you.	俺元用	scene_02
てへへ…一晩じゃ、おぼえきれんぜ。おう！素人！！悪いが、二階のあいぼうから教わってくれ	Heh heh…He'll forget about it. OH, you!! Get my friend on the second floor to teach ya.	一晩素人悪二階教	scene_02
オレみたいにタフな男の子になりたかったらいかす武器を選ぶこったな	You wanna be tough like me? Then you gotta pick out some good weapons.	男子武器選	scene_02
金渡す	Give him some	金渡	scene_02
オレの姉キは美人だぞ！！おっさん！！	Hey old guy! I got a good-lookin' sister!!	姉美人	scene_02
それにはひとつ条件があるぜ	There's just one condition.	条件	scene_02
チッ！！　おっさん。この話はなかったことにしてくれ	Damn, man!! Just forget about it!	話	scene_02
すきなベッドで休んでいきな。いい夢見なよな、おっさん	Use whatever bed you want. Sleep tight, old guy.	休夢見	scene_02
ベッドを見たら眠くなってきただろ	Doesn't just seeing the bed make you sleepy?	見眠	scene_02
これがタフに生きてく基本だぜ！おっさん、覚えときな	That's the trick to being tough. Remember that, old dude.	生基本覚	scene_02
７番街・武器屋２階	Sector 7 Slums, Weapons Shop Floor 2	番街武器屋階	scene_02
また、その話か	What, that again?	話	scene_02
おもてむきは、反神羅がどうしたとかって声明がでてるらしいがよ。真相はな……	On the surface they say they're an anti-Shinra group, but in reality…	反神羅声明真相	scene_02
笑わせてくれるじゃねぇか！？上でゴタゴタやってくれりゃよ。武器屋としては大助かりってやつよ	That's a good one, ain't it!? While they're bustin' things up on top, the only ones makin' out good are us weapon stores!	笑上武器屋大助	scene_02
オレの仕事わかります？わかんねえだろ～な	You know what I do? I'll bet you don't.	仕事	scene_02
まいどおなじみ初心者の館だよ～ん！	This is the Beginner's Hall.	初心者館	scene_02
記録を残すには？	How to save?	記録残	scene_02
マテリアの装着	How to apply Materia?	装着	scene_02
リミット技の使い方	About Limit status?	技使方	scene_02
せこいなあ、元ソルジャーさん。そらポーションの一個くらい、さしあげますぜ	You're a stingy one. Here, I'll give you ONE Potion.	元一個	scene_02
指示があるまで、ディスクホルダーを開けたり他のものと取りかえたりするな	Until you get instructions, don't open or take discs out of the CD drive.	指示開他取	scene_02
『ぜんたいか』のマテリアを手にいれた！	Received "All" Materia!	手	scene_02
いいですか？こ～んな【たからばこ】にはお得なアイテムがかくされてます	Now listen, hidden in these treasure chests are a lot of items.	得	scene_02
ほんとは、もうひとつあるんだけどいまは秘密♥　楽しみに待っててね♥	You can also do something else there, but right now it's a secret.	秘密楽待	scene_02
ただいま、ごしょうかいにあずかりましたあっしが【セーブポイント】でござんす！旅先行き先先々でお目にかかることと思いますが今後ともよろしゅうおねがいもうしあげます！	That should be all you need to know about the Save Point. I'll probably see you again somewhere down the road. Take care!	旅先行目思今後	scene_02
なにを教えてほしいんだ？	What do you want to know?	教	scene_02
【逃げる】について	About [Escape]	逃	scene_02
【ヘルプ】について	About [Help]		scene_02
メニューのコンフィグでＡＴＢを【ウェイト】にすると……戦闘中、魔法やアイテムを選んでいる間時間が止まる	Select [Wait] from ATB on the Config Menu and time will stop when you select magic or items during battle.	戦闘中魔法選間時止	scene_02
俺はいつでも【アクティブ】だが気にするな、好きなものを選ぶといい。以上だ	Personally, I always use [Active], but you can use whichever you like.	俺気好選以上	scene_02
後列にすると受けるダメージが減るが、攻撃力も減る。【チェンジ】は、戦闘コマンドを選ぶときに【方向キーの左】を押すと可能だ	In the back row, the damage received is less, but the attacking power is less.	後列受減攻撃力戦闘選方向左押可能	scene_02
俺は、戦闘中、【逃げる】ことなどめったにないから、くわしくは覚えていないが…おまえたちには必要だろう	I don't really remember ever having to use the [Escape] command… but you'll probably need it.	俺戦闘中逃覚必要	scene_02
ゲージがいっぱいになるとコマンドの入力が可能だがもし入力したくなければ、【△ボタン】で次のやつに順番をまわすこともできる。BARRETをこきつかいたい時などに便利だ	When the gauge is full, you can make your command. If you don't want to make one, push [MENU] and you can move to the next character. It's convenient when you wanna make BARRET work.	入力可能次順番時便利	scene_02
おまえたちは知らないだろうから、教えといてやる。【ステータス】に、【怒り】と【悲しい】という状態がある	You probably don't know about them, but there are conditions of [fury] and [sadness].	知教怒悲状態	scene_02
上のゲージは、なぐられ攻撃を防ぐ魔法【バリア】下のゲージは、魔法攻撃を防ぐ魔法【マバリア】	The top gauge displays [barrier] or magic defense against attacks. The bottom gauge displays [magic barrier] or defenses against magic attacks.	上攻撃防魔法下	scene_02
この俺の説明でもわからんようならしかたない。おまえたちの理解する能力がたりないようだ	Looks like you didn't get it the last time I told you. What's wrong with you? You touched in the head?	俺説明理解能力	scene_02
【全滅】か……俺の記憶にはないから、これは人から聞いた話だ	[wiped out]. This is one I've never personally used. But I heard from someone what it was about.	全滅俺記憶人聞話	scene_02
これまで説明したことと重なるかもしれんが代表的なものをまとめといてやる	I'll probably wind up repeating myself, but let me go over a few basic points.	説明重代表的	scene_02
かなしい　ダメージ低下。興奮剤でもどる。	Sadness Damage is decreased. Hyper will remedy it.	低下興奮剤	scene_02
マヒ　　　　タイムゲージ停止、コマンド入力不可	Paralyze Stops time gauges, commands.	停止入力不可	scene_02
【ステータス変化】はアイテムや魔法で直せるから物を買うときに確認しておくのがいいだろう	Your [Status] can be changed with magic and items, so you should check it whenever you buy things.	変化魔法直物買確認	scene_02
炎　　火の効果。けもの、氷のモンスターにきく。	Fire Fire effect. Works best on animals and water monsters.	炎火効果氷	scene_02
毒　　毒状態にする。もともと毒のヤツにはきかない。	Poison Poisons enemies. Doesn't work on any poison-based enemies.	毒状態	scene_02
聖　　星の力をよびおこす。暗黒のモンスターにきく。	Holy Calls up the Planet's power. Works well on dark monsters.	聖星力暗黒	scene_02
ポカポカポカポカ……！！	……smack……knock……!!		scene_02
よしっ、【リミットゲージ】はいっぱいだ！えんりょはいらない。【リミット技】で勝負だ！	OK! Now your limit gauge is full, go ahead and use it! Fight with your limit technique.	技勝負	scene_02
【リフレク】は魔法をはねかえすがはねかえす回数に制限があるから気をつけろ	[reflect] bounces the attacks off you. But the number of times you can use it is limited so be careful.	魔法回数制限気	scene_02
装備する武器や防具のしゅるいによってマテリアの成長のスピードはちがう	The type of Materia you put in your weapons and armor will determine how quickly your Materia grows.	装備武器防具成長	scene_02
俺を怒らせるな！	Listen kids, don't piss me off!	俺怒	scene_02
【方向キー】　　　　　　【ボタン】	[Directional button][CONTROL]	方向	scene_02
Ｌ１／Ｒ１ボタン：チョコッとまがる	[PAGEUP]/[PAGEDOWN]: turn.		scene_02
俺より目立つな……	Geez, you stand out even more than I do…	俺目立	scene_02
【ポジションカーソル】	[Position Cursor]		scene_02
これで、暗い夜道も険しい山道もご安心！なお、フィールドによっては表示されないことがあります。御注意ください。	These will help you safely make it through even the darkest streets or dangerous mountains! But, there are times when they won't appear, so be careful.	暗夜道険山安心表示御注意	scene_02
こうして家内と私、二人きりになってみるといやはや、さびしいものですなあ	When it's just my wife and I here, you have no idea how lonesome it gets.	家内私二人	scene_02
故郷はおありですかな？	Where are you from?	故郷	scene_02
故郷はね、知らんぷりをしていてもいつでも、あなたを待ってますよ	You may leave your home, but it'll always be there for you.	故郷知待	scene_02
当時は、最初の大きな魔晄炉事故ということですいぶん話題になりましたなあ	That was the first major Mako accident, I remember it was all over the news.	当時最初大魔晄炉事故話題	scene_02
俺は孤独なソルジャーだ	I'm just an ex-SOLDIER	俺孤独	scene_02
ハッハッ……。そろそろ、二人っきりにしてくれませんか	Well, would you mind leaving us alone?	二人	scene_02