ミッドガル８番街ステーション発最終列車～	Last train out of Sector 8 Station.	番街発最終列車	scene_03
おい！！こら……！！	Hey!! What's going on here?		scene_03
たのみますよぅ！！他のお客さんの迷惑になりますから…	Please!! Don't bother the other passengers.	他客迷惑	scene_03
しかし、魔晄炉爆破とは考えたよな。リーダーはさしずめ頭の切れるヤツだな。次は、何やるんだろな？	…Blowing up a Reactor… they sure put some thought into this one. They must have a real calculating leader. I wonder what they'll do next?	魔晄炉爆破考頭切次何	scene_03
また危ない人たちといっしょか。私もつくづく運がないな	…Hoodlums again. God, don't I just have all the luck?	危人私運	scene_03
どうなってる？	What's goin' on?		scene_03
ニュ、ニュースぐらい見てるだろ？アバランチの爆弾テロ予告があったんだ	You…you've seen the news, right? AVALANCHE says there'll be more bombings.	見爆弾予告	scene_03
わ、私は暴力にはくっしないぞ～。こ、この席だって、ゆずらない	I won't give in to violence… and I'm not giving you my seat either!	私暴力席	scene_03
ケッ！　落ちついた野郎だぜ！こっちのペースがくるっちまう…	@#$%! The hell you so calm? You're bustin' up my rhythm!	落野郎	scene_03
へヘ……有名か…	Heh heh… Famous…	有名	scene_03
しかたねえ……せ、説明してやるっ！	Alright…I'll tell ya!	説明	scene_03
今までのニセＩＤはもう使えねえ…	We can't use our fake ID's anymore…	今使	scene_03
よし、あと３分たったら列車から飛び降りる	Alright, in three minutes, we're jumpin' off this train.	分列車飛降	scene_03
あいにく、列車ではすわらない主義でね	Sorry, but I have a thing against sitting down in trains.	列車主義	scene_03
ヘッ！　元ソルジャーの物知りさんよ！五番魔晄炉のあたりは、くわしいんだろ！	Yo, Mr. Know-it-all, big time SOLDIER! You oughta know the area 'round the No. 5 Reactor, right!	元物知五番魔晄炉	scene_03
あら、BARRET！相手してあげましょうか？	Oh, BARRET! Are you mad because I'm not paying enough attention to you?	相手	scene_03
ま、いいわ。もっとそばにきて	It's all right. Come a little closer.		scene_03
各車両緊急チェックに入ります	A search of all cars will be conducted!	各車両緊急入	scene_03
まっずいことになっちゃったわ	We're in trouble.		scene_03
チッ！！　ウスノロッ！！ここまでか……	C'mon!! Hurry your slow ass up! That's it, huh?		scene_03
ん……？俺ん家来て、あいさつするのはあんただけ	Hmmm? You're the only ones that'll talk to me or come to my house.	俺家来	scene_03
フェニックスの尾を手にいれた！	Received "Phoenix Down"!	尾手	scene_03
車両１に未確認ＩＤ検知	Unidentified passengers located in Car #1	車両未確認検知	scene_03
警戒レベル１	Level 1 Warning	警戒	scene_03
さ、いそいで！！	Let's  hurry!!		scene_03
え……！いえない	Ugh! I'm not sure…		scene_03
おれたちは予定通り例のアレを実行する	We'll execute it just as we planned it.	予定通例実行	scene_03
作戦２にチェンジよ！	Changing to Plan 2!	作戦	scene_03
ぜんぜんっだめね！	That didn't do anything!		scene_03
車両２ドアロック完了	Car #2: Locked Down	車両完了	scene_03
おう！じゃますんな！	Hey, yo! Jus' keep the hell outta my face!		scene_03
列車のなかではおぎょうぎよくしてね	Please behave while you're in the train.	列車	scene_03
まちがいだ	My mistake		scene_03
ハイポーションを手にいれた！	Received "Hi-Potion"!	手	scene_03
車両２ロック完了	Car #2: Locked down	車両完了	scene_03
警戒レベル３	Level 3 Warning	警戒	scene_03
よし！！ぬけたか！？	Alright! We clear!?		scene_03
説明？　いいの？ＯＫ！！　まっかせといて	You want an explanation? OK!! Let me.	説明	scene_03
でも、旧式だけにちょろいもんよ	But it's an old system, we can get past it.	旧式	scene_03
ごめんなさい	I'm so sorry.		scene_03
こんどはもっとましなものプレゼントするわ。	I'll make a better one next time.		scene_03
もうすこしだったのに	We were almost there.		scene_03
車両３ドアロック完了	Car #3: Locked Down	車両完了	scene_03
ハァハァ……	…heave…breathe…		scene_03
さらば、グッバイ、アディオス！ミッドガル！！	Later…Goodbye…Adios, Midgar!!		scene_03
むぎゅ～～	urrrrrrrg		scene_03
そうだ	That's right		scene_03
目が覚めたら、すっぱだかで男３人だった気分！	All I know is, when I woke up, the 3 of us were butt-naked!	目覚男人気分	scene_03
ブルブルブル……	Brrrrrr…		scene_03
わかってるよ。いいたいこと	I know what you want to say.		scene_03
車両４ロック完了	Car #4: Locked Down	車両完了	scene_03
いくぜ！！こっからダイブだ！！	Let's go!! We're gonna dive outta here!!		scene_03
おふたりさん時間がないぞ！	Hey you two! There ain't no time for that!	時間	scene_03
リーダーは最後まで残るもんだ	A leader always stays till the end.	最後残	scene_03
わかるっすか？俺、ウェッジっす！	Guess who? It's me, Wedge!	俺	scene_03
私、ジェシーよ。どう、CLOUD？	It's me, Jessie. How do I look, CLOUD?	私	scene_03
……すてきだよ、男勝りで	…You look great, just like a man.	男勝	scene_03
おれ、一度でいいからこんな格好してみたかったんだ	I always wanted to dress up like this.	一度格好	scene_03
螺旋トンネル	Winding Tunnel	螺旋	scene_03
ゲームの状態を保存できます。	[SAVE] to save your game.	状態保存	scene_03
この光の帯は、神羅の警報センサー。これ以上、奥には進めないな	Those light beams are the Shinra's security sensors. We can't go any further.	光帯神羅警報以上奥進	scene_03
侵入者だ！	Intruders!	侵入者	scene_03
か～っ、せまっちい穴だな。ここからプレートの下にもぐれってのか？たまんねぇぜ	That's one damn tiny hole. You tellin' me to squeeze into that to get under the Plate? No way!	穴下	scene_03
おりない	Don't go		scene_03
入らねぇのか？ここを通る以外には、五番魔晄炉にいく方法はないんだぜ	Whaddya mean we're not goin' in? There ain't no other way of gettin' to the Sector 5 reactor 'cept through here.	入通以外五番魔晄炉方法	scene_03
よし、ここまでは予定通りだ	Good, so far everything's going as planned.	予定通	scene_03
まだ、オレたちが潜入したことはバレていないはずだ。五番魔晄炉まで一気に行けるぞ	They probably don't know we sneaked in yet. We'll be at the reactor in no time.	潜入五番魔晄炉一気行	scene_03
CLOUDさん、こっちっす。五番魔晄炉はこのハシゴの先っす	CLOUD, this way. The reactor's up this ladder.	五番魔晄炉先	scene_03
CLOUDのＩＤカード。私の特別製にしたから……	I modified your ID card… And that's what did it…	私特別製	scene_03
セフィロスね！	Sephiroth!?		scene_03
よし、行くぞ	Alright, let's go.	行	scene_03
こっちだ！	This way!		scene_03
プ、プレジデント神羅？	Pres…President Shinra?	神羅	scene_03
ひさしぶりだな、プレジデント	Long time no see, sir.		scene_03
CLOUD、だ	CLOUD.		scene_03
セフィロスだと……？	Sephiroth?		scene_03
キサマら神羅は、この星を死に追いやろうとする寄生虫じゃねぇか！その親玉であるキサマが何をえらそうにホザく！	Shinra're the VERMIN for killing the Planet! Guess that'd make you King VERMIN! So shu'up jackass!	神羅星死追寄生虫親玉何	scene_03
キミたちの遊び相手は別に用意させてもらった	But, I've made arrangements for a playmate for you all.	遊相手別用意	scene_03
待て、プレジデント！	Wait, President!	待	scene_03
これ、ソルジャーなの？	THIS is from SOLDIER?		scene_03
もうすぐ爆発する！行くぞ、TIFA！	It's gonna blow! Let's go, TIFA!	爆発行	scene_03
わかってる、TIFA	I know, TIFA…		scene_03
自分の心配でもしてろ！俺はいいからTIFAを！	You worry about yourselves! I'm all right, but take care of TIFA!	自分心配俺	scene_03
情けない声だすんじゃねえよ。悪いが何もしてやれそうにない。自分でなんとかしてくれ	Don't go cryin' like a woman. There ain't nothin' I can do for ya. Ya gotta do it on your own.	情声悪何自分	scene_03