……大丈夫か？	…You all right?	1
……聞こえてるか？	…Can you hear me?	2
…………ああ	…Yeah…	3
……どうだ？	…How about that?	11
ゆっくりな。少しずつ少しずつ……	Take it slow now. Little by little……	12
……わかってるさ	…I know.	13
ここ、スラムの教会。５番街よ	This is a church in the Sector 5 slums.	21
……落ちてきた	…I came crashing down?	22
屋根と、花畑、クッションになったのかな。運、いいね	The roof and the flower bed must have broken your fall. You're lucky.	23
……おぼえてないの？	Don't you remember me?	31
（会ったことがある……）	Yeah, I remember…	32
（たしか、初対面だ）	Never saw you before	33
でも、お花、買ってくれなかったね	You didn't buy any flowers from me though.	41
でも、お花、買ってくれたから許してあげる	But I forgive you, because you bought flowers from me.	42
な～んにも覚えてないんだ	I don't remember a thing.	43
身につけてると安心できるしお母さんが残してくれた……	I feel safe just having it. It was my mother's.	51
ね、いろいろ、お話したいんだけどどうかな？	Say, I feel like talking. Do you feel up to it?	52
せっかく、こうしてまた、会えたんだし……ね？	After all, here we are meeting again.	53
そういえば、まだだった	Now that you mention it…	61
おたがい、名前、知らないね	We don't know each other's names, do we?	62
わたしは……	My name is…	63
CLOUD！かまっちゃダメ！	CLOUD! Don't let it get to you!	71
タイミング、悪いなぁ	Sorry, bad timing on my part.	72
ねえ、CLOUD。ボディガードも仕事のうち？	Say, CLOUD. Have you ever been a bodyguard?	73
オレにかまうな、だと	Don't mind me.	81
もう少し、時間をやるぞ、と	I'll give you a little more time.	82
どこの誰だか知らないが……	I don't know who you are, but…	83
レノ	Reno	91
考え中だぞ、と	I haven't decided yet.	92
CLOUD、ダメ、やめて！	CLOUD, don't! Stop!	93
ま、いいかぁ。お仕事お仕事、と	Yeah, all right. C'mon, get to work.	101
あっ！	Oh!	102
お花、ふまないでね…だと	And don't step on the flowers…	103
タルを押しますか？	Push the barrel?	111
はい	Yes	112
いいえ	No	113
わかったわ。しっかり受け止めてね	Right. Make sure they don't get through!	121
古代種が逃げるぞ！撃て、撃て！、撃つな！	The Ancient is getting away! Attack! Attack! Attack!	122
やっちまったかな、と。抵抗するからだぞ、と	Think we killed 'em? They never should've fought us!	123
ぐわっ！	Guuagh!	131
ぶべっ！	Urkkk!	132
のわっ！	Nwahh!	133
そこの屋根の壊れたところから外に出ましょう	We'll get out through the hole in the roof.	141
倒れたハリ、つたって行けば屋根の上、出られるから	Jump off that beam, and we should be able to make it through to the roof.	142
教会	Church	143
それにウラじゃ汚いことをやっている	They're also involved in a lot of other dirty stuff on the side.	151
スパイ、殺し屋……いろいろだ	Spying, murder…you know.	152
そんな顔してるね	They look like it.	153
ハア……ハア……	Puff… …wheeze…	161
ひとりで……さきに……行っちゃうんだもん……	Slow…down… Don't leave me…	162
おかしいな……	Funny…	163
……ちょっと、ね	…Oh, nothing.	171
ちょっと……？	Nothing?	172
そ、ちょっと！	Right, nothing!	173
たいしてスリルもねえが、危険もねえ。店だけはあるから何かほしけりゃよってみな	No thrills, no danger. But there are a few stores so if there's something you want, stop by.	181
６番街スラムか……ヘヘヘ、男にとっちゃパラダイス、１度は行ってみるといい	Sector 6 slum…heh heh heh, A man's paradise. I've always wanted to go.	182
……ってことは、あんたみたいなおじょうさんには……ってとこさ。ま、別のお楽しみもあるかもな。ククク……	…But not for a nice girl like you… But there may be something else good for you. Heh, heh, heh.	183
しかも、いくら待ってもその女は２度と出てこないじゃありませんか！	I waited around a long time, but she never came out again!	191
やっぱりあそこはユーレイ教会……ブルブルブル……	I tell you, it's one of them …haunted churches! Ohhh…shiver…shake…	192
大地をゆるがす音とともに、７番街スラムの上にプレートが！	Then with a big rumble, the sector 7 plate came crashing down on the slum.	193
へんなんだよね、このドカンの中の人。何をきいても、ああとかううしか言わないんだよね	That guy in the pipe's a weird one. No matter what you ask him, he only answers 'uuh' or 'aahh'.	201
ドカン	Earthen Pipe	202
う……あ……あぁ……	ooh…aaah…ughhhh…	203
この星の終わりがジワジワ近づいてくるのを知りながら何もできないなんてさ	Even though they know the planet is on its last legs, there's nothing they can do about it.	211
私も、心を閉ざしてしまいたいよね……	I wish I could close myself off like that.	212
ここの人、どっかへ行っちゃったんだよね。フラフラ～っと……	These folks went wobbling off somewhere…	213
ウォールマーケットって知ってっかい？	You ever hear of Wall Market?	221
６番街スラムにあるマーケットさ。あそこに行けば何でもそろうんだけど途中の道がね……	It's a market in the slums of Sector 6. They've got everything you could ever want there.	222
へえ、そうかい。なら、そのうちオレの買い物もたのもうか……	Oh yeah? Then maybe I should have you pick something up for me next time you're there…	223
アイテム屋	Item Store	231
……ジロジロ…………フン、アイテムは金と引き換えだよ	Hmmm,… …hmph…we only trade items for gil here.	232
……ジロジロ……フン、金さえだしゃアイテムはやるよ。何があろうとね……	Hmmm,… …hmph…we only trade items for gil here. No matter what.	233
オットット！	Hey!	241
ひとんちのフリーザーを勝手に開けるなって、おっかさんに言われなかったかい？	Hey, didn't your mother ever teach you not to barge into houses and open up people's freezers?	242
武器屋	Weapon Store	243
……外がさわがしいな。何かあったのか？	…sure is loud outside. Wonder what's happening.	251
ブッブー！つぎはミッドガルミッドガルです	Toot toot! Next stop…Midgar Midgar.	252
お降りのお客様はブザーをならしてくださ～い！	Any passengers getting off at Midgar should please ring.	253
だがな、アバランチだかアバンチュールだか知らねえがあいつらも信用ならねえ	But you can't trust that AVALANCHE, or whatever you call them.	261
アレコレ言っててもけっきょく上の連中がうらやましいだけなのさ	You can bat it around all you like, but it all comes down to wanting to live like the people up there.	262
なら誰を信じるか？決まってんじゃねえか、俺だよ俺！俺は俺にウソをつかねえからな	So who do I believe in? Myself! Me! I never lie to myself, that's for sure!	263
そんな経験はございませんか？もうそんな心配はノー！	Have you ever had that happen? I hate it when that happens!	271
新発売のニュータイプエンジンシンラＶー３０００ですばらしいカーライフを！	A new standard in engines… the 'Shinra V-3000'. For the best drive of your car's life!	272
ニュースをおつたえします	And now for the news.	273
……ガー……ガ、ガガー……	……ga…… g, ga ga………………	281
民家２階	House 2f.	282
グーグー……	glug…glug…	283
……？	…….?	291
５ギル、か……	5 gil.	292
ぬすむ	Take it	293
エーテルターボを手にいれた！	Received "Turbo Ether"!	301
あっそ！ならいいよ、あとでたのんでも見せてやらないからな！	Oh yeah? Fine! But don't come crawlin' back here askin' to see it again, 'cause it ain't gonna happen!	302
ウォールマーケットですげぇディーラーになるのがおれのユメなんだ！	My dream is to grow up and become a big time dealer on Wall Market.	303
ぜんぜんかまわない	I don't mind	311
ダメ！	No it's not!	312
大切にな	Take good care of them.	313
あれっ？おねえちゃんは？	Hey! Where's the flower lady?	321
スラムの教会	church in the slums	322
ただいま、お母さん	I'm home, Mom.	323
ねぇ、これからどうするの？	So what are you going to do now?	331
……７番街は遠いのか？TIFAの店に行きたいんだ	…Is Sector 7 far from here? I want to go to TIFA's bar.	332
TIFAって……女の人？	Is TIFA…a girl?	333
７番街だったわね。私が案内してあげる	Let's see, Sector 7? I'll show you the way.	341
冗談じゃない。また危ない目にあったらどうするんだ？	You gotta be kidding. Why do you want to put yourself in danger again?	342
なれてるわ	I'm used to it.	343
うん、わかった、お母さん	Yeah, you're right, Mom.	351
AERIS、ベッドの準備をしておくれ	AERIS, please go make the bed.	352
７番街へは６番街を抜けていくの。６番街、ちょっと危険なところだから今夜はゆっくり休んでね	You need to go through Sector 6 to get to Sector 7. Sector 6 is a little dangerous so you'd better get some rest tonight.	353
あれ以来、かな	Ever since then.	361
本当に立派になってぇ	My, how you've grown.	362
そんなんじゃ、あれだね。女の子もほっとかないだろ？	I'll bet the girls never leave you alone.	363
そんな女の子がピッタリだと思うんだけどね	I think that would be best for you.	371
……興味ないな	I'm not interested.	372
……いつのまにか眠ってしまったのか	…I must've fallen asleep.	373
ソルジャーなんて……またAERISが悲しい思いをすることになる……	SOLDIER…the last thing AERIS needs is to get hurt again.	381
６番街をこえて７番街へ、か。一人でなんとかなりそうだな	Through Sector 6 to get to Sector 7. I should be able to do it alone…	382
の家	AERIS's House	383
この奥に７番街へのゲートがあるの	The gate to Sector 7's in there.	391
わかった。じゃあ、ここで別れようか。ひとりで帰れるか？	Thanks. I guess this is goodbye. You gonna be all right going home?	392
いや～ん、帰れない～！！って言ったらどうするの？	Oh no! What ever will I do!?' …Isn't that what you want me to say?	393
ちょっと休もっか	Can we take a break?	401
なつかしい、まだあったんだ	I can't believe it's still here.	402
CLOUD、こっち！	CLOUD, over here!	403
初めて好きになった人	My first boyfriend.	411
……つきあってた？	Were you…serious?	412
そんなんじゃないの。ちょっと、いいなって思ってた	No. But I liked him for a while.	413
あれに乗っていた人がTIFAさん？どこいくのかしら？それに、様子が変だったわね……	That girl in the cart was TIFA? Where was she going? She looked kind of odd…	421
まて！	Wait!	422
俺ひとりでいい！あんたは帰れ！	I'll go on alone! You go home!	423