なんだお前は？こんなところで何をしている？	The hell are you? What're you doin' around here?	前何	scene_08
ウーン、はやくもライバル出現……	And so another rival appears on the scene, eh?	出現	scene_08
いや～、このビルもそろそろあちこちにガタがきててなあ	You know, this building looks like it's starting to fall apart.		scene_08
ここはリフレッシュ・フロア。この上は、おえらがたがいる特別なフロアが多いからね	This is the lounge floor. Above us are the special floors for the company big wigs.	上特別多	scene_08
あいつ、遅いな……カードキー忘れたかな？	What's keeping her? Did she forget her keycard?	遅忘	scene_08
い、いろいろ？	Things?		scene_08
６０階から上は、役員クラスの社員の多い特別フロア。カードキーがないと入ることも許可されないの	The higher ups in the company use the floors above the 60th floor. But you can't get there without a keycard.	階上役員社多特別入許可	scene_08
でもね、カードキーにも何種類かあって、１枚でどこでも、ってわけにはいかないのよ	For example,	何種類枚	scene_08
神羅カンパニー	Shinra, Inc.	神羅	scene_08
科学部門資料室	Scientific Research Library	科学部門資料室	scene_08
ちなみにわたくしはミッドガルの助役です。困ったことがありましたらぜひわたくしに……	I am the Deputy Mayor. If you should have any questions feel free to ask me…	助役困	scene_08
とは言っても名前だけ。ホントのところ、ミッドガルのすべては神羅のものだ	Actually, I'm Mayor in name only. The city and everything in it is really run by Shinra, Inc.	言名前神羅	scene_08
そう、合言葉だ。それを言えたら、カードをやろう	Yes, that's it. Guess the password and I'll give you my keycard!	合言葉	scene_08
市長最高！！	BEST	市長最高	scene_08
魔晄爆発！！	MAKO	魔晄爆発	scene_08
市　　長　　最　　高　　！！	BEST!!	市長最高	scene_08
なんとすばらしいひびき！そのとおり！プレジデント神羅は最低！私こそミッドガルの主！	God, I love the sound of that! KING!! President Shinra sucks! I should be King of Midgar!	神羅最低私主	scene_08
なんとすばらしいひびき！そのとおり！魔晄エネルギーを爆発させろ！そして私を真の市長に！	God, I love the sound of that! MAKO! If I had a lot more of it, I would be a real Mayor!	魔晄爆発私真市長	scene_08
いいか、神羅はずっと私を苦しめてきたんだぞ	Shinra's been torturing me forever.	神羅私苦	scene_08
神羅め、この私を……この私を一般社員とおなじあつかいに……	Can you believe how they treat me? …ME! Like some common employee…	神羅私一般社員	scene_08
そういうことならわたくしがお手伝いしましょう	Maybe I can help you.	手伝	scene_08
助けなどいらない	Get out of my face	助	scene_08
ハイハイ。何がお望みで？	What can I do for you?	何望	scene_08
ええ、いいですとも。いいですとも	Sure, sure. All right.		scene_08
金をだそう	Give him the money	金	scene_08
……５０００ギルで	…for 5000 gil.		scene_08
今どきスラムの道具屋だってツケはききませんよ……	No one works on credit nowadays… not even stores in the slums.	今道具屋	scene_08
これはこれは…… ありがとうございます。	Oh, my…well, Thank you very much.		scene_08
資料室の名前はドアの横のプレートに書いてあります	The name of each library is written on the plaque outside the door.	資料室名前横書	scene_08
各部屋にまぎれこんでいる資料の名前を、その数字と見くらべてください	Look at the number on the files that don't belong in that library. Match the number with the letters in the title of the file.	各部屋資料名前数字見	scene_08
もしプレジデント神羅に会っても、わたくしのことは言わないでくださいよ	If you run into President Shinra, please don't tell him about this.	神羅会言	scene_08
『ぞくせい』のマテリアを手にいれた！	Received "Elemental" Materia!	手	scene_08
いいだろう、これをうけとりたまえ	Fine then, take this.		scene_08
やはり頭を使うのは苦手かね？	You all really don't use your heads much, do you?	頭使苦手	scene_08
都市開発部門	Urban Dev. Library	都市開発部門	scene_08
２　神羅プレート都市の 設計とその間題点	2 Problems with Plate construction in Midgar	神羅都市設計間題点	scene_08
１　魔晄兵器の長期使用に 関する特別規定	24 Ranks and extended use of Mako weaponry	魔晄兵器長期使用関特別規定	scene_08
１　　ジェノバプロジェクト 経過報告書 神羅カンパニー科学部門	4 The Jenova Project	経過報告書神羅科学部門	scene_08
３　新都市建設計画書	8 New plans for Urban Planning	新都市建設計画書	scene_08
４　生物の爆発的進化と 魔晄エネルギー ６　地上生物の最終進化論 	8 Final evolutionary stages in land dwelling life	生物爆発的進化魔晄地上最終論	scene_08
４　　宇宙開発部門 栄光の歴史　下巻	19 Modern history of the Midgar Space Dev Program Vol. 2	宇宙開発部門栄光歴史下巻	scene_08
６　神羅ロケットエンジンと 大陸間航行機	7 Economic report: Space Dev Program	神羅大陸間航行機	scene_08
１　神羅特別治安維持法 ハイデッカー私案	1 Breakdown of SOLDIER members by class	神羅特別治安維持法私案	scene_08
ここは宇宙開発部門資料室です。 各資料室の場所については 部屋の前にあるプレートを ごらんください。	This is the Space Dev Research Library. Click on the plate in front of each library to see which it is.	宇宙開発部門資料室各場所屋前	scene_08
５　　マテリアの製造および その軍事的利用に関する権利	3Special peace keeping law	製造軍事的利用関権	scene_08
４　　　ガストファイルβ 生物博士ガスト・ファレミス	4File on Dr. Gast, biologist	生物博士	scene_08
ピピッ……このドアをあけまスか？	…beep…beep… Open the door?		scene_08
Ｂランク社員ト確認。アナタは、このフロアのドアを３回まで開けルことが許可されましタ	Level B employee: verified. You are permitted to open doors on this floor up to three times.	社員確認回開許可	scene_08
ピピッ……コマンドを入力してくだサい	…bing…bing… Enter command	入力	scene_08
Ａクーポン……『星のペンダント』Ｂクーポン……『フォウスロット』Ｃクーポン……マテリア『ぜんたいか』	A coupon…'Star Pendant' B coupon….'Four Slots' C coupon….'All' Materia	星	scene_08
ピピッ……もう一度ハジメからやりなおしまスか？	…bing…bing… Start again from the beginning?	一度	scene_08
アナタは、このフロアのドアを３回まで開けルことが許可されましタ	You are permitted to open any door on this floor up to three times.	回開許可	scene_08
『きんのすなどけい』を手にいれた！	Received "Hourglass"!	手	scene_08
通気ダクトか……	An air-duct…	通気	scene_08
キーアイテム『Ｂクーポン』を手にいれた！	Received Key Item "B Coupon "!	手	scene_08
マテリア『ぜんたいか』をＣクーポンにもどしましタ	Your 'All' Materia was returned for a C Coupon.		scene_08
ビジターの方でございますね。あいているマシンはご自由にご利用ください	You must be a visitor. Feel free to use any open machine.	方自由利用	scene_08
グーゴー……たのむ……からゆっくりねかせてくれ……	…zzz… Please…let me… get some…rest…		scene_08
カギがかかっている……	Locked…		scene_08
神羅カンパニー修理課	Shinra Company Repair Management Department	神羅修理課	scene_08
……何もでてこないな	…Nothing…	何	scene_08
ちょっと、なにするんですか！乱暴はやめてください！	Sir, what are you doing!? No violence here, please!	乱暴	scene_08
バカバカしい	This is so stupid		scene_08
ほんのすこし身が軽くなったような……気がするな	I think I feel a little lighter… Maybe just a bit…	身軽気	scene_08
……なにかが開いたような音がしたな……	…Sounds like something opened up…	開音	scene_08
関係ないけどよ。 あの会議室って、何か臭くないか？ どこかから臭ってくるんだよな…… 	Is it just me or does the Conference Room smell? There's some sort of stench coming from somewhere…	関係会議室何臭	scene_08
さあ、私たちで魔晄の未来をつくるのよ！	Come on, we're building the future of Mako!	私魔晄未来	scene_08
すでに稼動していた工場部分と現在までの投資額を考えると我が社の損害は100億ギルはくだらないかと……	Considering those factories we already set up and all the investments, the damage is estimated at approximately 10 Billion gil…	稼動工場部分現在投資額考我社損害億	scene_08
７番プレートはこのまま放っておく	We're leaving Sector 7 as it is.	番放	scene_08
それから各地の魔晄料金を15％値上げしたまえ	I want you to raise the Mako rates 15% in every area.	各地魔晄料金値上	scene_08
いいないいな！	Oh man!		scene_08
ガハハハハ！	Ha ha ha!		scene_08
宝条	Hojo	宝条	scene_08
だから古代種を繁殖させようと思うのだ。しかも、長命で実験に耐えうる強さを持たせることができる	That's why we're thinking of breeding her. Then we could create one that could withstand our research for a long time.	古代種繁殖思長命実験耐強持	scene_08
わかんねえ	I dunno.		scene_08
臭うわね……	Something stinks…	臭	scene_08
登ってみようか？	Climb up?	登	scene_08
あの宝条ってやつ。神羅の科学部門の責任者だ。CLOUD、知らねえのか？	That Hojo guy. He's in charge of the Shinra's Science Department. CLOUD, don't you know him?	宝条神羅科学部門責任者知	scene_08
かわいいサンプルよ……	My precious specimen…		scene_08
ジェノバ…… セフィロスの…… そうか……ここに運んだのか	Jenova… Sephiroth's… So…they've brought it here.	運	scene_08
動いてる……生きてる？	It's moving……still alive?	動生	scene_08
AERIS？ ああ、この娘の名前だったな。何か用か？	AERIS? Oh, is that her name? What do you want?	娘名前何用	scene_08
世の中にはどうでもいいことが多いのでな	There's so many frivolous things in this world.	世中多	scene_08
そうそう。こういう時こそ論理的思考によって 行動することをおすすめするよ	That's right. I recommend you think things out logically before you make any rash moves.	時論理的思考行動	scene_08
私が手を貸さないと この種の生物は滅んでしまうからな	If I don't help, all these animals will disappear.	私手貸種生物滅	scene_08
ええい！！ さがってろ！	Awright!! Step back!		scene_08
今のうちにAERISを！	Now's our chance to get AERIS!	今	scene_08
[NO LINE FOUND]	Oh shit… We're surrounded.		scene_08
あの化け物は俺たちがかたづける	We'll take care of that monster.	化物俺	scene_08
AERIS、だいじょうぶか？	AERIS, you all right?		scene_08
興味深い問いだ。しかし、その問いは答え難いな。私は見てのとおり、こういう存在だ	An informed question. But difficult to answer. I am what you see.	興味深問答難私見存在	scene_08
さあ、AERISを助ければもうこんなビルには用はない！ さっさと出ちまおうぜ	Now we've saved AERIS, ain't no need to be in this buildin'! So let's get the hell outta here!	助用出	scene_08
あとでな！　【66階エレベーター】で合流だ！	Later! Meet up at the 66th Floor Elevator!	階合流	scene_08
どこ行くんだい？【６６階エレベーター】でみんな待ってるぜ	Where you goin'? Everyone's waitin' at the 66th Floor Elevator.	行階待	scene_08
お、おい！　何だ？	H, hey! What is it?	何	scene_08
スリリングな気分をあじわえたと思うが……楽しんでもらえたかな？	This must've been a real thrill for you… Did you enjoy it?	気分思楽	scene_08
あれは貴重な古代種の生き残りだからな	She's the last surviving Ancient…	貴重古代種生残	scene_08
約束の地？それは言い伝えではないか？	The Promised Land? Isn't that just a legend?	約束地言伝	scene_08
魔晄エネルギーだな！	then there's gotta be Mako!	魔晄	scene_08
ケッ！夢みてんじゃねえよ！	@$#*^%! Quit dreamin'!	夢	scene_08
何かあるなら……秘書をとおしてくれたまえ	If there's anything else… talk to my secretary.	何秘書	scene_08
AERISはどうしてるかな	I wonder how AERIS is doing		scene_08
ヒソヒソ(弱気にならないでよ！	Psst (Don't give up!)	弱気	scene_08
でも、約束の地ってのは 言い伝えに出てくるだけで 本当にあるのかどうかはわからねえ	I only heard stories 'bout the Promised Land. I don't know if it really exists.	約束地言伝出本当	scene_08
……そこも土地が枯れちまうな。星が……病んでいくわけだ	…and the land'll wither away. The Planet's gonna get weaker.	土地枯星病	scene_08
つまんねえやろうだぜ	You're so damn boring.		scene_08
いや、べつに……へへへ	Nothin'……ha, ha		scene_08
きっと、CLOUDが来てくれるって思ってた	I knew that CLOUD would come for me.	来思	scene_08
……！？　TIFA！ TIFAもそこにいるの！	…!? TIFA! TIFA, you're there too!		scene_08
約束の地って本当にあるの？	Does the Promised Land really exist?	約束地本当	scene_08
『セトラの民、約束の地へ帰る。至上の幸福、星が与えし定めの地』	The Cetra will return to the Promised Land. A land that promises supreme happiness.	民約束地帰至上幸福星与定	scene_08
星が何か言うの？	Just what does the Planet say?	星何言	scene_08
いつかミッドガルから逃げなさい。星と話して、AERISの約束の地 見つけなさい	Someday I'll get out of Midgar… Speak with the Planet and find my Promised Land.	逃星話約束地見	scene_08
ドアが開いている…… いつの間に？	The door's open… When did it open?	開間	scene_08
なんだか恐いわ……	I wonder what happened…	恐	scene_08
BARRET、RED XIII……来てくれ。ようすが変なんだ	BARRET, RED XIII …come with me. Something's wrong.	来変	scene_08
私がこの先の様子を見てくる	I'll go on ahead.	私先様子見	scene_08
何か目的に向かっているような…… 上に……？	It looks like it leads up…	何目的向上	scene_08
……セフィロスは生きているのね？	…Sephiroth is alive?	生	scene_08
こここここころさないでくれ！	P, p, p, please, don't kill me!		scene_08
ああ、見た！　この目で見た！	Yeah, I saw him! With my own eyes!	見目	scene_08
それじゃあ、なに？	Then does that mean		scene_08
そんな単純な話じゃない！俺は知ってるんだ！セフィロスの目的はちがう！	It's not that simple! I know him! Sephiroth's mission is different!	単純話俺知目的	scene_08
名前だけなら、私も知っている	I only know his name.	名前私知	scene_08
ルーファウス	Rufus		scene_08
アバランチだ！	I'm from AVALANCHE!		scene_08
おかしな組み合わせだ	What a crew.	組合	scene_08
……オヤジは金の力で世界を支配しようとした。なるほどうまくいっていたようだ	…Father tried to control the world with money and that worked for him.	金力世界支配	scene_08
だが私のやりかたはちがう	But, I do things differently.	私	scene_08
演説好きなところはそっくりね	He likes to make speeches just like his father.	演説好	scene_08
あとで話す！いまは俺を信じてくれ！俺はこいつを倒してから行く！	I'll explain later! Just take my word for now! I'll go after I take care of him!	話俺信倒行	scene_08
ふむ、その通り	That's right.	通	scene_08
【△ボタン】でメニューをひらく	Access Menu with [MENU]		scene_08
とどめはさせなかった。面倒なことになりそうだ	I couldn't finish 'em. This is gonna get complicated.	面倒	scene_08
CLOUD、TIFAのマテリアを……	CLOUD and TIFA's Materia…		scene_08
ハーディ＝デイトナ	Hardy Datona		scene_08
チッ……！すっかりかこまれてやがる	*&^%(*… We're surrounded!		scene_08
ヘッ、そうはいかねえな	Yeah, well that ain't happenin'.		scene_08
へヘッ、よしてくれよ。『BARRETさん』なんてオレのガラじゃねえや	Who you callin' Mr. BARRET? That don't sound right!		scene_08
なにか？	Did you say something?		scene_08
ええ！？どうしたんだよ？CLOUDは？	Huh? What's up? Where's CLOUD?		scene_08
『　神羅　　Ｓー２７式　』	[Shinra S-27]	神羅式	scene_08
【かめ道楽　通信】ナンバー２きびしい仕事でおつかれのアナタ……ぜひいちど居酒屋『かめ道楽』へ！！仕事の後の一杯は最高ですよ！	Turtle's Paradise Newsletter No. 2 The end of another hard day. Wouldn't you like to sit back with a tall cool one? You can at the Turtle's Paradise!! Stop in today! There's nothing like a smooth one after work!	道楽通信仕事居酒屋後一杯最高	scene_08
○ボタン	[OK]		scene_08
△ボタン　　　メニュー	[MENU]Menu		scene_08
セフィロスは生きている。俺は……あのときの決着をつけなくてはならない	Sephiroth is alive. …I have to settle the score.	生俺決着	scene_08
わたしも、行く。……知りたいこと、あるから	I'll go, too. There are things I need to know.	行知	scene_08
AERISのおふくろさんには安全な場所に移るようにって言っといたからマリンも安全だな	We told AERIS's mom to go somewhere safe, so Marlene should be safe, too.	安全場所移言	scene_08
そういえば、わたしミッドガル出るの、初めて……	You know what? This is the first time I've ever left Midgar…	出初	scene_08
言うと思った！	I thought you'd say that!	言思	scene_08
……う～ん。でもほら、CLOUDが約束守ってくれればだいじょうぶよね、きっと	…Hmm. But you know, it should be all right if you keep your promise.	約束守	scene_08
ここから北東に行くとカームって町があるんだ	To the Northeast, there's a town called Kalm.	北東行町	scene_08
そうだな。セフィロスの行方の情報も必要だからな	You're right. We need to know where Sephiroth went.	行方情報必要	scene_08
チッ…………わかったよ。ここから【北東にカームって町】があるんだ。何かあったらそこを集合場所にしよう	^#$^%…alright. Go Northeast to a town called Kalm. If something happens, we'll meet up there.	北東町何集合場所	scene_08
……組み合わせ	…combination.	組合	scene_08
じゃあ、カームでな！	Later, at Kalm!		scene_08