クエっ！	Wark!	1
クエっ？クエクエクェ　クエ？	Wark? Warkwark wark?	2
クエっ	Wark	3
グリン	Choco Bill	11
お客さんたち、この先の湿地帯をこえるつもりですか？	Thinking of crossing the marshes?	12
ふむ、それならチョコボを手に入れたほうが安全ですな	Hmm, then it'll probably be safer for you to get a Chocobo.	13
チョコボのお買い上げは向かって一番右の建物チョコボ小屋におります孫にお申し付け下さい	To purchase a Chocobo, please talk to my grandson. He's in the Chocobo stables at the far right end of the farm.	21
そういえば少し前に【湿地帯】に向かった人がいたんですよ	By the way, there was another person heading towards the Marshes.	22
チョコボなしで湿地帯なんてきっとミドガルズオルムにやられちまったでしょうな。真っ黒なマントの人でしたがね	Without a Chocobo, the Midgar Zolom probably got him. It was a man in a black cape.	23
探してない	Nope	31
どうでしょう一泊　１００ギルで…	How about 100 gil a night…?	32
先を急ぐ	I'm in a hurry	33
いえいえ、商売っ気をだしているんではなくてですな。こういう時だからこそ！	No, I'm not trying to persuade you for money. It's just because of the way things are in the world.	41
こう、建設的にですなチョコボを育てるのもお客様のためではないかと……	I thought that it would be a healthy thing for you to raise some Chocobos…	42
テヘヘヘヘ……お客さんは運がよろしい！	Hmm…You just happen to be in luck!	43
育成の話聞かせて	Tell me how you raise them	51
なんでもないの	That's all	52
チョコボをあずかってくれや	Take care of my Chocobos	53
『チョコぼう』は、お１つ１００００ギルになりますが？	'Chocobo Stables' cost 10000 gil…	61
貸して	Rent it	62
こちらも、６つ以上お貸しするよゆうがありませんので…	We don't have enough room to rent out more than 6 here…	63
ただ、チョコボにあたえるエサはお客様がお買いになるかして直接おあたえください	But, please buy the food for the Chocobo, and feed them yourselves.	71
チョコボはそのエサによって能力が大きく変わりますのでご自分で、お好きなようにエサを選んでください	Chocobo's abilities will differ with what you feed it, so feel free to choose your own food.	72
それから、オスとメスのチョコボはカップルにすることが出来ましてカップルにしたチョコボに『実』をあたえますとタマゴが生まれます	Also, if you're able to find a male and a female Chocobo that like each other, they'll produce an egg. But only if you feed them a 'Nut'.	73
白い子チョコボはね、耳の裏をこちょこちょしてあげるとすっごくよろこぶのよ	The white Chocobo likes it when you scratch behind its ears.	81
でも、へんなとこくすぐるときげんわるくしちゃうから気をつけないとダメよ	But if you scratch it someplace that it doesn't like, it'll get mad, so be careful.	82
グリングリン	Choco Billy	83
そうだ、チョコボがほしいなら野生のをつかまえるといいよ	You know, if you really want a Chocobo, you should go out and catch one.	91
野生のチョコボのこと何か知りたいかい？	Want to know how to catch a Chocobo?	92
どこにいる？	Where are they?	93
これを装備しておくと野生のチョコボに会える。逆を言うとこれを装備してないとチョコボには会うことが出来ないわけさ	If you equip this, they'll come to you. But, without it, they won't appear.	101
野生のチョコボは他のモンスターといっしょに出てくるんだ	A wild Chocobo always appears with other monsters.	102
けど、そのままじゃ他のモンスターがジャマでチョコボを捕まえることが出来ない	But, you won't be able to catch it because of the monsters.	103
今なら『チョコボよせ』を２０００ギルで売ってあげるよ	I'll sell you the 'Chocobo Lure' for 2000 gil, right now.	111
買うかい？	You want it?	112
買う	Buy it	113
いらっしゃい！	Welcome!	121
買い物をする	Buy	122
チョット話を聞く	Get some information	123
他のチョコボで外に出たいなら今、外に出してるチョコボを戻してからにしてよ	You must return the Chocobo that's out, if you want to take out a different one.	131
どれに乗って出かけるんだい？	Which one are you going to take?	132
これに乗って出かける？	Ride this one?	133
方向キー左右と○ボタンで選んでよ	Use the Directional button left or right and [OK].	141
す、すごいチョコボだよ、これ！	This…is a wonderful Chocobo!	142
すごくいいチョコボだよ	This is a great Chocobo.	143
いれる	Put it in	151
逃がす	Let it go	152
他のにする	Choose a different one	153
サクのチョコボは？	Chocobo by the fence?	161
外で乗れる？	Ride it outside?	162
クラスってなに？	What are "Classes"?	163
それと、チョコボにはもって生まれた能力があってね自分の持っている能力以上は育たないんだ	Oh, and Chocobos are born with certain natural abilities. So, no matter how much they mature, they can't get more abilities than what they're born with.	171
エサをあげても、能力が上がらなくなったらそのチョコボの限界がきてると思っていいよ	If a Chocobo's abilities don't increase even when you feed it, that means it's reached its limit.	172
そういうチョコボはもう、逃がしちゃうかカップリングさせて、次の子供を育てるといいんじゃないかな	It's best to let those kinds of Chocobo go or mate them to get a new Chocobo.	173
もう少し成長するかもね	It might mature a bit more.	181
もう、成長は望めないかも	Don't expect it to mature anymore.	182
クラス	Class	183
クリーエの野菜	Kurie Greens =	191
ミメットの野菜	Memit Greens =	192
レイゲンの野菜	Reagan Greens =	193
これでいいかい？	Is this all right?	201
他の『実』にする	Give it a different Nut	202
やっぱりやめる	Quit	203
ゼイオの実	Zeio Nut =	211
オスとメスじゃなきゃダメだよ	They gotta be male and female.	212
どのチョコボをカップルにするんだい？２匹に話しかけて決めてよ	Which two Chocobos are you going to mate? Talk to the two you like and make your decision.	213
かしこさアップ！	Intelligence Plus!	221
すこし仲良くなった！	They're getting along better!	222
性格がよくなった！	Their personalities improved!	223
それ以外では、カップリングできそうなのはいないみたいだけど	There doesn't seem to be any others you could mate it with.	231
ねぇ、チョコボせんにんって知ってる？	Hey, do you know what a Chocobo Sage is?	232
えっ！？会ったことあるの！？	What!? You've actually met him!?	233
　ね	That's `$& 	241
クリンが見たところダッシュが１番速そうなのは…	From what I see, the fastest sprinter is…	242
それから、クリンが見たところスピードが１番速そうなのは…	And, the fastest one is…	243
『山チョコボ』や『川チョコボ』が生まれる条件は『すごくいいチョコボ』か『いい感じのチョコボ』に『カラブの実』っていうのを使ってタマゴを生ませるんだって。けど、うちじゃあ『カラブの実』売ってないよ。	In order for the 'Mountain Chocobo' and River Chocobo' to be born, Feed the 'Carob Nut' to a 'Great Chocobo' or a 'Good Chocobo' and have it produce an egg. But we don't sell any Carob Nuts'.	251
クリンのメモ３	Chole's Memo #3	252
『すごくいいチョコボ』と『いい感じのチョコボ』はチョコボせんにんがいる所から南東の島とコレル。それとコレルの西の方でとれるんだって。それから『カラブの実』はチョコボせんにんのいる所から南にいるモンスターがよく持ってるんだってさ。あそこから南って言うとボーンビレッジあたりかしら？	A 'Great Chocobo' and a 'Good Chocobo' are found… on an island southeast of the Chocobo Sage's dwelling at Corel and in the area west of Corel. The 'Carob Nut' can be found south of the Chocobo Sage's dwelling. Monsters carry them. Let's see, is Bone Village just south of there?	253
山と川を渡れるチョコボとせんにんのいる所から南で取れる『すごいチョコボ』をカップリングさせると海を渡れるチョコボが生まれるんだって。けど、実は普通の実じゃダメみたい。	If you mate the Mountain-and-River Chocobo with a 'Wonderful Chocobo', you'll get an Ocean Chocobo.   But to do that you can't use an ordinary Nut.	261
クリンのメモ８	Chole's Memo #8	262
『海チョコボ』を生ませる実は『ゼイオの実』っていうらしいの。これも、初めて聞く名前ね。どこで手に入るのかしら？	The 'Nut' that produces Ocean Chocobos is the 'Zeio Nut'. This is the first I've ever heard of it. I wonder where you get them?	263