コレル山・東	Mt. Corel	山東	scene_17
少し前にすれちがった黒マントのヤツがよ	I just passed a guy in a black cape back there.	少前黒	scene_17
先を急ぎましょ	Let's hurry on.	先急	scene_17
この先は危険だよ。道中、気をつけてな	It's dangerous up ahead. Be careful on your way.	先危険道中気	scene_17
『Ｗマシンガン』を手にいれた！	Received "W Machine Gun"!	手	scene_17
【○ボタン】でジャンプしろ！	Push the [OK] button to jump!		scene_17
『ウィザードロッド』を手にいれた！	Received "Wizard Staff"!	手	scene_17
なにかがおこるはずだ	…something should happen.		scene_17
あっ！！CLOUD！ちょうどよかった！	OH!! CLOUD! That's it!		scene_17
CLOUDがいてくれたらなあって思ってたとこなの	I was just wishing you were here!	思	scene_17
ね、CLOUDちょっと休もっ	Come on, CLOUD. Let's rest a minute.	休	scene_17
……ふう	…whew!		scene_17
……なんだ？	What?		scene_17
『へんせいメニュー』	Morph Menu		scene_17
うん！！……かわいいね	Yes!! …how cute.		scene_17
どうするか…	What should we do?		scene_17
……俺たちには関係ない。無視だな	…It's got nothing to do with us. Just forget about it.	俺関係無視	scene_17
ゴっ……ゴクっ！	Glu…glug…		scene_17
おう！！よくこんなとこまで、きたもんだな！	Hey! How'd you ever wind up here?		scene_17
いまじゃ、見る影もねえ。俺もこのブルも動かねえよ	Now, it's nothing but a miserable pit! Me, my bulldozer…everyone's out of work.	見影俺動	scene_17
ここで、まっててくれ……	Wait here…		scene_17
ケッ！また、BARRETさまに会えるとは思ってもみなかったぜ	Well, lookey here! Never thought I'd ever see your face again.	会思	scene_17
ほんとに、そんなことができるのか……メテオにやられる前に、また魔晄炉にメチャクチャにされるんじゃねぇのか？	Ya think they can really do it? I'll bet the reactor destroys everything even before Meteor hits!	前魔晄炉	scene_17
ゴールドソーサーで遊びてぇよ…	I wanna play at the Gold Saucer…	遊	scene_17
フン！また、どこかの町を追い出されてきたんだろう？	They kick you out of another town or somethin'?	町追出	scene_17
ジャマしねぇでくれよ！！	Get out of the way!!		scene_17
どのツラさげて、もどってきたんだ？	You got a lot of nerve comin' back here!		scene_17
たまに空を見上げるとメテオのやろうが、でっかい顔してオレを見つめてやがる……	Whenever I look up in the sky, I see Meteor staring me right in the face…	空見上顔	scene_17
神羅の兵が、どかどかやってきて魔晄炉のヒュージマテリアを回収するだとか言ってたぜ	Shinra soldiers came around sayin' they were gathering up all the Huge Materia.	神羅兵魔晄炉回収言	scene_17
よぉ、都会のほうじゃ数字のイレズミをほるのが流行ってるのか？	I hear it's a big fad now in the city to get tattoos. Is that right?	都会数字流行	scene_17
よぉ、世の中は今どうなってんだい……	Hey, what's gonna happen to the world?	世中今	scene_17
生き抜いていくにはこの店の武器が必要だぜ	If you want to survive, then you're gonna need some of my weapons.	生抜店武器必要	scene_17
左の道を行けばロープウェイ乗り場があるぜ！	Take that road on the left to the Ropeway station!	左道行乗場	scene_17
このイドをず～っとほって世界のうらがわまで行きたいな	I'm gonna keep diggin' in this well till I come out on the other side of the world…	世界行	scene_17
ポケットにしまっておくからまた、あとで取りにきてね！	Here, I'll keep it in my pocket, and you can come by later and get it, OK?	取	scene_17
くよくよしてもしかたないよ！そんなのオッサンらしくないよ	No use baggin' on yourself! It's not like you, OLD guy!		scene_17
神羅の狙う、ヒュージマテリア……残るはジュノンの海底魔晄炉のみだな	There's only one more Huge Materia the Shinra needs… That's the one at the Underwater Reactor.	神羅狙残海底魔晄炉	scene_17
ちょっと様子を見に戻ってみるか【ミディール】へ……	Let's go see what's going on at Mideel…	様子見戻	scene_17
急いで、止めなきゃ！！	We've got to hurry and stop 'em!!	急止	scene_17
海底魔晄炉に行くのか？	Are we going to the Underwater Reactor?	海底魔晄炉行	scene_17
その時のクセがまだぬけないみたい	He still can't kick his old habits from then.	時	scene_17
メテオが落ちてくるんじゃどこへ引っ越しても同じかしら……	With Meteor coming, I guess it doesn't matter…	落引越同	scene_17
でも、だれかに責任を押しつけなければ気がおさまらんかったのじゃよ	But no one will be satisfied until someone takes the blame.	責任押気	scene_17
バギーカーでも持ってりゃ南のサバクを越えて、川向こうの村に渡れるんだけどよ……	If I had a buggy, I'd cross the southern desert, and go to that town across the river…	持南越川向村渡	scene_17
あれれ？それじゃ、持ちきれないよ	Hey? You can't hold anymore.	持	scene_17
わたしまだ若いのに……だれか、おヨメにもらって～	I'm still too young… I'll never remarry.	若	scene_17
町はメチャクチャになった……メテオも落ちてくる……	The town is in shambles… and Meteor is coming our way…	町落	scene_17
ねぇ、メテオってなぁに？	Hey, what's a Meteor?		scene_17
ゆっくり休みなされ	Enjoy your stay.	休	scene_17
神羅のやつらはどこまでこの町を壊せば気がすむんだろうな！？	How much more will they have to destroy before they're satisfied!?	神羅町壊気	scene_17
乗る	Go on	乗	scene_17
ひどいっ！	That's so terrible!		scene_17
みんな、いろいろ……つらいこと持ってるんだね	Everyone's… been through a lot of hardship…	持	scene_17
オレのせいだからだ。ぜんぶオレのせいなんだ	An' it's my fault. ALL my fault.		scene_17
オレさえ魔晄炉に賛成しなければ……	Never should've gone along with the building of the reactor…	魔晄炉賛成	scene_17
全部、オレのせいなんだ……	It's all my fault…	全部	scene_17
あった、とは？	What do you mean 'used to'?		scene_17
オーイ、あんたら！『ゴールドソーサー』に行くなら早く乗っておくれ	Hey everyone! If you want to go to the 'Gold Saucer', hurry and get on!	行早乗	scene_17
あせる気持ちは分かるけどよ。メテオが落ちなかったらそのあと、どうするんだよ？	I know how you feel, but what if Meteor doesn't hit us? What are you gonna do then?	気持分落	scene_17
オレたちは豊かな生活を夢みていた。	We all dreamt of the good life.	豊生活夢	scene_17
ダイン	Dyne		scene_17
でもよ、ダイン。今の時代、石炭なんて誰も使わない。時代にはさからえないんだ	But listen, Dyne. No one uses coal nowadays. It's the sign of the times.	今時代石炭誰使	scene_17
そんなの俺だって同じなんだ！	I know how you feel! I feel the same way too, damn it!	俺同	scene_17
オレたちは豊かな生活を夢みていた。しかし…………	We all thought it would bring us an easier life.	豊生活夢	scene_17
オレたちの家族も……	All my relatives……	家族	scene_17