コスモキャニオン	Cosmo Canyon		scene_20
……ナナキ？	…Nanaki?		scene_20
ウソをつきましたね。このコスモキャニオンでは許されないことですよ	You lied. That is something that is not treated lightly here in Cosmo Canyon.	許	scene_20
来たかったぜコスモキャニオン！	I always wanted to come here!	来	scene_20
ナナキというのは？	Who is Nanaki?		scene_20
おや、もうご出発ですか？あなたのお友だちはまだ星について学びたいみたいですが……	Leaving already? But it appears your friends still want to learn more about the Planet…	出発友星学	scene_20
ホントにあの扉なんの役にたつんでしょう？ずーっと閉じたままで……	What's that door there for anyhow? It's been closed forever…	扉役閉	scene_20
あの旅から帰られてからというものブーゲンハーゲン様、あまり元気がないようなんです	Bugenhagen seems rather down ever since he returned from that trip.	旅帰様元気	scene_20
ブーゲンハーゲン様は今の私たちの心のささえです……	Bugenhagen is what keeps our hearts strong…	様今私心	scene_20
ふぬけの父？	Cowardly father?	父	scene_20
いまいくよ！　じっちゃん！	Coming, Grandpa!		scene_20
ね、ちょっと休んでこ。わたし、いろいろ聞いてみたいことあるし	Let's rest for a bit. There are some things I want to find out about anyway.	休聞	scene_20
この火はね。『コスモキャンドル』なのです。むかーしむかしからもやされつづけてるのです	This fire is called 'Cosmo Candle'. It has burned for generations.	火	scene_20
これがコスモキャニオン……なるほど、神秘的な場所ですね	So this is Cosmo Canyon… Quite a mysterious place.	神秘的場所	scene_20
車がなおるまでコスモキャニオンを見学されては？	Why don't you look around Cosmo Canyon while I fix the car?	車見学	scene_20
お礼の金を……	How much do I owe?	礼金	scene_20
それもそうだ、それじゃ	I guess you're right		scene_20
この前、あそこのソファーにきれいなビンが置いてあったんですがあなたがたのですか？	There was a bottle on the sofa there a couple of days ago…was it yours?	前置	scene_20
うわっ！！	Whoa!!		scene_20
でも一度魔晄の便利さを知ってしまった人間がはたしてもとにもどれるのだろうか……	But can people used to Mako energy ever go back…?	一度魔晄便利知人間	scene_20
待ってくれ！　オイラも行く	Wait for me! I'm coming too!	待行	scene_20
オイラ、少しだけ大人になった。そういうこと！	I think I grew up a little. That's what happened!	少大人	scene_20
フカフカのベッド！	Fluffy Beds!		scene_20
コスモ……キャニオン？関係あるのかな？星とか、古代種とか……	Cosmo…Canyon? I wonder if there's any relation to the planet or the Ancients…	関係星古代種	scene_20
ハア……これがコスモキャニオンですか	Hmmm…So this is Cosmo Canyon.		scene_20
はいよ、いらっしゃい。あれ、まだ武器を買うの？あんたも変わった人だね……	Welcome. You still want more weapons? You sure are weird…	武器買変人	scene_20
アルバイトぼしゅう！経験は間いません。武器を見てもこうふんしないおだやかな性格の方求む！ちょっとせまいけれど明るいしょくばです！	Now hiring! No experience necessary. Looking for emotionally stable people who don't get excited at the sight of weapons! We offer a small, but good working environment!	経験間武器見性格方求明	scene_20
ん？おお、これまたお客さんか。いいともいいとも	Mmm? Oh, we have guests.  Good, good.	客	scene_20
そういうわけじゃない	Not really		scene_20
ようするにワシらには存在しないが古代種にとっては存在した	In other words, it doesn't exist for us, but it did for the Ancients.	存在古代種	scene_20
その旅を終え、星に帰る場所……つまり死に場所が約束の地	The place they returned to after their long journey… Their burial land is the Promised Land.	旅終星帰場所死約束地	scene_20
悪いんじゃが、伝説とか昔話とかワシにはそんな話しかしてやれんよ	I'd appreciate it if you didn't talk about such foolish things as legends and old wives tales.	悪伝説昔話	scene_20
つづけてくれ	Go on		scene_20
つづきは？	And then?		scene_20
おお、あったあった	Ahh, here it is.		scene_20
無意味なことなんかないとも。こうしておけば、いつかかならず誰かの目にふれるもんさ	Nothing is meaningless. If I do this then, someday, someone will run across it.	無意味誰目	scene_20
でも、ブーゲン様のことだからそんなこと言わんじゃろな。いつも『ホーホーホウ』……	But, Bugenhagen would never say that. All he says is 'Ho Ho Hoooo'…	様言	scene_20
おねがいします	Please		scene_20
やめとくぜ	No, thanks		scene_20
では、またのおこしをおまちしております	Well then, please come again.		scene_20
うちのオリジナルカクテル『ライフストリーム』はいかがです？	How about our original cocktail, 'Lifestream'?		scene_20
ほいほい	Mmm…		scene_20
古代種といえばガスト博士なのじゃ。時々ここにも来ておった	You can't talk of the Ancients, without mentioning Professor Gast. He used to come here sometimes.	古代種博士時来	scene_20
たしか……ジェノバとかいう名前をつけていろいろ研究しておったのじゃが……	If I recall…he named it 'Jenova' and was doing a lot of research…	名前研究	scene_20
というわけでなガスト博士に会うことがあったら伝えてほしいんじゃ	So, if you ever see Professor Gast, I want you to tell him…	博士会伝	scene_20
そうかそうか。おまえさんたちがナナキをつれてきてくれたのか	Is that so? You brought Nanaki back here?		scene_20
どこかへ行くの？	Are you going somewhere?	行	scene_20
約束の地はどこにあるのか……ブーゲンハーゲン様はごぞんじなのかもしれんなあ	Where is the Promised Land…? Maybe Bugenhagen knows.	約束地様	scene_20
ムニャムニャ……お客さん……おつり……おつりわすれてます……	…num…yawn…Sir… You…forgot…your… …change.	客	scene_20
ああ……そうですか……お買い……もの……お買いもの！？	Oh…is that so…  You're here to shop?	買	scene_20
１６からコツコツとマテリアを売りつづけてもう１０年。いったい僕の人生って……ん？	I've been selling Materia for 10 years now, ever since I was 16. Geez, what have I been doing with my life?	売年僕人生	scene_20
う～。勉強はキライだよっ！	God. I HATE studying!	勉強	scene_20
は～い、それじゃすぐ……	All right, it'll be ready in no time…		scene_20
ところでオバちゃんごはんまだですか？	So, when's dinner?		scene_20
なんやいいましたか？	What did they say?		scene_20
ブーゲンハーゲン様がフーインしてるんだからしんぱいないよ！	Mr. Bugenhagen sealed it so we wouldn't have to worry about it!	様	scene_20
でも、ブーゲンハーゲン様になにかあったらと思うと……やっぱり悲しいです	Just the thought of something happening to Bugenhagen…worries me.	様思悲	scene_20
べつにあのでっかい星がこわいんじゃないんです	It's not that I'm afraid of that big star.	星	scene_20
ゴメン……ゴメンよ。でも、今のオイラには……	Sorry…I'm really sorry. But now, I have…	今	scene_20
……だいじょうぶ。じっちゃんのことだからまたすぐにプカプカやってくるさ。『ホーホーホウ』って……	…Don't worry. Grandpa will come back floating, saying 'Ho Ho Hoooo' again…		scene_20
やあ、どうも。何をお探しかな？	Hello. Looking for anything in particular?	何探	scene_20
『エリクサー』を手に入れた！	Received "Elixir"!	手入	scene_20
『無用の扉』前	Gate of Naught	無用扉前	scene_20
やはりブーゲンハーゲンでなければ	It seems like the only one that		scene_20
CLOUD、この人がブーゲンのじっちゃん	CLOUD, this is my grandfather, Bugen.	人	scene_20
やめてくれよ、じっちゃん！オイラはもう４８歳だよ	Please stop, Grandfather. I'm 48.	歳	scene_20
無口で考え深い。あんたはナナキのことを立派な大人だと思っていたのかな？	He's quiet and very deep. You thought he was an adult?	無口考深立派大人思	scene_20
せのびをするといつかは身をほろぼす	To do that now would destroy you in the long run.	身	scene_20
……星が死ぬ？	…When the Planet dies?	星死	scene_20
天に輝く星の音。こうしているうちにも星は生まれ、死ぬ	The sounds of the stars in the heavens. While this goes on, planets are born, and die.	天輝星音生死	scene_20
CLOUDたちは星の命を救うために旅をしているんだ	They have come here on a journey to save the planet.	星命救旅	scene_20
しかし、なんじゃ。わしのじまんのアレを見るのはけしてムダではなかろう	But, then again, I guess it wouldn't hurt to show him.	見	scene_20
ブーゲンハーゲンさま～！	Bugenhagen!		scene_20
お～い、こっちじゃ。とびらのカギは開いとるから入ってくるがいい	Here, over here. The door's unlocked, come in.	開入	scene_20
ホーホーホウ。そろったようじゃな？それじゃ、はじめようかの	Ho Ho Hoooo. It looks like you have them all together. Then let's begin.		scene_20
こいつはすげえ！	This is really somethin'!		scene_20
この宇宙の仕組みが全てこの立体ホログラフィシステムにインプットされておる	All the workings of space are entered into this 3D Holographic System.	宇宙仕組全立体	scene_20
おおっ！　星が流れてるぜ！	Whoa! Shootin' stars!	星流	scene_20
感激もんですわ～！	I'm so overwhelmed!	感激	scene_20
さて、そろそろ本題に入ろうかの	Well, let's get to the subject.	本題入	scene_20
人間だけではない。この星、いや宇宙に生きるものすべてひとしく	And not only those of humans, but everything on this Planet. In fact, all living things in the universe, are the same.	人間星宇宙生	scene_20
『精神エネルギー』この言葉を忘れてはいかん	'Spirit Energy' is a word that you should never forget.	精神言葉忘	scene_20
いろいろ話してしまったがまあ、これを見たらわかるじゃろ	I've digressed, but you'll understand better if you watch this.	話見	scene_20
……終わりじゃ	It would be the end of life as we know it.	終	scene_20
むりやり吸い上げられ加工された精神エネルギーは本来の役割を果たさん	When Spirit Energy is forcefully extracted, and manufactured, it can't accomplish its true purpose.	吸上加工精神本来役割果	scene_20
すなわち魔晄エネルギーはこの星を滅ぼすのみ……じゃ	In other words, Mako energy will only destroy the Planet…	魔晄星滅	scene_20
そうか……ナナキがそんなことを……	So that's it…Nanaki's been thinking that all this time…		scene_20
すまんが、これからもナナキのことをよろしくな	I hate to trouble you, but please look after Nanaki.		scene_20
しかし、これが星の望んだことかの？星はこんな終わりかたをねがったのかの？	But is this perhaps, what the Planet wanted? Did the Planet actually want to end like this?	星望終	scene_20
コスモキャンドル	Cosmo Candle		scene_20
……本当に？この星の命を守るため？	…Really? To save the Planet?	本当星命守	scene_20
……今はわからねえ。だがよ、オレはきめたんだ	…Right now, I really don't know. But I do know one thing.	今	scene_20
もう一度……もう一度アバランチの結成だ！	Again… Again…AVALANCHE's born again!	一度結成	scene_20
……ううん	…It's nothing.		scene_20
CLOUDは……本当に本当にCLOUD……だよね	You really, really are… you…right?	本当	scene_20
俺が……俺たちがいるだろ？	But I'm…we're here for you, right?	俺	scene_20
こんなん、何年ぶりやろか……な～んや、いろんなこと思いだしますなぁ……	I wonder how many years it's been… Gosh, it brings back memories……	何年思	scene_20
オイラの両親のことだからさ	It's about my parents.	両親	scene_20
当たりまえだよ。あいつは……母さんを見殺しにしたんだ	Of course. He…left Mother for dead.	当母見殺	scene_20
CLOUDよ。おまえと、あと１人いっしょに来てくれんか	CLOUD. Will you and one other person come with us?	人来	scene_20
キケンなんやったらエンリョしますわ……	Dangerous? Count me out…		scene_20
ホーホーホウ。なら、行くとするかの	Ho Ho Hoooo. Shall we go?	行	scene_20
年寄りに先を行かせるのか？わしは後ろからついていくよ	You want an old man like me to go first? I'll be right behind you.	年寄先行後	scene_20
よしよし。それじゃ行くとしよう	Good. Then we shall proceed.	行	scene_20
しかし、死してなおギ族の憎悪の精神は消えず、ライフストリームに帰ることすらこばんでいるのじゃ……	The vengeful spirits of the Gi didn't disappear, and couldn't return to the Lifestream…	死族憎悪精神消帰	scene_20
不思議な形をした石だ……	This is a strange looking rock…	不思議形石	scene_20
きみょうな形をした石だ……	An odd shaped rock…	形石	scene_20
ギ族はわしらより体も大きくなにより残忍じゃ。ここから攻め入られたらひとたまりもなかったじゃろう	Even though the Gi outnumbered us, they could not attack through here because the passage is too narrow.	族体大残忍攻入	scene_20
次から次へと襲いかかってくるギ族と戦いながら……	Fighting attackers one after another…	次襲族戦	scene_20
なんということじゃ……	What is this?		scene_20
……ありがとう、CLOUD。あんたたちのおかげでなんとか助かったよ	…Thank you, CLOUD. because of you, we survived.	助	scene_20
さ、お前に見せたいものはすぐそこじゃよ	Come, I have something I want to show you. Right over here.	前見	scene_20
……その戦士はここでギ族と戦った	…The warrior who fought against the Gi.	戦士族	scene_20
……あれが……あれが……セト……？	…That… That's…Seto?		scene_20
いまも……	Even now…		scene_20
ホーホーホウ……知っておったよ。２人はあの時、わしに頼んだんじゃ。この洞窟は封印してくれとな	Ho Ho Hoooo…She knew. The two of them made me promise to keep this cave shut.	知人時頼洞窟封印	scene_20
ナナキよ。CLOUDたちと旅をつづけるのじゃ	Nanaki. I want you to continue your journey with CLOUD and the others.	旅	scene_20
正直なところ、そんなことができるとは、わしには思えん	Honestly, I don't think it can be done.	正直思	scene_20
こんなにも星が苦しんでいるのに星の一員、いや、星の一部であるわしらにできることは本当に何もないのか、とな	I've been thinking if there was anything WE could do, as a part of the Planet, something to help a Planet already in misery…	星苦一員部本当何	scene_20
ことしで１３０歳じゃよ。ホーホーホウ、じゃ	This year, I'll be 130. Ho Ho Hoooo.	歳	scene_20
わしが生きてるうちにおまえが帰ってきてよかったわい	I'm so glad that you came back while I was still alive to show you.	生帰	scene_20
オイラは見とどける	I'll see to it.	見	scene_20
その名にはじない戦士になって帰ってくる！だから、じっちゃん！	I'll come back a warrior true to that noble name! So please, Grandpa…	名戦士帰	scene_20
ここで、お別れね。RED XIII……	So this is it, RED XIII…	別	scene_20