え～っ！！	What!?	1
燃えちゃったはず、だよね？	This was all burnt down, wasn't it?	2
……そのはずだ	…I thought so.	3
おまえ、この村は全部燃えちまったって言ってたよな	You said the whole town burnt down, right?	11
ここ、ニブルヘイムだよね？村、ちゃんとしてるよ	This is Nibelheim, right? But the town's all here.	12
ここがニブルヘイム？燃えて全滅って聞いてたけど	This is Nibelheim? I heard it burnt down.	13
CLOUDよう。ウソはいけねえぜ	Yo, CLOUD. It's not good to lie.	21
どしたの？	What happened?	22
俺はウソなんか言ってない	I'm not lying!	23
なんでもないんだ	Nothing	31
俺はこの家に１４歳まで住んでいた……	I lived in this house until I was 14…	32
いや、それよりこの村は全部燃えたはずだ	No, but this town was burned down.	33
あれ……を……手にい……れセ……フィロスに……とどけるの……だ	…Must…get…it… and bring…to…Se…phi…roth…	41
そ……して……おぉ……セフィ……ロスと……ひとつ……に	Then…become…one… with…Se…phi…roth…	42
この男はナンバー『５』……	This guy's number '5'…	43
あれ？　ちょっと待って！がくふの間に何かはさまってる	Huh? Wait a minute! There's something inside the music sheet.	51
TIFAよこの村はいったいどうなっているのだ？あれは幻、それとも夢だったのか？いや、そんなはずはない。私ははっきりと覚えている。炎の中から無事な者を救いだそうとしたが力およばず……怒りに燃えた私はセフィロスを倒すべく魔晄炉へ向かった。	TIFA, what's happened to our town? Was it all an illusion, or just a dream? No, it was neither. I remember trying to get people out of the flames, but not having the strength… Burning with anger, I went to the reactor to kill Sephiroth.	52
セフィロスの姿は見えなかった。	But he was nowhere to be found.	53
ミッドガルの信頼できる医者におまえをあずけて私は再び旅に出ることにした。おまえのことは心配だったがひとつ場所にとどまっていられないのが私の性分だ。	I decided to go to Midgar to find a doctor I could trust. I'm worried about you, but I can't settle down in one place for very long.	61
傷はすっかり良くなっただろうか？元気にしているだろうか？	Have you recovered fully? Are you well?	62
あれから、何年がすぎたのだ？私はふらりとこの村に戻ってきたが正直なところ、おどろいている。村は元通りだが、黒い服の不気味な者たちがうろついている……。	I wonder how many years have passed since then? I just got into town again, but I can't believe it… The whole town is back to normal, except for the strange people with black clothes all around.	63
いや、弾かなかった	No, I didn't	71
ギンギンに弾いた	Yeah, I jammed on it	72
ちょっとだけ	Just a little…	73
□　レ	Re [SWITCH]	81
△　ミ	Mi [MENU]	82
○　ファ	Fa [OK]	83
……どこ……で……す……か？セフィ……ロス……さま	…Where…are…you? Great…Se…phi…roth…	91
定期報告　宝条博士へ	Periodic Report to Professor Hojo	92
１　コピー行動記録	1  Clone Activity Report	93
とめてくれ	Give me a room	101
１泊１００ギルになります。よろしいですか？	It'll be 100 gil a night. Is that all right with you?	102
では、ごゆっくりどうぞ	Enjoy your stay.	103
おじさん、ウソついてる……	You're lying…	111
失礼だなぁ……	EXCUSE ME! That's so rude…	112
変なこと言うなら出ていってもらいますよ	If you're going to talk like that, I'm going to have to ask you to leave.	113
………………ヨン	Re…union.	121
黒マントの……	…The Black Cape…	122
ここはいい村でしょ？	Nice town, huh?	123
ウソはいけませんよ！！	It's not nice to lie!!	131
ホッ……	Oh yeah?	132
あんたら、こんな時に買い物なんかして、どうするの？	How can you shop at a time like this?	133
『１２』のイレズミがあるな。ん？　何か持ってるぞ	He has a tattoo of the number'12'. Mmm? He has something.	141
聞こ……え……る？セフィ……ロスの……声……	Can…you…hear? The…voice…of…Se…phi…roth?	142
ふたのウラに文字がきざまれている	Something is written on the back of the lid.	143
メモリ	[Empty Entry]	151
せいこう	Success	152
失敗	Fail	153
逃亡者に関する報告書　２ 発見時の状態	Escapee Report no. 2 Description at the time of capture.	161
Ａ　元ソルジャー／ナンバー【無】 魔晄照射およびジェノバの影響は 見受けられませんでした。 	A  Former member of SOLDIER/Number(   ) No effect could be detected from either Mako Radiation Therapy or Jenova on him.	162
Ｂ　一般／ナンバー【無】ジェノバへの反応過多が見受けられました	B  Regular/Number (   ) Reaction to Jenova detected.	163
ところで、おまえはリユニオンに参加しないのか？	Are you going to participate in the Reunion?	171
俺はリユニオンなんて知らない！	I don't even know what a Reunion is!	172
ジェノバはリユニオンするものだ。ジェノバはリユニオンして空から来た厄災となる	Jenova will be at the Reunion. Jenova will join the Reunion, becoming a calamity from the skies.	173
ただし……これはあくまで私がきまぐれでおもいついたゲームにすぎない。むりにつきあってくれる必要はない	But…this is merely a game I thought of. It is not necessary for you to participate if you don't want to.	181
手紙は２まいあるようだ	There seems to be another letter.	182
もう１まいの用紙をみる	Read it	183
２階のイスのそばのユカのきしみ……そこから左５歩、上９歩、左２歩、上６歩	The creek in the floor near the chair on the second floor… then to the left five steps, up nine steps, left two steps, and up six steps.	191
４行目があぶりだされた……	The fourth row has been written in invisible ink…	192
ダイヤル　【４】　は　【右　９７】	Dial (4) is  (Right 97)	193