荒れ地	Wilderness	1
待った待った待ったーっ！！	Wait, wait, wait, wai----t!!	2
なになに！？どうしたの、とつぜんあわてたりして？	What!? What happened all of a sudden?	3
この先ってさあ、かなりキツイんだよね。だからね、いろいろ準備を……	It gets pretty tough past here. Better get ready…	11
……ふ～ん……なんかアヤしいな～	…Hmmm… Something's fishy…	12
また何かイケないこと考えたりしてない？	You're not planning something sneaky again, are you?	13
ひょっとして私たちをダマそうとしてるとか……	Are you going to trick us again?	21
クンクン……ウサンクサイにおいがするよ	Hmm… Smells fishy.	22
まさか、またオイラたちをだしぬこうとか……	Are you going to trick us again?	23
ちちちがうって！ホントのホントに大変なん……	No! It's REALLY tough…	31
いたぞ、つかまえろ！！	There they are, catch 'em!!	32
神羅ッ！？	Shinra!?	33
おい、違うぞ！　ヤツじゃない！こ、こいつら、例の！！	Hey, that's not them! These are the other guys from before!!	41
YUFFIE、あなた、もしかして……	YUFFIE, did you by any chance…	42
YUFFIE、おまえ、やっぱり……！	YUFFIE, so you're…	43
YUFFIE、あなたやっぱりイケナイこと考えてたでしょ！	So you WERE up to something!	51
これ『は』って何だ！『は』って！	Whaddya mean 'this one'!? This one'?	52
おまえ、やっぱり何かたくらんでたんだな！！	So you WERE plannin' somethin'!!	53
おめえ、やっぱり何かたくらんでやがったな！！	So you WERE planning some crooked $%*&!!	61
これ『は』？『は』とはどういうことだ？	What do you mean, 'This one'?	62
ほかのことなら心当たりがあるというのか？	You had something else in mind?	63
いったい、どうなってるの！？	What's going on!?	71
なんだかおかしいと思ったらマテリアが、マテリアがなくなってるじゃない！！	I thought something was odd… My, my Materia is missing!!	72
どうなってるんだよォ？	What's going on?	73
おい……YUFFIEは……？	Hey…where's YUFFIE?	81
ね……YUFFIE……は？	Hey…where's YUFFIE?	82
ねえ……YUFFIEは……？	Hey…where's YUFFIE?	83
チークーショーッ！！	ZOUNDS!!	91
ガルルル……ガウッ！ガウウッ！！	Grrrrrrrgh… Grrrgh! Grrrrrgh!!	92
あちゃ～、やられてしもた～！	She's done it again!	93
北だ、北に逃げてったぜ！絶対に、絶対につかまえてマテリア取りもどしてやる！	She went North! When I get my hand on her, I'll get our Materia back!	101
急げ！後を追うぞ！	C'mon! We're goin' after her!	102
はじめっから私たちのマテリアをねらってたんだわ	She was after our Materia from the beginning.	103
フン……どうやら北に逃げたらしいな	Hmm… Looks like she went North.	111
グズグズするない！すぐ出発するぞ！あのヤロー、とっつかまえてやる！！	Don't drag your asses! We're going right NOW! That $#@^% is history!!	112
どうやら、最初からマテリアが目的だったようだな	Seems as though all that she was after was our Materia.	113
ここは歴史の地、ウータイ。めずらしいものもあるからごらんになるといいでしょう	Wutai is a historical place. There are some very unusual things here you should see.	121
YUFFIEですか？さっきみかけましたよ。このあたりの家にいるんじゃないかしら……？	YUFFIE? I saw her a while ago. She must be in one of the houses around here.	122
マテリアも人の生ももとは同じ。いずれ命の大海へともどるべきものなのです	Materia is like Life. They both come from the large ocean of life, and both must return to it.	123
そんでもって、ものかげにかくれたりなんかして……まだまだコドモなんだナ	Other times she'll hide in the shadows just like a little kid.	131
そういえばさっきからYUFFIEみたいなコをみかけるな……	That reminds me, lately I've seen a kid around here that reminds me of YUFFIE.	132
どっかすみっこのほうでまたゴソゴソと、何かしてるんじゃないかナ	Always sneakin' around corners and doin' somethin' she shouldn't.	133
だからといって、私に何ができる？けっきょくいつもと同じ生活を送るしかないんだよナ……	But what can you do about it? Just go on living your life, day in and day out…	141
ハイハイ、ハーイ！ボク、しってます！	Alright, alright, alright! I know!	142
あそこのお山にガガン！と立ってるのはダチャオ像！	On the side of the mountain, right there in your face is Da-chao!	143
『アタシの家！誰も入るな！』	This is MY house! Nobody gets in!	151
もう逃げられないぞ、YUFFIE	You can't get away, YUFFIE.	152
あきらめなさい、YUFFIE	Give it up, YUFFIE!	153
オイオイ、あのガキほっぽってくのか？絶対まだこの町にいるぜ！	You lettin' that damn kid off the hook? I know she's gotta be hiding around here somewhere!	161
YUFFIEならこの町から出てはいないと思うが……それでも行くのか？	She couldn't have left town… I think she is must still be here. Or, do you want to go on?	162
居酒屋　『かめ道楽』	Pub [Turtle's Paradise]	163
おーおー、ひさしぶりじゃナ。今まで何しとったんじゃ。えーと…………誰だっけ？	Well, well. Long time no see. What have you been up to? Let's see…what was your name?	171
ちがうの、おじじ！ぜんぜん知らない人よ！知らない人が勝手にあがりこんでるの！	No, Gramps! This isn't anyone you know! This is just some stranger who barged into our house!	172
おーおー、にぎやかなことじゃ。マゴのおともだちかな？	Oh, how exciting. You a friend of my grandson's?	173
お、お前たち！？なんでこんなところへ……	Yy, you!? How did you get here?	181
そ、そんなことどうでもいいわ。私たちタークスに会ったのが運のつき	Never mind that. I guess it's fate that brought us together.	182
さあ、かくごしなさいっ！！	Get ready to die!!	183
……はい……	…Sorry…	191
もっと飲めよ、ルード、と。お前とくんでもう何年になる……？	Drink, Rude! How long have we been a team?	192
タークスの仕事はツライこともあるけど、ま、俺はやってきてよかったと思ってるぜ	Being a Turk's been hard at times, but all in all, I'm glad I did it.	193
地面がグラグラゆれたと思ったら今度はあのでっかい星……	First the ground started shaking, then that large star…	201
や、やっぱりもう……ダメなのかいナ？	Y, you think… It's all over?	202
ウーイ。さびしい店だろ？	Hey. You think the store feels gloomy?	203
……やなこった、と	…What a drag.	211
い、今なんと……？	Ww, what was that?	212
俺たちは休暇中につきあんたらのおもりはできないぞ、と	We're off duty now and can't save your butts.	213
イリーナ。かんちがいするなよ、と	Elena. Don't misunderstand.	221
仕事のためにすべてを犠牲にするのがプロじゃない。そんなのはただの仕事バカだ、と	Those who sacrifice themselves for their job aren't pros… …just fools.	222
ルード先輩……	Rude?	223
でもこのウータイや世界のどこかにはまだあるらしいんだナ	But some in the world, and here in Wutai, still believe.	231
水神様のうろこだとか水神様の力をふうじたマテリアとかがさ	Believe in the scales of the Water God and in Materia that has its power in it.	232
おお！アナタ、この『かめ道楽』のチラシを、６枚すべて見つけられましたね！	Congrats! You have just found all six flyers for the "Turtle's Paradise"! 	233
しかしこの前の戦ではそれもかなわず……やはり伝説は伝説にすぎなかったのかもしれません	But, in the last battle, we didn't fare so well… I guess our beliefs were only based on legend.	241
水神様のうろこの話を聞いたことがありますか？	Have you ever heard of the Water God's scales?	242
なんでも不思議な力をひめたうろこでそれを前にするとどんな炎でも消えてしまうとか	They're not just regular scales. They have special hidden powers. They're impervious to the strongest flames.	243
……いいだろう。こちらもYUFFIEをコルネオにさらわれた	…OK. Corneo took YUFFIE from us.	251
YUFFIEがいないとマテリアも取りもどせない	And without YUFFIE, there's no way we'll get our Materia back.	252
……わかったわ。私たちもYUFFIEをコルネオにさらわれたの	…All right. Corneo stole YUFFIE from us as well.	253
ええ、私たちもそのつもり。タークスと仲良くあくしゅなんてえんりょしておくわ	The same goes for us. We don't want to make friends with the Turks.	261
ところで、コルネオはいったいどこへ逃げたのかしら？	Now, which direction did Corneo run off?	262
あったりめえじゃねえか！タークスと手を組むなんざ、こっちからねがいさげでえ	Of course! There ain't no way we'd wanna work with the Turks anyway!	263
……くどいな。知らぬものは、知らぬ	…You again? I said it once, and I'll say it again, I don't know her.	271
知らぬと言ったら知らぬ！YUFFIEなどという者はこのウータイにはおらん！	Listen, I said I didn't know her! There isn't anyone named YUFFIE here in Wutai!	272
……見かけない顔だな……	…Never seen you around here before…	273
だったら他の町みたいにさっさと神羅にしたがったらいいじゃないか！	Then why don't you just bow down and obey them like all the other towns?	281
そこにいる連中の方が神羅とまともにたたかってるよ！	Those guys are the ones who are really fighting the Shinra!	282
う、うるさい！お前のようなやつになにがわかる！	Shut up! What would you know about this?	283
……やはり、早々にここから出ていってくれ	…Take your things and get out of here now.	291
ウータイを守るには神羅にさからうわけにはいかないのだ	For the good of Wutai, we cannot stand up to Shinra.	292
いいか！　ヤツはかならずこのあたりにいるはずだ！なんとしても探しだせ！	Now listen up! They must be in the area! Find them no matter what!	293
あんたらもまだあきらめてないクチかい？	You aren't tired of my rambling?	301
うれしいねえ！さあ、買った買った！	Great! Then come on in and start buying!	302
すまないが、ウチの商品いまみんな売りきれなんだ	Sorry, but we're entirely sold out now.	303
『ＭＰきゅうしゅう』のマテリアを手にいれた！	Received "MP Absorb" Materia!	311
イロイロそろってるよ。自由にえらんでおくれ	We got a lot of different stuff here. Take what you want.	312
こんな時だってのにまだ何か買うのかい？	You're still gonna sit here and buy stuff at a time like this?	313
ああ、ダメダメ。今、商品のいれかえをしているところなんだよ。あとでまた、来ておくれ	Oh, no, no, no! I'm just replacing these goods! You come back later.	321
YUFFIEの家	YUFFIE's House	322
わかってるよ、マテリアだろ？ちゃんとしまってあるよ。……こっちきて	I know, the Materia, right? I have it stored in a safe place. …Follow me.	323
マテリアさえ返してくれればそれ以上おまえを責めるようなことはしない	If you give it back now, we'll drop the whole thing.	331
ごめんなさいね、YUFFIE。あなたのキモチはわかるけど私たちにもマテリアは必要なの	I'm sorry, YUFFIE. I know how you feel, but we need Materia, too.	332
……このままあなたにあげてしまうことはできないのよ。わかってちょうだい	…We just can't let you have it. Please understand.	333
さあ、マテリアを……	Now, the Materia…	341
ちょっと言い過ぎたかな……	Were we a little too harsh on her?	342
まぁ、とりあえずはマテリア、返してもらいましょ	Well, let's get our Materia back.	343
ハッハッハーッ！人の言うことは聞いとくもんだってこと！！	Ha, ha--! You should've listened!!	351
ハッハッハーッ！そうかんたんに人を信用するなってこと！！	Ha, ha, ha--! Never trust anyone that easily!!	352
マテリアはアタシのもの！ざんねんでした！	The Materia's mine! Tough!	353
先にオイラたちを助けてよ～！	Help us first!	361
先に、こっちを助けて～なぁ～！	Hey, help us…please!	362
おい！オレ様を助けるのが先だろうが！	Hey! Help me first!	363
コラ、アタシをだれだと……あーっ！　何すんだよー！	Hey! Who do you think I… OW! What're you doin'? Jerk!	371
おまえは……！	You!	372
あっ！　あなたは……！	Oh! You're…	373
いちどにふたりも！ほひ～ほひ～！	Two for one, in fact! Heh, heh!	381
ふたり！？	Two!?	382
ふたりだと！？	Two!?	383
あ～ダチャオ様……今こそあなたのお力を……	Oh, Great Da-chao… Please grant us your strength…	391
ゴドー様はとなりにある五強の塔にこもりっきりじゃ。ゴドー様でもあんなものはどうにもならんて……	He's in the pagoda next to Lord Godo. Lord Godo says we're stuck…	392
ウータイ　ダチャオ像	Wutai‚Da-chao Statue	393
そんなに遠くへは行けないはずだぜ、と	There's no way they could get this far.	401
これは無理だな。この炎じゃ、あっという間に黒コゲだ	Can't go through here… That flame would fry me in an instant.	402
キャアッ！	Eyaaaah!	403
あ、あんた、私はタークスよ！こんな事をしてすむと思ってるの！？	He…hey, I'm a 'Turk'! Don't think you can get away with this!!	411
あ～ッ！こんなことなら、ナワ抜けの修行マジにやっとくんだったよ～！	Oh GAWD! If I knew this was gonna happen, I would've taken those rope lessons more seriously!!	412
ほひ～！！決めた決～めた！今夜の相手は……	Hmm!!! I've made my choice! My companion for the night will be…	413
ゲッ！TIFA……！	Oh man! TIFA……!	421
ゲッ！CIDのオヤジ……！	Oh man! That old fart, CID!	422
ほひひ、ひさしぶりだな	Wheeel…long time no see.	423
どうでもいいが、やり方がスマートではないな……	I don't care what you're doing, so much as the idiotic way you're doing it…	431
オッサン女にもてたいんやったらやり方ちゅうもんがあるやろ	Listen you stupid, slimy, sleazy old scab bag! If you want to get women, there's such a thing as the RIGHT way!	432
だまらっしゃ～い！あれから、俺がどんなに苦労したかお前らにはわかるまい……	Be quiet! None of you know how much I've suffered since then…	433
ラプス　カムヒア！！	RAPPS---come here!!	441
ちょ……	Wait…	442
さあ、かんねんしなさい！	You better say your prayers!	443
この、クサレ外道が……！	So this is how a loser lives!	451
きったねえ手使いやがって……！	Damn tricky $#%@&T$*^%$ !	452
わ、わかった……	All right…	453
お前が秘密をもらした時から決まっていたのだ	You knew this was gonna happen ever since you leaked that secret.	461
俺たちの手でほうむり去られるとな、と	We're going to take care of you… personally.	462
え、ええ～い！こうなれば、道づれだ！	DAMMIT! Then they're all comin' with me!	463
や！　やめ……！	No! Wait, st…	471
ほひいいいぃぃぃぃぃ……	Aaaaaaaaaa……p	472
正解は、と	The correct answer was…	473
ありがと、助かっちゃった	Thanks for your help.	481
ともかく、今日んとこは礼を言うぜ	I uh, thanks for today.	482
お前らに救われるとはな……	Never thought you'd ever help us…	483
仕事か……？	Are we on?	491
いや、今日は非番だ、と	No, today's our day off.	492
ど～でもい～けどお～ろ～し～て～～ッ！	Hey---who cares about that!? Get----me-----down----!	493
ま～さか～！	No way!	501
では、この１階の相手はこの力の強聖ゴーリキーがつとめさせていただきます！	Then I, Sacred Gorky, will be your opponent on the first floor!	502
YUFFIE様！私を倒さねば、２階に上がる事まかりなりませんぞ！	Miss YUFFIE! You cannot go on to the second floor unless you defeat me!	503
ま、次はどーかな？	Let's see how you do on next one…	511
お言葉ですが、修行が足りませんぞ！このゴーリキー、がっかりしましたぞ！	In my opinion, you need more training! Gorky is disappointed!	512
だ～めだって！ゴーリキーをやらなきゃ！五強の塔、ナメてんじゃない？	No good! You have to beat Gorky! Are you mocking this Pagoda?	513
ヘッヘ！　そうやってムキになるのがガキたるゆえんよ！	See what I mean? That kind of anger's what makes you so immature!	521
のうがきは、速の強聖のオラに勝ってからにしな！	Don't pat yourself on the back until you beat me!	522
見てなよ……！	Now watch…!	523
ひゃ～っはっは！ガキガキガキガキ～！	HYAAAAAAH! BRATBRATBRATBRAT!!	531
あんたらじゃダ～メ！ここはウータイ武闘術五強聖の塔だぜ！	You don't belong here! This is the Wutai Temple of Martial Arts!	532
コラコラ、そこの～！オラをムシすんなって！	Hey, you there! Don't ignore me!	533
小娘が、いきがっておるとやけどくらいですまぬぞえ	Keep mouthing off like that, little girl, and you're going to get burned.	541
あいにく火遊びは大好きなの	I got insurance.	542
オバさんは相手にしてらんない	Let's get this over, ya' old geez.	543
やはり常人では、ここまでが限度か……	This is the average person's limit?	551
そなたらでは、話にならぬぞえ	That being the case, we have nothing further to discuss.	552
ここを素通りしようとはわらわも、なめられたものよ	How dare they mock us, thinking they could sneak past us.	553
もっちろん！	Just come on!!	561
パス、パ～ス！	I'll pass!	562
気にいった！見るがいい……	I like you! Now watch…	563
YUFFIE殿でなければ私が相まみえるわけには参りませぬな……	If it were not for Miss YUFFIE, I wouldn't be facing him…	571
労せずして実をえようとはこの４階まで来た者とも思えん所業……	You didn't seem like someone who could get to the fourth floor so easily…	572
お、オヤジイ！？	D,…Dad!?	573
ほう、少しは腕を上げたか？	Hmm? A slight improvement.	581
全力で来い！総！　変！　化！　招！　来……ッ！！	Come at me with all you have! OMNI-Change!!	582
ちょ、ちょっと！	H…hey!	583
アハハハハハ……ッ！	Ha ha haaaaaa!	591
うわっはっはっは……！	Waha haaaaa!	592
やるようになったなYUFFIE……	It's time I gave this to you, YUFFIE…	593
ならわし、ならわしってもー聞きあきたよ！	CUSTOM, CUSTOM, CUSTOM… I'm so sick of hearing that!	601
バッカじゃない！？	It's so stupid!	602
口がすぎますぞ！YUFFIE様！	Silence, Miss YUFFIE!	603
やれやれ、やっぱガキだな	She IS a kid.	611
YUFFIEッ！！	YUFFIE!!	612
許してくれ……すべてワシの責任だ……	Forgive me… It's all my fault…	613
強さとは、相手をたおすためのものなのか？	Is strength for beating enemies	621
他者に対し見せつけるものなのかとな……	…or just something to show-off?	622
力を見せつける強者は、強者を呼ぶ。それが戦になる……	Might begets might.	623
そなたたちは、志と力その２つを持っている！	I perceive that you all have both determination and strength!	631
ま、大船に乗ったつもりでこのCID様にまかせときなって！	Well, just tell yourself you're on a big ship, and leave the rest to ol' CID!	632
そ、そこまで言いはるんならかまへんけど……	If you put it that way, we can't refuse…	633
ウータイに真の強さを根づかせるためにもな！	For the sake of Wutai!	641
オヤジ……	Dad…	642
お前がもどるまでは、ワシが五強聖をおさめる！	I'll take care of the Five Sacred Gods until you return!	643
マテリアを持ってな！	With the Materia!	651
ヘヘ……あったりまえよ！	Heh, heh…you bet!	652
YUFFIE殿。ウータイを思う気持ちはそなたもゴドー様もいっしょ。それだけはお忘れなきよう……	Miss YUFFIE. Your feelings for Wutai are the same as Lord Godo's. Always remember that…	653
おお、そなたら！YUFFIE様は、お元気ですかな？	Oh, you there! How is Miss YUFFIE doing?	661
YUFFIE様に見そめられるとはそれがしたちも、かなり腕にはおぼえがあられますな	Winning Miss YUFFIE's heart must mean you have tremendous skill.	662
あんたらも、オラにくらべりゃまだまだヒヨッコだね	Compared to me, all of you are nothin' but a buncha babies.	663
いや、YUFFIEをよろしく頼みますぞ……！	I mean, please look after YUFFIE…!	671
『ドラグーンランス』を手にいれた！	Received "Dragoon Lance"!	672
『折り鶴』を手にいれた！	Received "Oritsuru"!	673
フー、これでバッチリ。マテリアはもとどおり！	Phew, perfect. Now the Materia is back in its rightful place.	681
おい……マテリアのつけかたがメチャクチャだ	Hey…the order is all messed up.	682
ちょっと、なにコレ……マテリアのつけかたメチャクチャじゃない！	Hey, what is this? The order of it's all messed up!	683
そうそう、そう言えばあのタークスの連中けっこうイイところあるよね	You know, some of those Turk guys are pretty good, huh?	691
ま、なにはともあれマテリアはぶじに戻ってきたし	At least, after all that, we got the Materia back.	692
さ、はりきってみんなで旅をつづけ……	Now come on everybody, let's continue our journey…	693