古代種の神殿	Temple of the Ancients	1
ここ……古代種の神殿……	This is…the Temple of the Ancients…	2
わたし、わかる……感じるの……ただよう……古代種の意識	I…I know… I feel it… The knowledge of the Ancients…floating…	3
キー……ストー……ン……	Key…stone…	11
神殿の……扉を……開いて……	Open…door…of the Temple…	12
黒……マテリア……	Black…Materia…	13
ナンバー９のイレズミだ	It's a number 9 tattoo.	21
CAIT SITH……	CAIT SITH…	22
あっ！　ツォン！	Hey! It's Tseng!	23
社長は……判断をあや……まった……	The President… was wrong…	31
あなたたち、かんちがいしてる	You're wrong.	32
約束の地、あなたたちが考えてるのとちがうもの	The Promised Land isn't like what you imagined.	33
わたし、そういう人、少ないから。世界中、ほんの少ししかいないわたしのこと、知ってる人……	There's not a lot of people I can say that about. In fact, there are probably only a handful of people in the world who really know me.	41
私は……まだ、生きている……	I am…still alive…	42
ここにキーストーンをつかえば……	Let's put the Keystone in.	43
へ～、ごっつう広いなぁ。なんや、気い遠なりそうやわ	Wow, this place is huge! I'm starting to get bored.	51
出口なしか…。もうもどれないぞ	No exits… We can't turn back.	52
クンクン……ここいいにおいするよ	…sniff…sniff… This place smells good.	53
『トライデント』を手にいれた！	Received "Trident"!	61
『ロケットパンチ』を手にいれた！	Received "Rocket Punch"!	62
『リボン』を手にいれた！	Received "Ribbon"!	63
それでも、いいだろうか？	Is that all right?	71
記録する	Save	72
いらっしゃいませでぷ～	Welcome!	73
ううん、最初から言葉はいらなかった。神殿にとどまったものたちの目的はひとつだったから	Actually, they didn't need words from the beginning because there was only one objective for those left in the Temple.	81
ねえ、教えて！	Please, talk to me!	82
だめ、あとはわからない。おびえているの……？	No good. I don't understand the rest. Are you afraid?	83
古代種の知識がいっぱい	It's full of the knowledge of the Ancients.	91
ううん、知識なんかじゃない。そう……意識……生きてる心……	No…not knowledge …consciousness…a living soul…	92
何か、言いたがってる	It's trying to say something.	93
テストプレイはここまでです。	Test Play is up to here.	101
ツォンさん、これは？これで約束の地がわかるんですか？	Tseng, what's this? Can we find the Promised Land with this?	102
……どうかな。とにかく社長に報告だ	…I wonder. Anyway, we have to report to the President.	103
ここは……なんだ？	This place…what is it?	111
失われた知の宝庫。古代種の知恵……知識	A lost treasure house of knowledge. The wisdom of the Ancients….	112
私は星とひとつになるのだ	I am becoming one with the Planet.	113
死によって生まれる新たな精神エネルギー。やがて私の一部として生きることができる	For it is through death that a new spirit energy is born. Soon, you will live again as a part of me.	121
見えた？	Did you see it?	122
おう、しっかり見たぜ	Yeah, I saw it.	123
もうすぐ、ね	Almost there…	131
セフィロスがいるんだな？	Sephiroth is here, right?	132
あいつが何を考えようとここで終わりだ	No matter what he thinks, it's going to end here.	133
記録	Save	141
我、時の番人なり。古代種の知識を求めるものよ。我が時を制し、道をきずけ	I am the Time Guardian. Ye who seek the knowledge of the Ancients. I control the time, select your path.	142
知識求めるものよ、何をねがう？	What is it you wish, seeker of knowledge?	143
……時は満ちた……進むがよい	…It is time… You may proceed.	151
△ボタン：番人にまかせる	[MENU]: Leave it up to the Guard	152
○ボタン：ルーレット回転	[OK]: Spin	153
くるわ！	Here it comes!	161
バトルやで！	It's a battle!	162
戦いか……	A battle…	163
あ！鍵かかってる	Hey! It's locked.	171
だめね。つかまえなきゃ！	No good. We have to catch it!	172
いろいろ大変ね	You must be tired.	173
それからそれから画面左の段差からは下の段に飛びおりることができます	Oh yeah, oh yeah… you can jump down to the ramp below and to the left of the screen.	181
ここなら飛び降りても痛くなさそうだな……	It probably won't hurt if I jump from here...	182
ジャンプ	Jump	183
知の宝庫……	A treasure house of knowledge…	191
おまえが言ってることは意味不明なんだよ！	I don't understand what you're saying!	192
よく見ておくがいい	Look well.	193
CLOUDさん！どないしたんや！	CLOUD! What's going on with you?	201
どうなっちまってんだよ！	What the hell is going on?	202
なにをしているのだ？	What are you doing?	203
簡単なことだ	It's simple.	211
星は傷ができると治療のために傷口に精神エネルギーを集める	Once the Planet is hurt, it gathers Spirit Energy to heal the injury.	212
傷の大きさに比例して集まるエネルギーの大きさが決まる	The amount of energy gathered depends on the size of the injury.	213
星が破壊されるほどの傷？	An injury powerful enough to destroy the Planet?	221
傷つける？　星を？	Injure…the Planet?	222
壁画を見るがいい。最高の破壊魔法……メテオ	Behold that mural. The Ultimate Destructive Magic…Meteor.	223
ん？　どうした。なんか変か？	Mm? What's wrong? Is something wrong?	231
……なんでもないから気にしないで	…It's nothing so don't worry about it.	232
なんでもないよね」	It's nothing.”	233
なんや空から、ふってくんねんな？そりゃ、えらいことや	Oh, so something's going to fall from the sky?  It's going to be something big.	241
空から巨大なものが落ちてくるのか？	Something huge is falling from the sky?	242
なんだか知らないけど	I don't know what it is but…	243
セフィロスか！！	Sephiroth!?	251
クックックッ……私ではない	Ha ha ha… It is not me.	252
かつて古代種がさかえたころ豊富な魔晄の光をあびて育った種族がいた	During the time when the Ancients prospered there existed beings that grew up bathed in abundant Mako.	253
セフィロスの気配は？	Any sign of Sephiroth?	261
消えちゃったね	He disappeared.	262
『バハムート』のマテリアを手にいれた！	Received "Bahamut" Materia!	263
とる	Take it	271
ほうっておく	Leave it	272
ちょっと待って。わたし、聞いてみる！	Wait a minute. I'll ask!	273
そっとしておこうよ、ね？	Let's just leave it, OK?	281
それなら安全だね。だれにも持ち出せない	That'll be safer. If no one else can take it…	282
セフィロスだって同じなんだよね？	Then Sephiroth can't either, right?	283
この場所はもう安全じゃないんだ	This place isn't safe.	291
でも、どうするの？	So what are we going to do?	292
話、聞かせてもらいましたよ！	I heard your situation!	293
まぁ、信じてみいな	Everyone, please trust me.	301
わかった……仕方ない	I guess we have no choice	302
信用できない	No way	303
う～ん、仕方ないな	Hmmm, I guess I have to	311
やっぱり信用できない	How can I?	312
これやな！	This must be it!	313
それじゃあ、誰にも持ち出せないな	Then no one could take it.	321
う～ん、むずかしいところね。ここにあるのは神殿の模型なの	Hmm, it's pretty hard. You see this is a model of the Temple.	322
この模型には、しかけがあってパズルをといていくとどんどん模型が小さくなるんだって	And inside it is a device, which gets smaller each time you solve a puzzle.	323
なまあたたかい…	It's warm…	331
やばいな……	This isn't good…	332
CLOUD…………うしろ	CLOUD… …behind you.	333
そうやな～。それも、ひさしぶりですねぇ	Say, that's right… I haven't done it in a while, huh?	341
わくわくしますなぁ～当たるも～CAIT SITH当たらぬも～CAIT SITH	I'm so exited. Right or wrong, I'm still the same 'ol me	342
ほんな、なに占いましょ？	Now, what should I predict?	343
そうですか？ほんな、いいますよ	Is that so? Then I'll tell you.	351
ええかんじですよ。おふたりの相性、ぴったりですわ！	Looks good. You are perfect for each other!	352
AERISさんの星とCLOUDさんの星！すてきな未来が約束されてます！	AERIS's star and CLOUD's star! They show a great future!	353
どないなったんやろ？	What happened?	361
まだ動けるようやな	I can still move more.	362
あれが、黒マテリア……	That's the Black Materia…	363
キーアイテム『黒マテリア』を手にいれた！	Got Key Item "Black Materia!"	371
これを俺たちが持ってるかぎりセフィロスはメテオを使えないってわけだ	As long as we have this, Sephiroth won't be able to use Meteor.	372
俺たちは使えるのか？	Can you guys use it?	373
いや、しかし……	No, but…	381
セフィロスは、ちがう。古代種じゃない	Sephiroth is different. He's not an Ancient.	382
約束の地は見つけられないはずだ	He shouldn't be able to find the Promised Land.	383
さあ、目をさませ！	Wake up!	391
だ、だまれ！	Sh…shut up!	392
う……うるさ……い……	The…noise…	393
……ごくろう	…Well done.	401
CLOUD、だいじょぶ？	CLOUD, are you all right?	402
……俺はセフィロスに黒マテリアを……？	…I gave the Black Materia to Sephiroth?	403
CLOUD、何してるの！？	CLOUD, what are you doing!?	411
んがーー！！！CLOUD！！	Urrggggggh!!!! CLOUD!!	412
おい！　CLOUDてめえ！	HEY! CLOUD, you #$#&@!	413
こりゃあかん！えらいときにきてしもた！	Oops! This looks like a bad time!	421
ボク、CAIT SITH２号機です～。よろしゅうたのんます～！	I'm CAIT SITH No. 2. Right pleased to meet you all!	422
ボク、CAIT SITH２号機です～。なかようしてください～！	I'm CAIT SITH No. 2. Pleased to meet you all!	423
ボク、CAIT SITH>２号機です～。ほな、よろしゅうたのむわ～！	I'm CAIT SITH No. 2. Pleased to meet you all!	431
ボク、CAIT SITH２号機です～。なかよくしてな～！！	I'm CAIT SITH No. 2. Pleased to meet you all!	432
CLOUDさん！！なにしてまんねん！！	CLOUD!! What are you doin'!!	433
そして、CLOUDは自分のこと考えて	And CLOUD, you take care of yourself.	441
自分が壊れてしまわないように、ね？	So you don't have a breakdown, okay?	442
ここは……どこだ？	What is this place?	443
おやおや……私たちの邪魔をする気のようだ。困った娘だと思わないか？	Hmm… So she's going to interfere? She'll be a difficult one, don't you think?	451
そろそろあの娘にも…	We must stop that girl soon.	452
万年前の地層	[Empty Entry]	453
そうか……でもよ、そうも言ってらんねえぜ	Oh… Better keep it to yourself.	461
そんなとこだろうな。ま、あんまり悩まねえこった	I guess that's right. Well, don't worry too much about it.	462
あのね、CLOUD。AERISがいなくなっちゃったの	You know, CLOUD. AERIS is gone.	463
おい！おまえ、なんだってチンタラしてるんだ？	Hey! Why are you still sittin' around?	471
いやだ	No.	472
俺、またおかしくなるかもしれない	I might lose it again.	473
あのな、考えてみろよ。自分のこと、全部わかってるやつなんて世の中に何人いると思ってんだ？	Just think about it… How many people in this world do ya think really understand themselves?	481
誰だって、わけわかんねえからあ～だこ～だ、なやむんだろ？	People get depressed in life because they don't know what's up.	482
それでもみんななんとか生きてる。逃げ出したりしないでよう。そういうもんじゃねえのか？	But, they go on living. They don't run away… That's just how it is.	483
待ちな、TIFA。しばらく時間をやろうぜ	Wait a minute, TIFA. give him a little time.	491
これは、あいつが自分自身で決着をつけなきゃならねえことだ	He has to decide this on his own.	492
信じてるんだろ、CLOUDを	You believe in CLOUD… right?	493
もし、セフィロスと会ってよまた、おまえがおかしくなっちまったらそん時はそん時だぜ	Even if you do go nuts again when you see Sephiroth… If it happens, it happens.	501
オレがぶんなぐって正気にもどしてやるからよ！	I'll go upside your spikey head and bring you back to normal!	502
CLOUD、大丈夫よ。みんながついてるじゃない	CLOUD, it'll be all right. We're all with you.	503