ようこそ、自然主義者の村。ボーンビレッジへ	Welcome to Bone Village, a town for nature lovers.	自然主義者村	scene_29
何をしている？	What are you doing?	何	scene_29
ありがとう	Thanks		scene_29
もういい	That's enough		scene_29
文字通りカギとなる石さ。どこかの金持ちが持っているって話だな	Just like it sounds. A rock that's a key. I heard that some rich guy has it.	文字通石金持話	scene_29
古代種の都？ああ、忘らるる都のことだな	The City of the Ancients? Oh, you must mean the Forgotten City.	古代種都忘	scene_29
ただ、生きる。喰って、畑仕事して、ねる	Just live. Eat, work, and sleep.	生喰畑仕事	scene_29
何もいらない	Don't want anything	何	scene_29
かいものをしたい	I want to buy something		scene_29
ちょっといい宝	Good treasure	宝	scene_29
ハックツ品は上のテントわきのハコの中にあるぜ	Everything already excavated is in the box next to the tent.	品上中	scene_29
ルナ・ハープという楽器があれば【眠りの森】は目をさますはず	You can awaken the Sleeping Forest if you have the Lunar Harp.	楽器眠森目	scene_29
下のテントにいる男に聞いてな	Ask the guy in the tent below.	下男聞	scene_29
お金がたりないので配置しませんでした。	Could not position the staff, due to a lack of funds.	金配置	scene_29
地下調査する地点まで移動し□ボタンで 決定してください。穴をほって調査します。 ？？？	Move to the dig point and press [SWITCH] to select. The staff will dig for the item.	地下調査点移動決定穴	scene_29
すこし前に、若い娘さんがこうやってなんか話してたんだ	Just a while ago, a young girl asked me the same things.	前若娘話	scene_29
すこし前にな、黒い服の男がこうやって森の中に入っていったんだよ	While ago, a man in black came and said this as he went into the forest.	前黒服男森中入	scene_29
あれが……古代種の都『忘らるる都』なのか	So that's……the capital of the Ancients The Forgotten City'.	古代種都忘	scene_29
……ダメだ。おれには、わからない	…No good. I can't understand.		scene_29
……古代種の意識？	…Consciousness of the Ancients?	古代種意識	scene_29
おわっ！	Whoa…!		scene_29
誰だ？　オレ様の頭を のぞこうとするのは？	Who is it? Who's trying to peek into my mind?	誰様頭	scene_29
あっ、ベッドがあるよ	Look, there's a bed here.		scene_29
ここの住人が使っていたものか？	I wonder if the owners used this?	住人使	scene_29
つかれもたまってきたしちっと休んでいかねぇか？	I'm beat. Why don't we get some rest?	休	scene_29
ベッドがある。	Here's a bed.		scene_29
……りくつじゃない。感じるんだ、おれの心が	…It's not an excuse. I feel it in my soul.	感心	scene_29
おい、何時だと思ってんだよ！	Do you know what TIME it is!?	何時思	scene_29
な、なんだって！セフィロスが！？	Wh, what! Sephiroth!?		scene_29
うっそ～！セフィロスなんてお呼びじゃないのに～	No way---! Sephiroth wasn't invited!	呼	scene_29
でも、どうしてそんなことがわかるの？	But how can you tell?		scene_29
でも、なんでそんなんがわかるんですか？	But how can you tell that?		scene_29
ど、どうしよう？急がないと、大変なことになるよ！	Wh,…what should we do? We must hurry to her!	急大変	scene_29
それが本当なら、急ぐべきだ。取り返しのつかないことになる。	If that's true, we should hurry. Something terrible could happen at any moment.	本当急取返	scene_29
AERISの声の聞こえた方向……あっちか？	AERIS's voice…… Coming from there?	声聞方向	scene_29
ち、ちょっとCLOUD	Hey, hey CLOUD.		scene_29
お……おい、CLOUD	H…ey, CLOUD		scene_29
ち、ちょっと待ってぇ～な	Wa------it!	待	scene_29
そっちの方角へ行くと北の山に出ちまうぜ。はやくAERISをさがそうぜ	That way goes to the Mountains up north. Let's hurry and find AERIS.	方角行北山出	scene_29
AERISさがすんでしょ！雪山の方行って、ど～すんの！サイテ～！	We're looking for AERIS, right! Then why are you heading for the mountains!? What a dork!	雪山方行	scene_29
やめて！	Stop!		scene_29
バカッ！	Dumb #^%@!		scene_29
……AERIS	…AERIS.		scene_29
私はそこで新たな存在として星と一体化する。その時はその娘も…	There, I will become a new being by uniting with the Planet. As will this girl…	私新存在星一体化時娘	scene_29
AERISは、もうしゃべらないもう……笑わない泣かない……怒らない……	AERIS will no longer talk, no longer laugh, cry…or get angry…	笑泣怒	scene_29
何を言っているのだ？おまえに感情があるとでもいうのか？	What are you talking about? Are you trying to tell me you have feelings now?	何言感情	scene_29
なぜなら、CLOUD。おまえは……	Because, CLOUD. You are…		scene_29
俺が……人形？	I'm…a puppet?	俺人形	scene_29
……何が言いてえ？	What're ya tryin' to say?	何言	scene_29
なんや、いきなりあらたまって。どないしたんですか？	Why're you being so formal? Is something wrong?		scene_29
……俺の中には俺の知らない部分がある	…There is a part of me that I don't understand.	俺中知部分	scene_29
だから俺はもうこの旅をやめた方がいいのかもしれない	That's why I should quit this journey.	俺旅方	scene_29
俺は……俺は、行かなくてはならない	I… I must go on.	俺行	scene_29
……でもよ、なんだかよ……	…I dunno‚ man…		scene_29
アタシにまかせな！	Leave it to me!		scene_29
まだ、チャンスはある。セフィロスがメテオを使う前に黒マテリアを取り返すんだ	We still have a chance. We must get that Black Materia back before Sephiroth uses it.	使前黒取返	scene_29
前にも聞いたぜ	I've heard all this before.	前聞	scene_29
……そういう自分が俺の中にいる	…It's something inside me.	自分俺中	scene_29
それで……頼みがあるんだ	But…I have a favor to ask of you.”	頼	scene_29
……なるほど	…I see.		scene_29
ここまでのゲームの状態をメモリーカードにセーブしますか？	Save the game to this point on your computer?	状態	scene_29
現在はまだここでセーブできません。	You still haven't saved your game.	現在	scene_29
セフィロスは……どっちに行ったのかな？	Sephiroth… which way did he go?	行	scene_29
セフィロス……どこへ向かった？	Which way did Sephiroth head?	向	scene_29
お、おい！大丈夫か？	Ey, hey! You alright?	大丈夫	scene_29
……うっ	…ugh.		scene_29