アイシクルロッジ	Icicle Inn	1
この先に、何があるんだ？	What's down there?	2
ボス……ツォンのことか？あれは俺たちじゃない。セフィロスが、やったんだ	You mean Boss…Tseng? That wasn't us. Sephiroth did it.	3
いいえ、だまされるもんですか	No! Liar! Don't think you can fool me!	11
いくら、しらをきってもムダよ。絶対、許せない！！	Don't try to act innocent. I'll never forget it!!	12
口で言ってもムダなんだったら体に聞いてもらおうじゃないの！	Looks like just talking won't do. You're going to have to feel some pain!	13
えっ？　ええ……	What?  Yeah…	21
この村は、しばらく閉鎖だ！	This village is now under martial law!	22
（すなおに、したがう）	(Do as you're told)	23
ダメダメ！！この先は、すごい下り坂なんだ	No, don't!! There's a steep grade, past here.	31
キケンだから、入らないでくれ！	It's dangerous, please don't go!	32
それでも行く	I'm still going	33
えんりょする	No thanks	41
つまんねぇヤツだな！	You're so boring!	42
さっきは、逃げ出してしまって……何かヤバそうな感じだったんでな	Sorry I ran off a while ago… I thought there was going to be trouble.	43
北の果てのクレーターにバリアが、はられているんだ！この先は、行かないほうがいいぜ	There's a barrier at the North end of the crater! You shouldn't go any further.	51
とっても、まぶしい光がクレーターのバリアを突き破ったんだ！いったい、何が起こっているんだ！？	A bright light shattered the barrier at the crater! What in the world's goin' on!?	52
この村に引っ越してきていきなり、黒マントの男が北に向かうのを見たんだ	When I first moved here, I saw a man with a black cape heading North.	53
お山さんが泣いているんだね、きっと。どこか、ケガしてるのかな？	The mountain must be crying. Is it hurt?	61
もうすぐ完成なのよ！	It's almost finished!	62
お山のてっぺんにバリアがはられているんだって	I heard that there's a barrier on top of the mountain.	63
【方向キーの下】　　ブレーキ	Directional button [down]Brake	71
□ボタン　　ブレーキ	[SWITCH]Brake	72
×ボタン　　ジャンプ	[CANCEL]Jump	73
あの子ったら、引っ越してすぐにケガしちゃうんだから……	My boy got hurt right about the time we moved here…	81
スノーボードなんか買ってあげるんじゃなかったわ	I never shoulda got him that snowboard.	82
私にも教えてねっ！おねがいよ	Teach me too, OK!?	83
おばぁちゃん火の近くで眠っちゃダメよ！	Grandma, don't sleep so close to the fire!	91
おばぁちゃん、カゼぎみでねこのごろ元気がないのよ……	Grandma's been sick for a while and doesn't have much energy…	92
ついつい、イイ気持ちになってね	I just get SO comfortable.	93
オレは、あの坂をスキーで挑戦してみようと思ってるんだ	I'm thinkin' 'bout taking that hill on my skis.	101
こんなに急に気温が下がったのは初めてなんだよ……	It's the first time that the temperature has dipped this low, this fast…	102
北の果てに不思議な光も見えるしこれが世界の終末っていうやつかね？	There's also that mysterious light at the Northern limits, too. Does this mean it's the end of the world?	103
じぃちゃん起きて！お客さんだよ！！	Grandpa, wake up! We have a customer!!	111
今日は、いちだんと寒いねぇ	It's colder than usual today…	112
２００ギルだが、泊まっていくかい？	It's 200 gil , you wanna spend the night?	113
パブ	Icicle Inn Bar	121
バーテン	Bartender	122
なんでも、この村の北の大氷河には温泉ぎらいの雪女がいるらしいとか……	I've heard there's a snow woman at the Great Glacier that hates hot springs…	123
けどな、っていったいどうしたんだよ？	Whadaya mean?	131
神羅と古代種…なんか、怪しいニオイがするよな	Shinra and the Ancients… I smell somethin' fishy…	132
おれたちも早くこの町を出た方がいいかもしれんな	Maybe we'd better leave town soon too.	133
そのつもりだ	That's my plan	141
ちがう	No	142
そうかぁ…いや、この村より先に行くには地図でもなければムリだぜ	Well…if you're going past this town you'll need a map.	143
なによ、ツンとしちゃって感じ悪～い！	What's with you!? You make me sick!	151
あの人の話の相手とってもつまんなかったの	I got bored listening to his stories.	152
へぇ～、そぉなの？	Oh yeah?	153
ウェポンとは？	What is "Weapon?"	161
プライベート	Confidential	162
見ない	Don't watch	163
イファルナさん……少し休みましょう	Ifalna… Let's take a break.	171
北の大空洞に現れた、その者とはいったい何者なのですか？	Who is the person that appeared at the North Cave?	172
まるで見当がつかないのですが	I haven't any idea.	173
何千人ものセトラが力を合わせました。星の傷をいやそうとしたのです……	Thousands of Cetra pulled together, trying to heal the Planet…	181
でも、その傷はあまりにも深く星自身が長い年月をかけて治す他はなかったのです	But, due to the severity of the wound, it was only able to heal itself over many years.	182
いえ、そういう力ではありません。星の上にあるもの全ての生命力がエネルギーになるのです	No, it's not that kind of power. The life force of all living things on this Planet becomes the energy.	183
その姿は、亡き母の…亡き兄のものでした。それぞれに過去の幻影を見せるのです	It looked like…our…our dead mothers …and our dead brothers. Showing us specters of their past.	191
その者は親しげな顔でセトラたちに近づき…あざむき…そして……ウィルスを…ウィルスを与えたのです	It first approached as a friend, deceived them, and finally… gave them the virus.	192
その者は、ノルズポルと同じように別のセトラの部族に近づき………そしてまた…ウィルスを……	Then, just as it had at the Knowlespole. It approached other Cetra clans… and infected them with…the virus.	193
少数の生き残ったセトラたちがジェノバに討ち勝ち、そして封印したのです	A small number of the surviving Cetra defeated Jenova and confined it.	201
星はウェポンを生みだしました……しかし、使う必要がなくなったのです	The Planet produced Weapon… But it was no longer necessary to use it.	202
ウェポンが消えることはありません。…この星のどこかで眠っているのです	Weapon cannot vanish. …It remains asleep somewhere on the Planet.	203
………そう言わないでくださいよ	… Please don't say it that way.	211
ワ、ワタシと……ア、アナタのとってもカワイイ娘なんですよ！	It's our lovely daughter, both yours…and mine!	212
彼女のすくすくと育っていく姿を残しておきたいと思いませんか？	Don't you want to capture her childhood on videotape?	213
くっ……私は神羅とは手を切ったのだ	That's it! I'm severing all ties with the Shinra.	221
宝条くん、帰ってくれたまえ	Hojo, please leave.	222
イファルナ！	Ifalna!	223
クスクス……ええ、そうね	I'll send them away.	231
は～い、いますぐ！！	Yes, at once!!	232
だれかしらね？	Who the devil?	233
ほう、AERISちゃんですか？いい名前だ……クックックッ	Hmm, AERIS? What a nice name. Ha, ha, ha.	241
私の実験にはあなたたち、みんなが必要なんですよ	I'll need all of you for my experiment.	242
ガスト博士、わかってくれますよね。この星の運命を変えることができるんですよ！	You understand don't you, Professor Gast? We can change the future of the Planet!	243
あっ、ビデオをとろうと思っているんですよ	Oh, I'm thinking of taping it on video.	251
でも、なんだかビデオの調子が悪くて……	But, the video's not working right…	252
いえ、そんなことではないです。カワイイわが子をとるんですよ	No, that's not it. I'm going to record my beautiful daughter.	253
ウフフ……あなたのカタイ頭で考えたにしては上出来じゃないかしら	Hee hee…it's a good name, considering it came out of that forgetful head of yours!	261
う……	Ugh…	262
なんとか、飛び越したようだな	I guess we're still in one piece.	263
ああ、大丈夫だ	Yeah, I'm all right.	271
やってらんねえぜ　まったくよー	I'm too old for this! Damn!	272
いったいどこへ落ちたんだ？	So where did we land?	273
おう、あれだ！なにかもらったろ？□ボタンで見ようぜ	Hey, what's that!? You just got something, right? Use [SWITCH] to see it.	281
よし、地図を見よう。□ボタンで広げるんでしょ？	All right, let's look at the map. We use [SWITCH], right?	282
ほな、地図でも見よか。ええからはよひろげぇな。□ボタンや	Then, let's look at the map. Just push [SWITCH].	283
かまわないでください	Don't worry about me.	291
あなた方に危害を加えるつもりはありません	Now, I don't want to hurt any of you.	292
もう近寄らないでください	And don't come back again.	293
『アレクサンダー』のマテリアを手にいれた！	Received "Alexander" Materia!	301
これを渡るしかなさそうだ……	The only way is to cross…	302
しかたがないな	That's the way it goes…	303
オオッ、これは珍しい！！	Now, this is a surprise!!	311
人に会ったのは 何年ぶりだろう……	It's been years since I last saw anyone up here.	312
おっと失礼！　わたしの名は、ホルゾフ。この地に住みついて、もう２０年だ	Oh, I'm sorry, my name is Holzoff. I've lived here for 20 years.	313
きみたちは、大氷河で倒れていたんだ。無事だったのはきせきだな	You collapsed at the Great Glacier. It's a miracle you're alive.	321
わたしの名は、ホルゾフ。この地に住みついて、もう２０年だ	My name is Holzoff. I've been living here 20 years now.	322
これから先、北に向かうつもりならわたしの話を聞いていきなさい	If you are planning to head north, you'd better listen to me.	323
わたしと友人ヤマスキーが初めて絶壁に挑んだのは３０年前のことだ	The first time my friend Yamski and I tried to climb the cliff was 30 years ago.	331
この地には、大昔に何かが空から降ってきたという言い伝えが残っているんだ	There's an old legend that says something fell from the sky here a long time ago.	332
どうやら、その時に大地がもりあがってできたのがこの絶壁らしい	It's supposed to have pushed the land up and formed this cliff.	333
１つめは雪におおわれて見つけにくくなっている登山ルートをよく確認すること	First, check your route… It's hard to find because of all the snow.	341
２つめは絶壁の途中のタナに着いたら必ず下がった体温を回復させること	Second, warm yourselves up once you get to a ledge.	342
わかったかい？	Understand?	343
こんなところに住めって言われたらオレは、迷わずカンベンしてくれって答えるぜ……	But, if anyone ever told me to live here, I'd tell them to…well, you know…	351
でも、もし住むことになったらきっと、いろいろ工夫して居心地よくしようとすると思うんだ	I tell you one thing though, If I did have to live here I'd change things around 'n' make it better.	352
そんな人間の工夫の行き着いたところが…………ミッドガルなのか	I guess Midgar is the total opposite of this place.	353
絶壁のぼりきったらどうなってんのかな？　見たいな～	I wonder what's at the top of that cliff? Well we shall see…	361
う～、こんな寒いところもう、たえられない！！	Brrrr, I can't take this cold!!	362
クッソ～ィ！空を飛べればよ、絶壁なんてヒュ～～ッなのによっ！	Damn! If I was back in the air, this cliff would be nothing!	363
絶壁内部	Inside of Gaea's Cliff	371
『ジャベリン』を手にいれた！	Received "Javelin"!	372
これいじょうマテリアは持てません。なにかマテリアをすててください	You can not take on any more Materia. Please discard some Materia.	373
『烈火の腕輪』を手にいれた！	Received "Fire Armlet"!	381
下の部屋に飛びおりますか？	Jump down to the room below?	382
左に進む	Go left	383