…ぶ…しい……	…ding…	1
あんっ？	Huh?	2
まぶしいね……	The glare…	3
きっと……生きているよね	Is he still…alive?	11
私……どれくらい眠ってた？	How long…was I asleep?	12
え～と……あれから７日たってるはずだぜ	Let's see now… Must've been about 7 days.	13
あれが地上に出てきたんだ。古代に生きていた伝説の巨獣だって話だぜ	Well it's up here now. They say it's some legendary monster from the past.	21
ウェポン……はセフィロスを守っているの？	Weapon…is protecting Sephiroth?	22
わからねえ。でも、とにかくそいつらが現れて世界を襲い始めた	Dunno. But he's been goin' around tearin' stuff up.	23
CLOUDをどうするつもり！	What are you going to do to CLOUD?	31
セフィロスの分身……か	Sephiroth's alter ego…	32
メテオを呼んでしまった今となってはおはらいばこのようだな	Meteor has been summoned… Essentially, it's all but over now.	33
腕をしばらせてもらおうか	I'll tie your arms now.	41
こら！　まっすぐ進め！	Hey! Walk straight!	42
みなさんお集まりになった？この者たちが世界をこんな混乱に落としめた張本人たちよ！	Is everyone here? These are the ones who brought this madness to the world!	43
さ、まずはこの娘からよ	We'll start with this girl.	51
やるんならまずオレからやれ！	If you've gotta do it…take me first!	52
ほらほら、カメラさん、こっち！こういうお涙ちょうだいしばいが最高にウケるのよね！	Camera, this way! Make sure you get this, the audience just eats up tearful goodbyes!	53
BARRET助けて！！	BARRET, help!!	61
息をとめてろ！少しでも長くガマンするんだ！	Hold your breath! Hold on as long as you can!	62
むちゃ言わないで！とめるって言っても限界があるわ！	Come on! I can't hold on forever!	63
ガスをとめるボタンは……？	Which button stops the gas?	71
開いてぇぇぇーーーーー……	Open it---	72
さ、楽しいショウが始まるわよ。キャハハハハ！	Well now, the show's about to begin. Ha, ha, ha !	73
おや、お前は逃げないでいたの？感心感心……なに？　気持ち？今の気持ちねえ……	Hmm, so you didn't run? I'm impressed. How do I feel? Right now…	81
ンガーーーッ！	Nngaaaaaahhhh!	82
なにっ？！　さいみんガス？	Huh!? Sleeping gas?	83
多分別の部屋からガスルームのとびらをロックしてるんだ！	The Gas Room's probably locked from a different room!	91
しゃあない、作戦チェンジですわ。いっぺんこの部屋から出ましょ	Hmm, we gotta go with a different plan. Let's get out of this room first.	92
TIFA！かならず助けてやっからな！	TIFA! I'll help you, I promise!	93
おバカさんたちね。これでもう、この娘は助けられないわよ	Fools. Now, you can't save the girl.	101
キャハハハハハハハ	Ha, ha, ha, ha !!	102
チックしょーー！！	Goddammit!!	103
大きな声ださないでよ……アタシよ、アタシ！　YUFFIEよ！	Don't make so much noise. It's me, ME! YUFFIE!	111
なんでこんなところに！？	The hell you doin' here!?	112
説明はあと！さ、エアポートへ急いで！	I'll explain later! Now we gotta get to the airport!	113
発射ーーーーーーーーーーーーーーーーー！！！	Fire----!!!	121
準備ととのいました！	Ready!	122
やったか？	Did we get 'em?	123
それまで通常兵器で時間をかせげ！	Then use regular fire power in the meantime!	131
は！　全砲門開け！目標ウェポン！　陸にあげるなよ！	Yes sir! Open all artillery doors! Target: Weapon! Don't let it land!	132
速度７０ノット！	Speed, 70 Knots!	133
ガス処刑は無理だったけどここから落ちて水面にたたきつけられて死ぬってのもス・テ・キ、かもしれないわね	The execution may have been unsuccessful, but your death by falling and crashing into the water below might still be pretty exciting.	141
最後までなまいきね！	Stuck up to the end!	142
やったわね！	How can you!?	143
○ボタン　和手うち	[OK]…Slap	151
さっきからパンパンいたいのよ！この年増女！！！！（○ボタンを押せ！）	Quit slapping me! You old $*&^%!!! (Push [OK]!)	152
さ、連れていきなさい	Take her away.	153
ちょっとホッペタ痛いけどね	My cheeks hurt a bit.	161
それより、これ、どういうこと？	Forget it, what's all this about?	162
まぁ、くわしい話はあとで適当に聞いといてくださいな	Well, I'll catch the details later.	163
オレはよ……TIFAともサヨナラかと思ったぜ	I thought… TIFA was gone for good.	171
すんませんな～でも、敵をあざむくにはなんとやら、ですわ	Sorry, but I had to do something to trick the enemy.	172
さ！　みなさん待ってますから！	Come on! Everyone is waiting!	173
CIDさんごくろうさまです！	CID, thank you for a job well done!	181
ごくろうさまです！手をはなせないので、このまま失礼します！	My hands are full, so I'll excuse myself here!	182
飛空艇操作	Fly Airship	183
【方向キー　右】　　右へ！	[Directional button:right]  move right	191
【Ｌ１ボタン】　　　左へ！	[PAGEUP] arc Left	192
【Ｒ１ボタン】　　　右へ！	[PAGEDOWN] arc Right	193
ボクたちハイウインドのクルーは毎日毎日ハイデッカーにコキ使われていました	Working on the Highwind, we spent every day slaving under Heidegger.	201
あの人、社長にしかられるとすぐにクルーにやつあたりするんです	Whenever he got yelled at by the President, he'd immediately take it out on the crew.	202
ボクたちは、ず～っとガマンしてました。なぐられてもなぐられても	We put up with this all the time, even when he beat us.	203
CIDさんはハイウインドがあれば旅が楽になるとおっしゃりました	CID said that if he had the Highwind, things would be a lot easier.	211
なんと、星を救う旅だそうですね。ホント、感動しちゃいましたよ	And now here we are off to save the Planet. It's true. He really overwhelmed me.	212
それで、ボクたちは協力することにしたんです	And that's why we decided to help.	213
あれっ？　CIDさんってば忘れちゃったんですか？あ、ボクが覚えてるかどうかテストしたんですね！	Huh?  Don't you want to test my memory on how we met CID?	221
雑談なんてとんでもないです！ボク、ちゃんと仕事してますよ！	I'm not just shooting the breeze! I'm also working!	222
あ、そうそう。チョコぼうは使ってますか？	Oh, yeah, yeah. Are you using Chocobos?	223
はぁ……はぁ……	Ugh…ugh…	231
なに？　どっかついた？	What? Are we there?	232
強いウータイのためとはいえアタシ、つらいよ	I know it's all for Wutai, But I can't take much more of this.	233
それはヤメテ！行くんなら、アタシ、つれてかないで	Quit it! If you want to go, then just leave me behind.	241
……うう。何言ってるんだ、アタシ……	…ooooooh. What're you talking about? I…	242
パイロット……どんなやつ？	What's the pilot like?	243
字を読むと気分が悪くなる。船酔いがひどくなるからな	Whenever I read, I get airsick.	251
はぅ……	Oh yeah?	252
それ、よくわかるから何も言えないよ……	I'm the same way, so I can't say too much.	253
俺の研究によると……	Well, according to my research…	261
まず、緊張していると酔わないな	First off, if you're nervous a lot, you won't get sick.	262
しかし、常に緊張しているわけにもいかない	But you can't always be nervous.	263
まあ、一度酔ってしまったら何をやってもどうしようもない……	Once you get sick, there's nothing anyone can do.	271
つらいところだよな……	I know it's tough…	272
あ、でも仲間がいるからちょっとだけ、元気でたよ	…So you’re a little better off than me.	273
はい、世話は私におまかせください	I'll take care of it for you.	281
え？　チョコボの育て方？う～ん、それは私もよく知りません	What? How do you raise a Chocobo? Can't say I know much about that.	282
チョコボ育てのことならミッドガル近くの【グリン＆グリングリン牧場】で話を聞けばＯＫだと思いますよ	If you want to know about raising Chocobo, there's a Chocobo ranch near Midgar. You should ask them.	283
メンバー……足りないね	Not enough crew.	291
CLOUDがいないとダメかい？	Do you think we aren't strong enough without CLOUD?	292
オイラたちだけじゃ星を救えないのかな？	Do you think we can't save the Planet alone?	293
いつもそうしていたみたいにちょっと気取ったポーズで言ってくれるの	…stand that cocky little way he did, and tell us what to do.	301
だいじょうぶだよ、TIFAって	He'd say, 'Everything's under control, TIFA.'	302
TIFA！　いつからそんなに弱い女になったんだよ！	TIFA! When'd you become such a wimp!	303
カッコつけてるかと思えば間の抜けたこともする	Just when you thought he was cool, he'd do some damn fool thing.	311
やたら物知りなヤツだと思えばあたりまえのことも知らない	Then when you thought he was smart, he'd show how stupid he was.	312
動き方も話し方もなんかチグハグなんだよな	Everything about him from his movements to his speech were kinda odd.	313
地中の奥深く……ライフストリーム？	Deep within the earth…are you talking about the Lifestream?	321
そのライフストリームが海底スレスレを通っていてときどき地上に吹き出す	The Lifestream sometimes gushes out from cracks in the ocean floor to the surface.	322
そんな場所があるって話を聞いたことがあるんだ	I heard about such a place.	323
そうだ、ネエちゃん	Oh, and TIFA…	331
ま、目的はなんにせよ準備が必要だろ？	No matter what your goal is, you've got to be prepared.	332
ＯＰＥＲＡＴＩＯＮって部屋でちょこっと準備してこいよ	Go to the Operation room and get ready.	333
ま、人生いろいろだ～なぁ	Well, it takes all kinds.	341
さ～て、どうするよっ！オレたちに出来ることはなんだ？	What're we gonna do now! What can WE do?	342
ん～っ？なんかねえのか？	Huh? Ain't there nothin' we can do?	343
さて……我々はふたつの課題を抱えている	Now then… We're faced with two issues.	351
１　メテオの破壊２　北の大空洞のバリアを取り除きセフィロスを倒す　　　　　　	1 Destroy Meteor. 2 Remove the barrier around North Cave and defeat Sephiroth.	352
何か作戦は？	Any ideas?	353
すでにニブルヘイムは回収終了。残るはコレルとコンドルフォート	We've already collected Materia from Nibelheim. All that's left are Corel and Fort Condor.	361
コレルにはすでに軍隊を向かわせております	I've already dispatched troops to Corel.	362
ヒュージマテリアは魔晄炉内で圧縮されて生成される高度に集積された特別なマテリア	Huge Materia is a high-density, special type of Materia made through a special compression process in Mako reactors.	363
……そうか。CLOUDが……	I see… CLOUD has…	371
たしかにライフストリームが集まっている場所は世界にいくつかある	It's true that there are several places on the planet where the Lifestream is gathered.	372
ただそのほとんどははるか地の底で、とても人間の手のとどく場所ではないんじゃ	But most of those places are below the surface where humans cannot reach them.	373