あら、こんにちわ。彼女、いつも彼につきっきりよ。よっぽど大切な人なのね	She's always there right by his side. She must really love him.	1
いい、たとえどんな時でも彼女みたいに、強くならなきゃ	Even at a time like this You've got to be strong like her.	2
そうそう、彼、時々ナンバーがどうのってつぶやくんだけど……なんのことなのかしら？	Sometimes he mumbles about numbers… I wonder what it means?	3
……。俺……。ナンバー……いくつ？	…what… What number….am I?	11
CLOUD……ぜんぜんよくならないの……	CLOUD… I don't understand a word.	12
バカだな、私……。CLOUDに、なにをしてあげられると思ってたんだろ……	I'm such a fool…… I thought I could do something to help…	13
キャーッ！わ、わたし、ダメなのよ、地震！！	Eyaaah! I hate earthquakes!!	21
なんかマズイよ……。ユレが、どんどんひどくなってくる	Oh god… The tremors are getting worse.	22
ちょっと待ってて、CLOUD	Wait a minute, CLOUD.	23
オッケー、バッチリよ！それじゃ、気をつけてね	OK! Perfect! Well then, take care.	31
ちくしょー！！ウェポンの野郎めが！！	Damn!! That &%$^%$ Weapon!!	32
よりによって、こんな時にあらわれやがって……！	Of all the times to show up!	33
なんとか、ライフストリームもおさまったようですな	Looks like the Lifestream's back under control, too.	41
あいつ、いつか絶対ぶっとばしてやるからなあ！	I swear, next time, that guy's dead meat!	42
ライフストリームの方もなんとかおさまったみたいだね	Well at least the Lifestream's back to normal.	43
そんでも、CLOUDさんたちが……！？	But what about CLOUD and the others?	51
バカ野郎！！ひとのこと心配してる場合か！？いつストリームが吹き出すか……	Goddammit!! Don't have time to worry about anyone other than yourself! Don't know when that stream'll blow…	52
時間がない、急げっ！！	There's no time, hurry!!	53
いやッ、やめて……！！なかに入って来ないで！！	No! Stop it!! Stay back!	61
だれか、助けて……！おねがい……！！	Somebody…help! Please!!	62
助けて、CLOUDッ！！	CLOUD,help me!!	63
通じているの……ニブルヘイムに……？	It connects… to Nibelheim?	71
そうね……。たしかにそこからはじめるのが一番なのかもしれない……	That's right…It's probably best to start from there…	72
行ってみましょう、CLOUD。つらいかもしれないけど……。私がついてるから……	Let's go have a look, CLOUD. I know it's not easy… I'll be here for you…	73
ゴメンね、CLOUD	Sorry, CLOUD.	81
あの時のこと私がちゃんとおぼえていればもっと早くに……	If I had only remembered more clearly what happened, I could have done something sooner…	82
TIFAのせいじゃないよ。俺のせいだ	It's not your fault, TIFA.	83
私には……もう、なにも言えない……	There's nothing… I can say.	91
答えはあなたが、自分自身で見つけなきゃ……	You must find the answer yourself.	92
それが見つけられないと……あなたは……	If you can't, then…	93
ねえ、CLOUD、それなら……ほかの記憶は？	CLOUD, what about your other memories?	101
ううん、記憶じゃない	No, not memories.	102
記憶って、頭の中から無理矢理ひっぱりださなくちゃならないでしょ？	A memory is something that is consciously recalled, right?	103
そういえば、CLOUDはどうしてソルジャーになりたいって考えたの？	Now that you mention it, why did you want to join SOLDIER in the first place?	111
私には、あなたが突然決心したように思えたんだけど……	I always thought it was a sudden decision.	112
……悔しかった。……認めてほしかったんだ	…I was devastated. …I wanted to be noticed.	113
ごめんなさい……。なんのこと、言ってるの？	I'm sorry… But what are you talking about?	121
ううん……いいんだ。TIFA、あの時は大変だったしね	No…it's all right. You were having a hard time back then.	122
自分のことで手一杯だったからあの時のおれのことなんかおぼえてなくて当たり前だよ	You were so busy with your own things, it's only natural you don't remember me then.	123
う……あ、あ……！	Uh…* Ah, uh…	131
う……。TIFA……	Uh…% TIFA…	132
ああ、CLOUD……！本当にCLOUDなんだね！	Oh, CLOUD! It's really you, isn't it?	133
帰ろう、CLOUD。みんなのところへ……	Let's go back, CLOUD. Back to everyone…	141
ああ、そうだな……。帰ろう、TIFA。一練に……	Yeah, I guess so… Come on, TIFA. Let's go home…	142
母の名はジェノバオレを生んですぐに死んだ。	My mother is Jenova. She died right after she gave birth to me.	143
５年前……ここにふたりのソルジャーがやって来た……	Five years ago…two men from SOLDIER came…	151
セフィロスと……若くて陽気なソルジャー	Sephiroth and… a young and vibrant soldier.	152
その時のようす……もう一度教えて？	Can you tell me again what happened?	153
この人が……英雄セフィロス	So this is…the Great Sephiroth?	161
でもね、正直に言うとなんて冷たそうな人、って思ったの	But to tell the truth, I thought he was very cold.	162
イヤな予感がしたの、覚えてるわ	I remember a foreboding about him.	163
CLOUDは私の話にあわせてこの記憶をつくりだしたって言ってたけど……	CLOUD made up his memories by listening to my stories…	171
この星空は、CLOUDが自分で考えた……ううん、思い出したのよ	Did you imagine this sky? No, you remembered it.	172
星がとってもきれいな夜、CLOUDと私。ふたり、給水塔でお話した……	That night the stars were gorgeous. It was just CLOUD and I. We talked at the well…	173
生きては越えられない山……	No one crosses that mountain alive…	181
じゃあ、死んだ人は？	How 'bout those that died?	182
ママは山を越えていっちゃったの？	Did mama pass through the mountains?	183
TIFAにもしものことがあったらどうするつもりだったんだ！！	What if she dies!?	191
『TIFAは７日間意識不明だった』	TIFA was in a coma for seven days.	192
『死んでしまうかと思った』	We all thought she wouldn't make it.	193
あいつ入ってくる気かな？	You think he wants to come in?	201
この日、CLOUDが初めて私の部屋に？	Was that the first day you came into my room?	202
……そうだったよね	…that's right.	203
CLOUDはソルジャーになれたのかなって	I wondered if he was able to get into SOLDIER?	211
CLOUDの記事、あるかと思って新聞だって読むようになったのよ	I even started reading the newspaper, just to see if CLOUD was in any of the articles.	212
ママに……会いたい……--	I want…to see…Mom…	213
……そうだったね	…That's right.	221
俺は……みんなバカだと思っていた	I thought they were all…stupid.	222
えっ！？	What!?	223
『もしかしたら声をかけてもらえるかもしれない』	Just maybe, they would invite me in.	231
『そう考えてみんなのまわりをうろついていた……』	I thought that might happen, so I hung around…	232
どうしようもなくひねくれてた。そして……弱かった	I was so prejudiced. …And weak.	233
ありがとう、TIFA	Thanks, TIFA.	241
あとで、こいつに言ってやって。きっとよろこぶよ	Tell him what you told me, later. He'll probably be so happy.	242
あれっ？	Huh?	243
魔晄炉へ！　５年前の魔晄炉へ！	To the reactor! The Mako reactor of five years ago!	251
そう……これが……俺だ	Yeah…this is…me.	252
ソルジャーなんかじゃないただの兵士	Not in SOLDIER, just a common grunt.	253
あっ！　CLOUDじゃない！	Hey! It's CLOUD!	261
ザッ……クス……ザック……ス。ザックス……	Za…ck…Zac…k. Zack…	262
思い出したのね！！	You remembered!!	263
そうだったんだ……	That's what happened…	271
……いっしょにいたのね	…You were there.	272
私を見ていてくれたのね	You were watching me.	273
そ……んな……ばかな……	…It can't be!	281
おい、だいじょうぶか！？TIFA！？	Yo! You alright!? TIFA!?	282
う……ううん……？	u…unn…?	283
人間て、自分のなかになんてたくさんのものをしまってるんだろう……	People have so many things pent up inside of themselves…	291
なんてたくさんのことを忘れてしまえるんだろう……	So many things they can never forget.	292
ふしぎだよ……ね………………	Strange…isn't it?	293
ご命令をば！	Your command?	301
【ＰＨＳ】	(PHS)	302
【セーブ】	(SAVE)	303
さらに自分で見たことをまぜあわせて幻想の自分を創り出した……	And I created an illusion of myself made up of what I had seen in my life…	311
そしてその自分を演じ続けていたんだ	And I continued to play the charade as if it were true.	312
幻想かよ……そのわりには強かったじゃねえか	Illusion, huh? Pretty damn strong for an illusion.	313
それがみんなが知っていた俺………CLOUDだ	Everyone knew that. I'm…CLOUD.	321
……俺は幻想の世界の住人だった	…the master of my own illusionary world.	322
でも、もう幻想はいらない……俺は俺の現実を生きる	But I can't remain trapped in an illusion anymore… I'm going to live my life without pretending.	323
BARRETがよく言ってただろ？	It's like you always told me, BARRET.	331
おう、アレだな！	Oh, uh, you mean that!	332
なになに？　わからないよ！	What? I don't understand!	333
でも、いいんだ。これが……俺なんだ	But that's okay. That's the real me.	341
ほい、ここはミディール。ごらんのとおり元、のどかな温泉村じゃよ	Ahoy! This here's Mideel. As you can see, this used to be a quiet hot springs town.	342
なんもなくなってしまったがかえってさっぱりして気持ちいいくらいじゃわい、ホホッ	Everything's gone now but in a way, I'm kinda glad everything's cleaned out. Feels better this way, ho, ho.	343
まいどあり、のことね！お店、品モノないけどまた来てちょー、アルね	Thank you! We don't have many goods but you come again, please.	351
うっふっふー、いらっしゃい。来たわね。ついにこの日が来たわね！たっぷり買ってってちょうだい！	Hee, hee. Welcome It's here. The day's finally come! Your day to shop!!	352
え、アイテムや武器もないかって？しかたないわね。出血大サービス！５割増しってとこで、どう？	Do we have items and weapons!? Well, I should say so. And here's a bargain! What would you say to 50% off everything?	353
それにしても……不思議なもんじゃのうライフストリームというもんは	Isn't the Lifestream a strange thing?	361
わしらも死んだらこのやさしいぬくもりのなかへ帰ってゆくんじゃろうかのう……	When I die, I wonder if I'll float along in the middle of a warm gentle stream like this?	362
むむむ、君は……！？なんと、魔晄中毒から回復したのか！？	Hmph! You!? How did you get over your Mako poisoning?	363
いやだ、あげない！	Don't give it any!	371
野菜はあげられないな。わるいな、チビ助	Sorry, peewee But I can't give you any.	372
しょうがないな。ほら、食べろよ、チビ助	Well, I guess it won't hurt. Here, shorty, eat up.	373