お、おまえたち！？なぜここに？タークスのルードがいたはずだ！！	You…you! Why are you here? Rude of the Turks should've been here!!	1
残念だったな。ヤツなら、そこでたおれてるぜ	Too bad. Those guys are over there.	2
く～っ、あのタークスがあっさりやられるなんて……しかし、ここは通さんぞ！	Oh man…the Turks, being done in like that…  But, I won't let you through!	3
うう～興奮するぜ～！！	Urrrrgh. Man this is so COOL!!	11
ちょっと待ってくれ！	Wait a minute!	12
うるせぇぞ！！おめえは、だまってろい！	Shut up!! Just shut the hell up!	13
ホレ、ホレ！みんなに伝えてこい！	Hey, go ahead! Go tell everyone!	21
わかったよ、艇長。あとは、よろしくたのんだよ	All right, Captain. Good luck.	22
おい、CID！どういうつもりだ！？	Hey, CID! What're you doing!?	23
地ベタをはいずりまわってた人間が空を飛べるようになったんだぜ！	Humans only used to walk around on the ground but now they can fly!	31
そして、ついには宇宙まで行こうってんだ	And finally, we're about to go into outer space.	32
科学は、人間が自らの手で生み出し、育て上げた『力』だ。その科学が、この星を救うかもしれねえ	Science is a 'Power' created and developed by humans. And science just might be what saves this Planet.	33
うひょっ！	Hey-hey!	41
パルマー！てめぇ、何しやがった！？	Palmer! What the hell did'ya do!?	42
オートパイロット装置修理完了だってさ。だから打ち上げだよ～ん	They said they finished repairing the Auto-Pilot. So, I laun---ched it!	43
どうしよう？オイラたち、死んじゃうのかな	What should we do? Are we all going to die?	51
ちょいと、CIDのおっさん！なんとかしてよ！	Hey old man! Do something!	52
どないしょ！　どないしょ！	What shall we do? What shall we do?	53
こんな時のためにこいつには脱出ポッドがつんであるのさ	I keep an escape pod on the rocket just for emergencies like this.	61
脱出ポッドのロックを解除したぜ。メテオとぶつかるまえにとっとと、おさらばしようぜ	I deciphered the lock code on the escape pod. We'll bail right before we crash into Meteor.	62
さてと、こいつの航路はどうなっているのかな……っと	Let's see, how's the course set?	63
いらないのなら、アタシがもらっちゃお～かなぁ～	If you don't want it, maybe… you could…give it to ME!	71
ところで、ヒュージマテリアはどないするんですか？	By the way, what are we goin' to do with the Huge Materia?	72
ならば、残る間題はヒュージマテリアをどうするか、だな	Then the remaining question is what to do with the Huge Materia.	73
マテリア取りに行くんならこっちだぜ	If you're goin' to get the Materia, it's this way.	81
脱出ポッドはこちらです。急いで下さい	The escape pod is this way. Please hurry.	82
これが……宇宙……	So this is…outer space…	83
……ありがとう	…Thanks.	91
ヒュージマテリア……やっと見つけたぞ	I finally found the Huge Materia…	92
このコンソールパネルからパスコードを入力すればロックが解除される仕組みになってるぜ	It's structured so that the lock can be opened if we enter the passcode from this control panel.	93
３分後にプロテクトシステム作動	Protection System will activate in 3 minutes	101
ミスっちまったようだな！	Seems like you missed the code!	102
プロテクトシステムが作動する前に正しいパスコードを入力しないとマテリアを取りもどせないぜ！	If we don't enter the correct passcode before the protection system activates, we won't be able to get the Materia back!	103
パスコード４を入力せよ	Enter Passcode 4	111
確か最後のコードは△だったと思うぞ。いや、×だったかな……	I'm pretty sure that the last code was [MENU]. No, maybe it was [CANCEL]…?	112
２番目のコードは△じゃなかった。こいつはマチガイない！	The second one's not [MENU]. I'm sure of it!	113
二回押すキーがあったような記憶があるんだが……	I think there was a key that you have to push twice…	121
聞いたことがあるぜ。神羅のえらいさんだけが知っているパスコードがあるって	I heard there's a passcode only the top people in Shinra know.	122
多分、そいつを入力すればいいはずだ。思いだしてみるから、その間にお前はいろいろコードを入力してみな！	We probably have to enter that. Try and enter some codes while I try and remember that passcode!	123
あちゃ～プロテクトシステムが作動しちまったぜ	Ahhh &$#$#! The Protection System just activated!	131
……CLOUD、残念だがあきらめるしかねぇぜ	…CLOUD, too bad, but we gotta let it go.	132
よっしゃ！はやいとこ、脱出しようぜ	ALRIGHT! Let's get outta here while we can!	133
爆発したのは、８番ボンベ……８番ボンベねえ……やっぱりイカレてやがったのか……	Tank Number 8 blew up…/ So Tank Number 8…/ really was malfunctioning…	141
シエラ……確かにおまえが正しかったぜ	Shera…/ You were right.	142
でもよ……オレ様もこれで終わりだぁ	But, …this is the end for me.	143
ア、アタシの力じゃ持ちあがんないよ！！	I can't budge it by myself!!	151
ど、どないしょ～持ちあがらへん！	What shall we do? It won't budge!	152
……だめだ。持ちあがらない	…No. I can't lift it.	153
行くです	Yes	161
行かないです	No	162
見習いパイロット（ＬＶ９）	Learner Pilot (L9)	163
さあ、行きましょう！	OK then, let's go!	171
行きましょう！	Let's go!	172
待ってください……	Wait a sec…	173
すいません、待ってください	Excuse me, but could you wait?	181
見習いパイロット（ＬＶ１４）	Learner Pilot (L14)	182
さあ、CLOUDさん！！！	Hey, CLOUD!!!	183
CLOUDさん、いかがいたしましょう？	CLOUD, what do you want to do?	191
行ってくれたまえ	Go on	192
少々、待ちたまえ	Wait a minute	193
さんざん邪魔しといてなんやけど……	We been botherin' them as much as we can…	201
他に方法があるわけやないし……ボクらがまちごうとったんやろか？	But there ain't no other way… Wonder if we've been wrong all this time?	202
悩んじゃうよね	Makes you worry, doesn't it?	203
広くて大きくて……俺なんかが動き回っても何も変わらないんじゃないかって	How wide and big… No matter where I go and what I do it won't change a thing.	211
そうなのかもしんねえな	Maybe you're right.	212
でもよ、オレ様が考えたのは違うぜ	But I came up with something different.	213
CID……なんだかステキ	CID…that's beautiful.	221
おう！　CIDさんよぉ！オレは感動しちまったぜ！	Yo! CID! You even got to me!	222
で、どうするんだ？どうやってメテオから星を守るんだ？	Now what? How're we gonna protect the Planet from Meteor?	223
ブーゲンハーゲンさんが教えてくれたからよ	Bugenhagen told us.	231
ブーゲンハーゲン……	Bugenhagen…	232
じっちゃんに会いに行こうよ！【コスモキャニオン】へ！	Let's go see Grandfather! To Cosmo Canyon!	233