ああ、だから来たんだ	Yeah, that's why we came.	1
どうしたらよいか……道を見失ったか？そういう時はおのおの自分を静かにみつめるのじゃ	What to do? Have you lost your way? When that happens, we each have to take a good long look at ourselves.	2
何か忘れているものが……何か心の奥にひっかかっているものがあるはずじゃ	There's always something in the deepest reaches of our hearts. Something buried, or something forgotten.	3
そんなの、アタシにわかるわけないじゃん！他の連中にまかせたよ！	You expect me to do that? Let the others do it!	11
CLOUDさん、どうやろみなさんにも来てもらうってのは？	How about it, CLOUD? Shouldn't we have the others come?	12
どうかなCLOUD。ここは全員に来てもらったほうがいいと思うが……	I don't know, CLOUD. I think we should have everyone here.	13
そう言えば……私も……そうだった	That reminds me… I was the same.	21
……オイラも	…as was I.	22
オレもさ……	Me too…	23
そうなんだ、CID	Of course, CID!	31
俺たちはそんなことも知らないんだ	We don't know about it.	32
AERISは何をしていたんだ？	What did AERIS know?	33
ヘッ、星が呼んでるねえ	Yeah, hoo boy, the planet calling…alright.	41
ホーホーホウ。さあ、行こうかの	Ho Ho Hoooo. Then let's go.	42
そうだ、ブーゲンハーゲン。もうひとつ、頼みがある	Oh yeah, Bugenhagen. I have one more thing I want to ask you.	43
これはまためずらしいマテリアじゃの	This is really rare Materia, indeed.	51
これほどのマテリアなら、なにか特別な知識をひめているかもしれんのう	Materia this rare is certain to have a special consciousness enclosed in it.	52
ホーホーホウ。よしよし。それじゃ出発するとしよう	Ho Ho Hoooo. Good. Now let's leave.	53
この色……しょうかんマテリアと同じ色だ……	The color…is the same as summoned Materia.	61
今のは……バハムート……？	Is that… Bahamut…?	62
【コマンドマテリアゆうごう】	Command Materia Blend	63
ＭＡＸレベルの まほうマテリアはうしなわれ、	Maximum level Magic Materia has been lost.	71
【マスターまほう】のマテリアをひとつ、手にいれます。	Received one Master Magic Materia!	72
すべてのＭＡＸレベルのしょうかんマテリアをゆうごうします。	All maximum level summoned Materia will be blended.	73
ヒュージマテリア……	Huge Materia…	81
たしかに不思議なかがやきだ……	It is glowing strangely…	82
もっと近くで……	Get closer…	83
ん？　上は甲板かな？	Hmm? The deck's up there?	91
では、ワシは甲板で時をすごさせてもらおうか	Then I'll be on the deck just passing the time.	92
風のニオイに星のいとなみを感じ機械のニオイに人間の知恵と知識の素晴らしさを感じる……	I can feel the workings of the Planet in the smell of the wind. I also feel the greatness of Man's wisdom and the knowledge in the smell of machinery…	93
何かわかりそうなのか？	Are you getting something?	101
……ちと時間をくれんか？	…Give me a moment.	102
この部屋にうずまいている古代種の意識はたったひとつのことをうったえているのじゃ	The knowledge of the Ancients swirling around here is telling me one thing.	103
もしかしたら、わしらもな	Perhaps, even ourselves.	111
俺たちも！？	Even us!?	112
それは星が決めることじゃ	It is up to the Planet to decide.	113
ねがいが星にとどくと白マテリアがあわ～いグリーンに輝くらしいのじゃ	If our wish reaches the Planet, the White Materia will begin to glow a pale green.	121
……終わりだ	…This is the end.	122
白マテリアはAERISが持っていた……	AERIS had the White Materia…	123
読めるのか？	Can you read it?	131
さすがだな	Damn, dude, you're really somethin'	132
さすが、ブーゲンハーゲンさん！！	You're really something, Bugenhagen!!	133
わしは古代種じゃない。こんなもん読めんわい！	I'm not an Ancient. I can't read this thing!	141
でもな、こんなおいぼれでも目は悪くなっておらん。よ～くその文字の下を見てみろい	I may be old, but my eyes aren't completely bad yet. Look closely below the writing.	142
チョークでメモがかきなぐってある…………【日の光もとどかぬ】……【カギ】	There's something written in chalk… …(even sunlight can't reach)…(Key)	143
あそこにあるのがオルゴールじゃよ。あそこでカギを使うんじゃ	That Music Box over there. We'll put the key in it.	151
さあ、その言葉をヒントにカギを探してこい	Use these words as clues and go find the key.	152
ワシはここで古代文字の解読を続けよう	I'll continue to figure out the Ancients' writing.	153
待てよ。潜水監……【ジュノンの港】にたしか……	Wait. Submarine…I think there's one at Junon Port.	161
おお！　見つけたか！	Oh! You've found it!	162
わしがカギをさしてこよう。おまえたちはここにいるんじゃ	I'll go use the key. You all wait here.	163
……俺がセフィロスに黒マテリアをわたしてしまったあと……夢の中のAERISの言葉……	…After I gave up the Black Materia to Sephiroth… AERIS's words came into my dreams…	171
セフィロスを止めることができるのはわたしだけ……その方法が、秘密がここにある……そう言ってたんだ	She said, she was the only one who could stop Sephiroth… And to do that, there was a secret here…	172
それがホーリー……自分が持っている白マテリアの意味。白マテリアを自分が持っている意味。自分がすべきこと……AERISはここで知った	That was Holy… That's why, she had the White Materia. AERIS knew about here… and what she had to do.	173
俺・た・ち・だよ	WE'LL take care of it.	181
クソったれい！俺・た！ち！っだろ？俺たち！	You &^$#%^! It's WE! WE!	182
俺やのうて俺・た・ち・やろ？	It's WE! Isn't it WE?	183
大切な人が残してくれた希望……それをはぐくむのが、私たちにできるせいいっぱいのこと……	The hope she left us… We must make stronger…	191
せっかく残してくれた希望……それにかけてみなきゃねっ！	We've gotta take a chance on the hope she left us!	192
ありがとう……AERIS	Thank you…AERIS.	193
ヒソヒソ……（すんません）（ちょっと、びっくりしたもんですから）	…whisper…whisper… (sorry I was a little surprised).	201
ジュノンのキャノンがのうなってたの覚えてますか？あれ、実はルーファウスが運んだんです	You remember when the Junon Cannon disappeared? Actually, Rufus moved it.	202
運んだって？　あんなデカイものを……？どこに……？　なぜ？	Moved it? That big thing? Where? Why?	203
ここは……ライフストリームの中に似ている	This place…is similar to the inside of the Lifestream.	211
……いろいろなノイズ	…All the different noise.	212
……耳ではなく、頭の中に直接入りこんでくるノイズ	…The noise doesn't go through your ears but directly into your head.	213
頭がパンクしそうなかんじだ	My head feels like it's getting crushed.	221
頭、パンクしそうや	My head, it's about to be crushed.	222
頭がプッチンきちゃいそう	My head's about to pop.	223
どうしたい！？	What's wrong!?	231
怪電波です！	It's a strange signal!	232
どっからだ？	From where?	233
マリンちゃんは安全な場所にいますわ。AERISさんのお母さんもいっしょです	Doncha worry none, Marlene's in a safe place. She's with AERIS's mama.	241
BARRETさん！！	BARRET!!	242
なんですか、今の『ポリポリ』ってのは！	What was that scratching just now!?	243
神羅のやつにどうこう言われたかねえ……	I don't wanna hear that from no one in Shinra…	251
…………どうせ、ボクは……	Can't do anything about that…	252
やめろよ	Stop it!	253
CLOUDよう……	Hey CLOUD…	261
あんなバケモノに勝てるのか？少しは勝ち目ってのがあるんだろうな？	You think we can win against that monster? We got a chance of winnin', right?	262
そんなことはわからない！	How would I know?	263
セフィロスを倒せばメテオも消えるとは目のつけどころが違いますな！	The whole idea that Meteor will disappear if we defeat Sephiroth is all wrong!	271
社長、忘れないでおいてね	If you remember, Mr. President	272
ミッドガルの魔晄炉の力で砲弾を飛ばすのは私のアイディアなんだから	It was my idea to fire Mako powered shells.	273
この谷を、コスモキャニオンのみんなを守るのがオイラの……セトの息子の使命だ！	It's the duty of… Seto's son, to guard this canyon and her people…	281
……聞くのじゃ、ナナキ。もうおまえにもわかっておるじゃろう	…listen, Nanaki. I think you may already know.	282
おまえに使命というものがあるとすれば、それはこの谷を守ることでは……ない	If you have any mission in life, it is not to defend this valley.	283
じっちゃん！？じっちゃん！！	Grandfather!? Grandfather!!!	291
……ああ、そうそう。おまえにわたすものがあった	…oh yes. This is for you.	292
トトト……おどかさないでよ、じっちゃん！	… Don't scare me like that, Grandfather!	293
広い世界を見てくるんじゃ……もしかしたらホレ、カワイイガールフレンドが見つかるかもしれんしの？	It's a big world and you must go out and see it… You may even find your life's mate. You never know.	301
そうそう……これを持っていくといい。今のおまえならよく……似合うじゃろ	Oh yes…take this along. I think it will look good on you now.	302
RED XIII……ブーゲンハーゲンは……	RED XIII… Is Bugenhagen…?	303
そうか……それじゃまた、どこかでヒョッコリ会うかもしれないな	Hmm… Maybe we'll run into him again somewhere.	311
ウン……そう……そうだね……	Yeah… maybe…	312
ありがと、CLOUD……	Thanks, CLOUD…	313