ハイデッカーがみなさんを狙ろてますんや	Heidegger is going after you all.	狙	scene_40
ど、どうしたの？まるで何かを求めているみたいに……	What's wrong? Are you still looking for something?	何求	scene_40
どないなっとるんや？	What's going on?		scene_40
飛空艇に行きましょう！	Let's go to the Airship!	飛空艇行	scene_40
飛空艇にもどりましょ	Let's go back to the Airship.	飛空艇	scene_40
でっかいのが……でぇぇぇっかいのがくるで！	Something big… I'm talkin' REALLY BIG's comin'!		scene_40
甲板	deck	甲板	scene_40
ミッドガルだ！	Midgar!		scene_40
クレーター、バリアも消えました！	The barrier has disappeared!	消	scene_40
逃げろー！！	Run for your lives!!	逃	scene_40
わからねえ。社長と連絡がとれない！	Strange. I can't reach the President!	社長連絡	scene_40
魔晄炉の出力が勝手にアップしてるんや！	The reactor's output is increasing all by itself!	魔晄炉出力勝手	scene_40
こまかいことはどうでもいいんや！！	I don't care how you do it!!		scene_40
何者かが本体操作に切り換えています！	Someone has switched the machine over to mainframe operation!	何者本体操作切換	scene_40
おい！　まて！！	Hey! Wait!!		scene_40
治安維持部門は総力をあげてあいつらを撃退してやる！	The Peace Preservation force will do their best to beat the enemy!	治安維持部門総力撃退	scene_40
ハイデッカー！例の新兵器、使うわよ！	Heidegger! Now I'm going to use the new weapon!	例新兵器使	scene_40
クックックッ……ミッドガルのひとつやふたつ安いものだ	Ha, ha, ha… One or two Midgars? …It's a small price to pay.	安	scene_40
クックックッ……科学を超えて行け……	Ha, ha, ha… Go beyond the powers of science…	科学超行	scene_40
ブリッジ	Bridge		scene_40
おいCAIT SITH！今度はなんだ？	Yo, CAIT SITH! Now what?	今度	scene_40
宝条を……だな	Must stop Hojo…first.	宝条	scene_40
おまえ、神羅の人間なんだろ？どうして無理なんだよ！	You're from Shinra, ain't ya? So why's it impossible!?	神羅人間無理	scene_40
神羅もクソも関係ねえ！男なら……いや人間ならこの星を救ってやるんだ！って気にならねぇのかよ？	I don't give a damn about Shinra. If you're a man… no, if you're a human being, you'll save the planet! Don't you even care?	神羅関係男人間星救気	scene_40
いや…ことなんや……	I don't like this…		scene_40
アカンのや！　魔晄炉を止めたら大変なことになるんやで！！	No way! If we shut down the reactor, all hell will break loose!!	魔晄炉止大変	scene_40
どんどんわき出るエネルギーを無理にふさいでしまうとやな……	And we can't try to stop the energy from gushing out…	出無理	scene_40
オイ！	Hey!		scene_40
スラムからの交通機関は完全封鎖みたいよ……	Looks like all transportation from the slums is cut off…	交通機関完全封鎖	scene_40
よし！　パラシュートでミッドガルに降下するぞ！！	Okay then! We'll parachute into Midgar!!	降下	scene_40
降下後のメンバーを決めて下さい。メンバーチェンジしますか？	Choose from the members below. Change your party's members?	降下後決	scene_40
オレが言うとへんだけどよ……	May sound strange comin' from me…	言	scene_40
ほんま、たのんます！魔晄キャノンまで、はよう来てや！	Please! Hurry to the Mako Cannon!	魔晄来	scene_40
長き時がすぎても騒動をまきおこすのは宝条というわけか……	So it was Hojo who stirred up all this commotion after all these years?	長時騒動宝条	scene_40
におうよ！キャノンは、こっちじゃない！	I smell it! The cannon's not this way!		scene_40
早く早く早く早く～っ！	C'mon, c'mon, c'mon, c'mon---!	早	scene_40
……イリーナ。あまえるなよ、と	…Elena, don't act so weak.		scene_40
あんなに、およいだのは初めてだったぜ、と	I've never swam so much in my life.	初	scene_40
……殺すこと	…Kill.	殺	scene_40
わかった、ケリをつけよう	Okay, let's end this		scene_40
待て、イリーナ、と	Wait, Elena.	待	scene_40
イリーナ、お前もりっぱにタークスだったぜ、と	Elena, you were a great Turk!	前	scene_40
仕事は終わりだ……	Our mission's over…	仕事終	scene_40
おいおい！そこまでするかよ……	Hey-hey! You serious?		scene_40
よ～くも今までコケにしてくれたな！	You sure treated us like dogs till now!!	今	scene_40
このプラウド・クラッドの破壊力！見せてあげるよっ！-	I'll show you the destructive power of the Proud Clod!	破壊力見	scene_40
宝条！　そこまでだ！！	Hojo!  Stop right there!!	宝条	scene_40
私は自分の科学的センスのなさを痛感させられる……	It pains me that I had so little scientific sense…	私自分科学的痛感	scene_40
なんでもいいからこんなことはやめろ！	None of that matters… just stop this nonsense!		scene_40
私が少しばかり力をかしてやるのだ	So I'm going to lend him a hand.	私少力	scene_40
エネルギーレベルは……８３％か。時間がかかりすぎだ	Energy level is at…83%. It's taking too long.	時間	scene_40
クックック……クァックァックァッ！！	Ha, ha, ha… HA, HA, HA!!		scene_40
セフィロスがあんたの息子！？	Sephiroth is your son!?	息子	scene_40
き、きさま……！	You!		scene_40
科学者としての欲望だ！ヒーッヒッヒッヒッ！	It's my desire as a scientist! Heee, hee, hee!	科学者欲望	scene_40
この間もな、負けてしまった	I lost the last time, too.	間負	scene_40
見せてやろう！！	…the results!!	見	scene_40
父親か……	The father…	父親	scene_40
おっ！ こいつは……	Hey! This is…		scene_40
神羅は…………終わりました	Shinra's…finished.	神羅終	scene_40
コスモキャニオンの人たちに会いたいか？	You want to see everyone in Cosmo Canyon again?	人会	scene_40
俺たちがセフィロスを倒して……	We'll beat Sephiroth…	俺倒	scene_40
メテオで死んでしまう人たちより何日か先に、だ	We'll just go a few days sooner than the rest who'll die from Meteor.	死人何日先	scene_40
みんなが何のために戦っているのか。それをわかっていてほしいんだ	What are we all fighting for? I want us all to understand that.	何戦	scene_40
セフィロスを倒す。過去との完全な決別	I want to beat Sephiroth and settle my past.	倒過去完全決別	scene_40
自分と……自分が大切にしている誰か？　何か？　そのために戦う	For ourselves…and that someone… something…whatever it is, that's important to us. That's what we're fighting for.	自分大切誰何戦	scene_40
でも、オレにできたのはあの、魔晄炉爆破だ……	But I was the one who blew up that Mako reactor……	魔晄炉爆破	scene_40
でも、今は……	But now…	今	scene_40
会いに行けよ。その気持ち、たしかめてこいよ	Go and see her. Make sure you're right, and come back.	会行気持	scene_40
メテオでどうせ死んじまう。ムダなあがきはやめようってよ！	Meteor's gonna kill us all anyway. Let's just forget any useless struggling!	死	scene_40
見つからなかったら仕方がない。理由なしでは戦えないだろ？	If you don't find it, then that's okay, too. You can't fight without a reason, right?	見仕方理由戦	scene_40
私……ひとりなんだもん。どこにも行くところがないんだもの	I'm…all alone. I don't have anywhere to go.	私行	scene_40
そうだね……	You're right…		scene_40
それに今度ばっかりは、相手が相手だ……	But this time, our opponent…	今度相手	scene_40
私たち……これまではずっと遠く、はなればなれだったんだね。たとえ、どんな近くにいても……	No matter how close we are now… We were far apart before.	私遠近	scene_40
ああ……。あのとき俺にもTIFAの叫ぶ声が聞こえたよ	Yeah… I heard you calling me.	俺叫声聞	scene_40
がんばってる私たちの姿を見ていてくれると思う？	Do you think they see how hard we're fighting for them?	私姿見思	scene_40
うん……そうだね……	Yes…that's right…		scene_40
TIFA………	…		scene_40
俺も、聞いたような気がするな。あの時、TIFAの声を……	I think I've heard it, too. Then, it was TIFA's voice…	俺聞気時声	scene_40
ゴメン。おこしちゃったか……。もうすぐ夜が明けるよ、TIFA	Sorry. Did I wake you? It's almost dawn, TIFA.	夜明	scene_40
ああ……いいよ	Sure…		scene_40
いいんだよ、TIFA。きのう、TIFAも言ってたろ？	It'll be all right, TIFA. You said so yourself yesterday.	言	scene_40
おはよう、TIFA。もうすぐ夜が明ける……	Morning, TIFA. It's almost dawn…	夜明	scene_40
CLOUDはどうするの？	What are you going to do, CLOUD?		scene_40
だいじょうぶだよ、TIFA	Everything'll be fine!		scene_40
やっぱり、ちょっとだけさびしいな	Yeah, it's a little lonely without everyone.		scene_40
いままでみたいに安心してのっていられないからな	No more flying around casually like before.	安心	scene_40
BARRET！　CID！	BARRET! CID!		scene_40
だって……ねえ、CID	But, you know, CID.		scene_40
…………聞いてたの？	…Were you listening?	聞	scene_40
いつもさめてたから……関係ないって顔してただろ？	No, it's just that you're always so cool to what is happening I thought you didn't care.	関係顔	scene_40
あの～	Uh, excuse me but…		scene_40
さて……全員そろったな	I guess that's everyone.	全員	scene_40
ひっどいな～！！	How could you say that!?		scene_40
おろ～……CLOUDやさしいねえ。なんかあった？	Gee, CLOUD…that's so nice of you to say that…You sick or somethin'?		scene_40
オレの大切なマリンのため。それとおんなじくらい大切なオレの……オレの気持ち……ってのか？	I came back for Marlene. Guess it's jus' my… feelings or somethin'.	大切気持	scene_40
……AERIS、最後にほほえんだんだ	…AERIS. She was smiling to the end.	最後	scene_40
星にとどいたはずなのに邪魔されて身動きできないでいる……	Although she should've returned to the Planet by now, something stopped her and now she's stuck…	星邪魔身動	scene_40
宝条が創り出したセフィロス・コピーですわな	He was a Sephiroth-clone created by Hojo.	宝条創出	scene_40
じゃあ、CLOUDは？	Well then, what is CLOUD?		scene_40
船酔いに負けないでここまで来たんだよ	I stuck in there even when I was pukin' from bein' so seasick.	船酔負来	scene_40
俺たちの最後の戦いだ。目標は北の大空洞のセフィロス！さあ……	This is our last battle. Our target is Sephiroth in the Northern Cave! So…	俺最後戦目標北大空洞	scene_40
CLOUD……どうしよう……考えなくっちゃ	CLOUD…what should I do? I've got to think.	考	scene_40
きっと、命をかけてこの星を……	I'm sure she wanted to give her life for the Planet.	命星	scene_40
AERIS、他の誰よりも明日のこと話してた……	She talked about the future more than any of us…	他誰明日話	scene_40
好きとかキライとか……	Whether you love it or hate it…	好	scene_40
だいじょうぶだよね	It's all right.		scene_40
ちょっと気取って	Say it cool	気取	scene_40
あ、本当にだいじょうぶって気がした……ありがと、CLOUD	Now I feel like things are really going to be all right. Thanks, CLOUD.	本当気	scene_40
私……だいじょうぶだから……がんばって戦うから……	I'm…all right…really… I'll fight my hardest…	私戦	scene_40
ここに、ずっと気になってたレバーが２本あるんだが……	These two levers have been buggin' me for a while…	気本	scene_40
CLOUDさんよ、いっちょ、決めてくれ	You decide, CLOUD.	決	scene_40
おう！　つっこむぜい！	Man, I'm going to stick it to him!		scene_40
艇長	Captain	艇長	scene_40
ケッ……カッコつけやがって	Oh ma--…stop trying to act so cool.		scene_40
行くぞ、CLOUD！もたもたしてらんねえ！	C'mon, CLOUD! Don't #&$* around!	行	scene_40
ブーゲンジイさんかよ……よくわかんねえジイさんだよな	That Bugenhagen guy… He was a weird old dude.		scene_40
だとしてもよ、やっぱりよ会えるわけじゃねえからな……	But even if she did, there's no way we'll meet her again…	会	scene_40
最初はよ、ビラはりだったぜ。アバランチの初めのころはな	When AVALANCHE was startin' out, we used to put up flyers everywhere.	最初	scene_40
でもよ、オレはミッドガルの連中には返しきれねえ借りがあるからよ……	But I got a debt to all them back in Midgar that I can't never repay…	連中返借	scene_40
神羅のやり方ってさ、今さえ良ければなんでもいいってことだよね	Shinra only cares if things are good right now.	神羅方今良	scene_40
AERISはね、ときどきオイラのハナをなでてくれたんだ	AERIS used to pat me on the nose sometimes.		scene_40
はぅ……大人になりたいなぁ。この旅が終わったら、大人になれるかな……	Whew…I wish I could grow up. I wonder if after all this is over, will I be an adult?	大人旅終	scene_40
いろんな人と出会ったり出会わなかったり……不思議だね	People you want to meet… others you don't…strange isn't it?	人出会不思議	scene_40
しずかに研究だけしてればいいのにさ	Why couldn't he content himself with quiet research?	研究	scene_40
……どうかな、CLOUD。借り物ではない自分を生きるのは？	…how does it feel, CLOUD? living for no one but yourself?	借物自分生	scene_40
あの老人の中では科学と星がともに生きているのだ	Science and the Planet lived side by side in that old man's heart.	老人中科学星生	scene_40
……なかなかセフィロスには近づけないな……	……we still can't seem to get near Sephiroth…	近	scene_40
科学的センスのなさ……つきまとう天才ガスト博士との比較……	Such utter lack of scientific talent… compared with the genius of Dr. Gast…	科学的天才博士比較	scene_40
空をかけめぐる時間は終わったのだ。今は地の底が我々の戦場……	The time for flying is now past. Our battlefield is now beneath the earth…	空時間終今地底我戦場	scene_40
はぁ……秘密もらすんてなんや快感なってきましたわ	…I love giving out secrets more than anything.	秘密快感	scene_40
この星のんか、メテオのんか……どっちの悲鳴なんやろなぁ……	Which was screaming? The Planet? Or Meteor?	星悲鳴	scene_40
AERISさん、亡くなってしもたことお母さんに伝えたんです	I told AERIS's Mom about her death.	亡母伝	scene_40
神羅は許せんかもしれんけどミッドガルの人たちには、何の罪もないんや！	I know you can't forgive the Shinra, but the people in Midgar haven't done any wrong!	神羅許人何罪	scene_40
さ、みなはん、スラムの方へ！急いで急いで！	So let's get over it! We've got to hurry to the slums!	方急	scene_40
……気休めかもしれまへんけどな	Maybe we were all just kidding ourselves.	気休	scene_40
誰がどんなマテリアつけてるとかす～ぐ忘れちまったぜ、オレ様はよ	I always forget who has what Materia.	誰忘様	scene_40
スイッチとかレバーが増えててよ気になってしょうがねえぜ	All these switches and levers. They're kinda gettin' to me.	増気	scene_40
いよいよ、セフィロスだぜ。腕が鳴るってか？	Well, I guess it's time for Sephiroth. Are your hearts pounding?	腕鳴	scene_40
行ったり来たり忙しいじゃねえか！	This runnin' back and forth is tough!	行来忙	scene_40
ある	Yes		scene_40
んでよ、オレ様は一回だけ見たことがあんだけどよ……	An' I remember seein' it just once…	様一回見	scene_40
自分でも予想してたけどよガーガーねちまったぜ	But this thing put me to sleep, just like I thought it would.	自分予想	scene_40
『どうしても行くの？』	Do you really have to leave?	行	scene_40
『もちろん……ここに帰ってくるよ。約束なんかなくても待っていてくれる人がいること、俺は知ってるから』	Of course…I'll come back to you. Even if you don't promise to wait. I'll return knowing you'll be here.	帰約束待人俺知	scene_40
オレ様はあとひと仕事終わったら船を降りるんだ………そうするぜ	When this job's done, I'm landing the ship… yeah, that's what I'll do.	様仕事終船降	scene_40