ハイウインド・甲板	Highwind‚on deck	甲板	scene_43
『テトラエレメンタル』を手にいれた！	Received "Tetra Elemental"!	手	scene_43
よじ登る	Climb up	登	scene_43
おつれさまです！皆さんが、中でお待ちです	Welcome! Everyone's waiting for you.	皆中待	scene_43
ハイウインドへ戻れそうだな	Looks like we can get back to the Highwind.	戻	scene_43
『コマンドカウンター』のマテリアを手にいれた！	Received "Counter" Materia!	手	scene_43
道が別れているな。ここは二手に別れるか	The road splits into two. We'll split into two groups.	道別二手	scene_43
右	Right	右	scene_43
CLOUD、あんたはどっち行くの？	CLOUD, which way are you goin'?	行	scene_43
そうか。　それじゃ、オレは……	All right, then I'll go…		scene_43
ほんなら、ボクは……	Then, I'll head…		scene_43
上	Up	上	scene_43
死ぬなよ、みんな。ヤツの……	Now don't any of you die on me. …	死	scene_43
生きて帰ろうね……絶対に！	Let's all go back alive, okay?	生帰絶対	scene_43
終わるのだな。これで……	It's all over now. With this…	終	scene_43
戦っているのはオイラたちだけじゃない	We're not the only ones fighting.	戦	scene_43
行くぞ……	Let's go…	行	scene_43
こっちは、CIDにまかせるか	We'll leave this to CID.		scene_43
こっちは、YUFFIEにまかせるか	We'll leave this to YUFFIE.		scene_43
『まほうカウンター』のマテリアを手にいれた！	Received "Magic Counter" Materia!	手	scene_43
おいてかないでよ、CLOUD	Don't leave us, CLOUD.		scene_43
はくじょうやなぁ、CLOUDさん	You're so cruel, CLOUD.		scene_43
RED XIIIは……？	Where's RED XIII?		scene_43
TIFAたちは……？	Where're TIFA and the others?		scene_43
CAIT SITHたちは……？	Where's CAIT SITH and the others?		scene_43
ここが、星の中心……？	This is the center of the Planet?	星中心	scene_43
いよいよね	This is it.		scene_43
CLOUD、オイラこんなもの見つけたんだけど	CLOUD, I found this…	見	scene_43
ウダウダしてねぇでさっさと行こうぜ！	Received "Elixir"!	行	scene_43
手にいれた！	Hold on to this.	手	scene_43
…………な、なんだよ	… Wh…what?		scene_43
そういや、YUFFIEよ。おめぇ何かひろってなかったか？	Yeah, YUFFIE, didn't you pick up something on the way?	何	scene_43
おっ！？マテリアがいっぱいじゃん！じゃあ、いらないね	Hey!? But you have lots of Materia! Then you won't need it.		scene_43
よし、行こうよ、みんな	All right, everyone, let's mosey.	行	scene_43
行くぜ！！	Move out!!	行	scene_43
俺もここで戦う	OK, I'm going alone.	俺戦	scene_43
ま、本番前の準備運動ってところかしら？	Is this like a practice run before the final battle?	本番前準備運動	scene_43
来る！もう、となりのフロアまで来てる！	They're coming! They're already on the floor next to us!	来	scene_43
ああ、あとでな	Yeah, later.		scene_43
ここは……？	Where are we?		scene_43
な、なんや！	What?		scene_43
来る！！	It's coming!!	来	scene_43
この光が……ホーリー？	Is this light…Holy?	光	scene_43
なんだオイ……けっきょくみんなそろっちまったのか……	What? So everyone's together again?		scene_43
ウグッ……！！	Uuuugh!!		scene_43
セフィ……ロス……！まだだ……まだ俺は……ウァァアア！	Sephi…roth! Not yet… I'm not…Uuuuraagh!	俺	scene_43
CLOUD……CLOUD……	CLOUD… CLOUD…		scene_43
……ホーリーが……ホーリーがそこにある……	…Holy…Holy… is there…		scene_43
ウワアァーッ！！	Uuuuuaaaaagh!!		scene_43
AERISの想い……俺たちの想い……	AERIS's memories… Our memories…	想俺	scene_43
ホーリーはアバランチの……マリンやダインの……この星の人間のいのりだ！	Holy is the prayer of AVALANCHE… Of Marlene and Dyne… And everyone on the Planet!	星人間	scene_43
今ならわかるよ、じっちゃん。それがオイラの使命だ！	I understand now, Grandpa. This is my mission!	今使命	scene_43
まちがいにきづくんがちぃ～と遅かったんかもしれん……	We noticed a little late the trouble we were getting in…	遅	scene_43
もう、マテリアなんか……マテリアなんか……	I don't need…Materia……any…		scene_43
ウオオォッ！！	Urrrrrgh!!		scene_43
負けへんでェ！！	We're not losin'!!	負	scene_43
……なにもかも……	…everything…		scene_43
すべてがはじまる！！	will begin anew…with me!!		scene_43
……そうねNew	…You're right.		scene_43
不安やなんかはここに置きざりにしてさ	That's it.	不安置	scene_43
あいつは……まだいる	He is still…here.		scene_43
….わかったような気がする	…. I think I'm beginning to understand.	気	scene_43
そうだ、みんなは？	Hey, where is everyone?		scene_43
でもよ、これからどうするんだ？	But… now what're we going to do?		scene_43
何とかなんねェのかよ～	Shit!!	何	scene_43
まずいんじゃねえのか？	We can't let that happen!		scene_43
メテオが星に近づきすぎてる	Meteor is approaching the Planet.	星近	scene_43
なんなんだ……？	What the hell IS that…….?		scene_43