パワーリスト	パワーリスト	Power Wrist	Power Wrist
防弾チョッキ	Bōdan Chokki	Bulletproof Vest	Protect Vest
イヤリング	イヤリング	Earring	Earring
タリスマン	タリスマン	Talisman	Talisman
チョコボのはね	チョコボのはね	Chocobo Feather	Chocofeather
お守り	O-mamori	Amulet	Amulet
チャンピオンベルト	チャンピオンベルト	Champion Belt	Champion Belt
ポイズンリング	ポイズンリング	Poison Ring	Poison Ring
タフネスリング	タフネスリング	Toughness Ring	Tough Ring (Touph Ring)
サークレット	サークレット	Circlet	Circlet
星のペンダント	Hoshi no Pendanto	Star Pendant	Star Pendant
銀縁メガネ	Ginbuchi Megane	Silver-Rimmed Glasses	Silver Glasses
ハチマキ	Hachimaki	Headband	Headband
フェアリーリング	Fearī Ringu	Fairy Ring	Fairy Ring
ジュエルリング	Jueru Ringu	Jewel Ring	Jem Ring
ホワイトケープ	Howaito Kēpu	White Cape	White Cape
エルメスのくつ	Erumesu no Kutsu	Hermes Shoes	Sprint Shoes
安らぎの指輪	Yasuragi no Yubiwa	Tranquil Ring	Peace Ring
リボン	Ribon	Ribbon	Ribbon
炎の指輪	Honō no Yubiwa	Flame Ring	Fire Ring
冷気の指輪	Reiki no Yubiwa	Cold Ring	Ice Ring
雷の指輪	Kaminari no Yubiwa	Lightning Ring	Bolt Ring
テトラエレメンタル	Tetora Erementaru	Tetra Elemental	Tetra Elemental
セーフティビット	Sēfuti Bitto	Safety Bit	Safety Bit
怒りの指輪	Ikari no Yubiwa	Anger Ring	Fury Ring
呪いの指輪	Noroi no Yubiwa	Cursed Ring	Curse Ring
守りの指輪	Mamori no Yubiwa	Protection Ring	Protect Ring
タマのすず	Tama no Suzu	Tama's Bell	Cat's Bell
リフレクトリング	Rifurekuto Ringu	Reflect Ring	Reflect Ring
水の指輪	Mizu no Yubiwa	Water Ring	Water Ring
盗族の小手	Tōzoku no Kote	Thief's Bracer	Sneak Glove
ヒュプノクラウン	Hyupuno Kuraun	Hypno-Crown	HypnoCrown