たたかう 	たたかう 	Attack	Attack
リミット	リミット	Limit	Limit
まほう 	まほう 	Magic	Magic
しょうかん 	しょうかん 	Summon	Summon
アイテム	アイテム	Item	Item
ぬすむ 	ぬすむ 	Steal	Steal
ぶんどる	ぶんどる	Plunder	Mug
みやぶる	みやぶる	Uncover	Sense
てきのわざ 	てきのわざ 	Enemy Skill	E.Skill
なげる 	なげる 	Throw	Throw
ぜになげ	ぜになげ	Coin Throw	Coin
あやつる	あやつる	Manipulate	Manip.
ひっさつ 	ひっさつ 	Deathblow	D.blow
へんか	へんか	Transform	Morph
れんぞくぎり 	れんぞくぎり 	Continuous Slash	2x-Cut
みだれうち 	みだれうち 	Chaotic Strike	4x-Cut
ぜんたいぎり	ぜんたいぎり	Slash All	Slash-All
いあいぬき	いあいぬき	Iainuki	Flash
ものまね	ものまね	Mimic	Mime
チェンジ	チェンジ	Change	Change
ぼうぎょ	ぼうぎょ	Defend	Defend
Ｗしょうかん	Ｗしょうかん	Double Summon	W-Summon
Ｗまほう	Ｗまほう	Double Magic	W-Magic
Ｗアイテム	Ｗアイテム	Double Item	W-Item