カエルのうた	カエルのうた	Frog Song	Frog Song
レベル４自爆	レベル４じばく	Level 4 Self-Destruct	L4 Suicide
マジックハンマー	マジックハンマー	Magic Hammer	Magic Hammer
ホワイトウィンド	ホワイトウィンド	White Wind	White Wind
マイティガード	マイティガード	Mighty Guard	Big Guard
天使のささやき	てんしのささやき	Angel's Whisper	Angel Whisper
ドラゴンフォース	ドラゴンフォース	Dragon Force	Dragon Force
デスフォース	デスフォース	Death Force	Death Force
火炎放射	かえんほうしゃ	Flamethrower	Flame Thrower
レーザー	レーザー	Laser	Laser
マトラマジック	マトラマジック	Matra Magic	Matra Magic
臭い息	くさいいき	Smelly Breath	Bad Breath
ベータ	ベータ	Beta	Beta
アクアブレス	アクアブレス	Aqua Breath	Aqualung
トライン	トライン	Trine	Trine
マジカルブレス	マジカルブレス	Magical Breath	Magic Breath
？？？？	？？？？	????	????
ゴブリンパンチ	ゴブリンパンチ	Goblin Punch	Goblin Punch
チョコボックル	チョコボックル	Chocobokkuru	Chocobuckle
レベル５デス	レベル５デス	Level 5 Death	L5 Death
死の宣告	しのせんこく	Death Sentence	Death Sentence
死のルーレット	しのルーレット	Death Roulette	Roulette
シャドウフレア	シャドウフレア	Shadow Flare	Shadow Flare
なんとか？？？	なんとか？？？	What???	Pandora's Box