ポーション	Pōshon	Potion	Potion
ハイポーション	Hai Pōshon	High Potion	Hi-Potion
エクスポーション	Ekusu Pōshon	X-Potion	X-Potion
エーテル	Ēteru	Ether	Ether
エーテルターボ	Ēteru Tābo	Ether Turbo	Turbo Ether
エリクサー	Erikusā	Elixir	Elixir
ラストエリクサー	Rasuto Erikusā	Last Elixir	Megalixir
フェニックスの尾	Fenikkusu no O	Phoenix Tail	Phoenix Down
毒消し	Dokukeshi	Antidote	Antidote
目薬	Megusuri	Eye Drops	Eye drop
金の針	Kin no Hari	Golden Needle	Soft
乙女のキッス	Otome no Kissu	Maiden's Kiss	Maiden's Kiss
うちでのこづち	Uchide no Kozuchi	Lucky Mallet	Cornucopia
やまびこえんまく	Yamabiko Enmaku	Echo Smokescreen	Echo Screen
興奮剤	Kōfun-zai	Stimulant	Hyper
鎮静剤	Chinsei-zai	Tranquilizer	Tranquilizer
万能薬	Bannōyaku	Panacea	Remedy
テント	Tento	Tent	Tent
セーブクリスタル	Sēbu Kurisutaru	Save Crystal	Save Crystal
けむりだま	Kemuridama	Smoke Bomb	Smoke Bomb
光のカーテン	Hikari no Kāten	Light Curtain	Light Curtain
月のカーテン	Tsuki no Kāten	Lunar Curtain	Lunar Curtain
反射ミラー	Hansha Mirā	Reflective Mirror	Mirror
スピードドリンク	Supīdo Dorinku	Speed Drink	Speed Drink
英雄の薬	Eiyū no Kusuri	Hero Medicine	Hero Drink
ワクチン	Wakuchin	Vaccine	Vaccine
聖なるトーチ	Seinaru Tōchi	Holy Torch	Holy Torch
手榴弾	Shuryūdan	Hand Grenade	Grenade
ボムのかけら	Bomu no Kakera	Bomb Fragment	Shrapnel
ボムの右腕	Bomu no Migiude	Bomb's Right Arm	Right arm
金の砂時計	Kin no Sunadokei	Golden Hourglass	Hourglass
死神のキッス	Shinigami no Kissu	Grim Reaper's Kiss	Kiss of Death
クモの糸	Kumo no Ito	Spider Thread	Spider Web
ドリームパウダー	Dorīmu Paudā	Dream Powder	Dream Powder
サイレントマスク	Sairento Masuku	Silent Mask	Mute Mask
戦いのゴング	Tatakai no Gongu	Battle Gong	War Gong
惑わし草	Madowashi-sō	Delusion Grass	Loco weed
火龍の牙	Karyū no Kiba	Firedrake Fang	Fire Fang
火とん	Katon	Unleashed Fire	Fire Veil
南極の風	Nankyoku no Kaze	Antarctic Wind	Antarctic Wind
冷気の結晶	Reiki no Kesshō	Cold Crystal	Ice Crystal
電撃鳥の角	Dengekichō no Tsuno	Shock Bird Horn	Bolt Plume
雷迅	Raijin	Swift Thunder	Swift Bolt
大地のドラム	Daichi no Doramu	Earth Drum	Earth Drum
大地のハンマー	Daichi no Hanmā	Earth Hammer	Earth Mallet
有害物質	Yūgai Busshitsu	Hazardous Material	Deadly Waste
モルボルの触手	Moruboru no Shokushu	Morbol Tentacle	M-Tentacles
星の砂	Hoshi no Suna	Stardust	Stardust
バンパイアの牙	Banpaia no Kiba	Vampire Fang	Vampire Fang
ゴーストハンド	Gōsuto Hando	Ghost Hand	Ghost Hand
バジリスクの爪	Bajirisuku no Tsume	Basilisk Claw	Vagyrisk Claw
モズのはやにえ	Mozu no Hayanie	Shrike's Prey	Impaler
チヂマール	Chijimāru	Miniaturize	Shrivel
ファイアカクテル	Faia Kakuteru	Fire Cocktail	Molotov
巨鳥のハネ	Kyochō no Hane	Giant Bird Feather	Bird Wing
海龍のウロコ	Kairyū no Uroko	Sea Dragon Scale	Dragon Scales
Ｓマイン	S Main	S Mine	S-mine
２０３ミリ砲弾	203-miri Hōdan	203mm Cannon Shell	8-inch Cannon (8inch Cannon)
重力球	Jūryoku-kyū	Gravity Ball	Graviball
時空弾	Jikūdan	Spacetime Bomb	T/S Bomb
イカスミ	Ikasumi	Squid Ink	Ink
しびれ針	Shibirebari	Numbness Needle	Dazers
双龍の牙	Sōryū no Kiba	Twin Dragon Fang	Dragon Fang
魔女の大釜	Majo no Ōgama	Witch's Cauldron	Cauldron
ギザールの野菜	Gizāru no Yasai	Gysahl Vegetable	Gysahl Greens
クラッカの野菜	Kurakka no Yasai	Karaka Vegetable	Krakka Greens
タンタルの野菜	Tantaru no Yasai	Tantal Vegetable	Tantal Greens
パサーナの野菜	Pasāna no Yasai	Pasana Vegetable	Pahsana Greens
クリーエの野菜	Kurīe no Yasai	Curie Vegetable	Curiel Greens
レイゲンの野菜	Reigen no Yasai	Reigen Vegetable	Reagan Greens
ミメットの野菜	Mimetto no Yasai	Mimet Vegetable	Mimett Greens
シルキスの野菜	Shirukisu no Yasai	Silkis Vegetable	Sylkis Greens
ピピオの実	Pipio no Mi	Pipio Fruit	Pepio Nut
ルチルの実	Ruchiru no Mi	Rutile Fruit	Luchile Nut
サラハの実	Saraha no Mi	Saraha Fruit	Saraha Nut
ラサンの実	Rasan no Mi	Lasan Fruit	Lasan Nut
パラムの実	Paramu no Mi	Param Fruit	Pram Nut
ポロフの実	Porofu no Mi	Polov Fruit	Porov Nut
カラブの実	Karabu no Mi	Carob Fruit	Carob Nut
ゼイオの実	Zeio no Mi	Zeio Fruit	Zeio Nut
パワーアップ	Pawā Appu	Power Up	Power Source
ガードアップ	Gādo Appu	Guard Up	Guard Source
マジックアップ	Majikku Appu	Magic Up	Magic Source
マインドアップ	Maindo Appu	Mind Up	Mind Source
スピードアップ	Supīdo Appu	Speed Up	Speed Source
ラックアップ	Rakku Appu	Luck Up	Luck Source
森羅万象	Shinra Banshō	All Things In Nature	All Creation
カタストロフィ	Katasutorofi	Catastrophe	Catastrophe
カオス	Kaosu	Chaos	Chaos
コスモメモリー	Kosumo Memorī	Cosmo Memory	Cosmo Memory
ファイナルヘヴン	Fainaru Hevun	Final Heaven	Final Heaven
大いなる福音	Ōinaru Fukuin	Great Gospel	Great Gospel
ハイウインド	Haiuindo	Highwind	Highwind
超究武神覇斬	Chōkyūbushinhazan	Transultimate Wargod Supremacy Slash	Omnislash
１／３５神羅兵	1/35 Shinra-hei	1/35 Shinra Soldier	1/35 soldier
ジンクバッテリー	Jinku Batterī	Zinc Battery	Battery
ポケットティッシュ	Poketto Tisshu	Pocket Tissue	Tissue
超合金スイーパー	Chōgōkin Suīpā	Super-Alloy Sweeper	Super Sweeper
マサムネブレード	Masamune Burēdo	Masamune Blade	Masamune Blade
ディオ激闘日記	Dio Gekitō Nikki	Dio's Fierce Combat Diary	Combat Diary
サイン色紙	Sain Shikishi	Signed Colored Paper	Autograph
人生バクチ打ち	Jinsei Bakuchi-uchi	Gambler's Life	Gambler
アースハープ	Āsu Hāpu	Earth Harp	Earth Harp
デザートローズ	Dezāto Rōzu	Desert Rose	Desert Rose
ガイドブック	Gaido Bukku	Guidebook	Guide Book