リミットレベル	リミットレベル	Limit level	Limit level
ちから	ちから	Strength	Strength
すばやさ	すばやさ	Dexterity	Dexterity
たいりょく	たいりょく	Vitality	Vitality
まりょく	まりょく	Magic	Magic
せいしん	せいしん	Spirit	Spirit
うん	うん	Luck	Luck
こうげきりょく	こうげきりょく	Attack	Attack
めいちゅうりつ	めいちゅうりつ	Attack%	Attack%
ぼうぎょりょく	ぼうぎょりょく	Defense	Defense
かいひりつ	かいひりつ	Defense%	Defense%
まほうこうげき	まほうこうげき	Magic atk	Magic atk
まほうぼうぎょ	まほうぼうぎょ	Magic def	Magic def
まほうかいひりつ	まほうかいひりつ	Magic def%	Magic def%
じかん	じかん	Time	Time
ギル	ギル	Gil	Gil
経験値	けいけんち	EXP	EXP
ＡＰ	ＡＰ	AP	AP
ＧＰ	ＧＰ	GP	GP
ＢＰ	ＢＰ	BP	BP