準備のほうは？	How are the preparations going?	準備	scene_06
ハイデッカー	Heidegger		scene_06
ガハハ！！　順調順調！実行部隊はタークスです	Gya, haa, haa!!  Smoothly, very smoothly! I assigned the Turks to this.	順調実行部隊	scene_06
リーブ	Reeve		scene_06
プレジデント！本当にやるのですか？たかだか数人の組織をつぶすのに……	President!! Are we really going to do this? Simply destroy a group with only a few members…	本当数人組織	scene_06
いまさらナニかね、リーブ君	What's the problem, Reeve? You want out?	君	scene_06
……いいえ	…No.		scene_06
しかし、私は都市開発責任者としてミッドガルの建造、運営のすべてにかかわってきました。ですから……	But, as head of the Urban Development Department, I have been involved in the building and running of Midgar. That's why…	私都市開発責任者建造運営	scene_06
リーブ、そういう個人的な間題は朝のうちにトイレで流しちまうんだな！	Reeve, flush your personal problems with the rest of your crap!	個人的間題朝流	scene_06
市長も反対しているわけであり……	The Mayor's against this anyway…	市長反対	scene_06
市長！？	Mayor?	市長	scene_06
このビルの中でボソボソとメシをくってるあいつか！？あいつを、まだ市長と呼ぶのか？	He just sits in this building all day feeding his face! You still call that a Mayor?	中市長呼	scene_06
それでは失礼します！	Now if you'll excuse me sir!	失礼	scene_06
君はつかれているんだよ。休暇をとって旅行でも行ってなさい	You're tired. Why don't you take a couple of days off and go somewhere.	君休暇旅行	scene_06
７番街を破壊する。アバランチの仕業として報道する。神羅カンパニーによる救助活動。フフフ……かんぺきだ	We'll destroy Sector 7 and report that AVALANCHE did it. Then we'll send in the rescue operation, care of Shinra, Inc…. Heh, heh, heh…this is perfect.	番街破壊仕業報道神羅救助活動	scene_06
ガハハハ！	Gya, haaa, haa!		scene_06
地下下水道	Sewer	地下水道	scene_06
もう！サイテーね、これ	Man! This is terrible.		scene_06
うん	Yeah.		scene_06
ま、最悪の事態からはのがれられた……	Well, the worst is over…	最悪事態	scene_06
……でもないみたい	Maybe not…		scene_06
飛び降りてみよう	Let's try and jump down	飛降	scene_06
やめるか……	Let's not…		scene_06
もうダメだわ……マリン……BARRET……スラムの人たち	It's too late… Marlene…BARRET …the people of the Slums.	人	scene_06
あきらめない、あきらめない。柱、壊すなんてそんなに簡単じゃない、でしょ？	Don't give up, never give up hope. It's not easy to destroy the pillar, right?	柱壊簡単	scene_06
…………そうね……そうよね！まだ時間はあるわよね	…Yeah…you're right! We still have time.	時間	scene_06
列車基場	Train Graveyard	列車基場	scene_06
AERIS。すっかり巻きこんでしまって……	AERIS, I got you mixed up in this…	巻	scene_06
ここから帰れ！な～んて言わないでね	Don't tell me to go home.	帰言	scene_06
え～と……明かりのついている車両を抜けて行けば出られそうね	If we can just get past the trains that are lit up, we should be able to get out of here.	明車両抜行出	scene_06
『ハイポーション』を手にいれた！	Received "Hi-Potion"!	手	scene_06
『ポーション』を手にいれた！	Received "Potion"!	手	scene_06
『やまびこえんまく』を手にいれた！	Received "Echo Screen"!	手	scene_06
まにあった！柱が立ってる！	We made it! The pillar's standing!	柱立	scene_06
まて！上から……聞こえないか？	Wait! You hear something above us?	上聞	scene_06
……銃声？	…gun fire?	銃声	scene_06
BARRETか！？	BARRET?		scene_06
のぼるぞ！	I'm going up!		scene_06
AERIS！ウェッジをたのむ	AERIS! You look after Wedge.		scene_06
AERIS、おねがい	AERIS, do me a favor.		scene_06
この近くに私たちの店『セブンスヘブン』があるの	I have a bar called '7th Heaven' in this neighborhood.	近私店	scene_06
そこにマリンっていう名前の小さな女の子がいるから……	There's a little girl named Marlene there.	名前小女子	scene_06
わかった。安全な場所へ、ね	Don't worry. I'll put her somewhere safe.	安全場所	scene_06
ここは危険です！みんな早く柱からはなれて！	It's dangerous here! Everyone get away from the pillar, quickly!	危険早柱	scene_06
７番街から離れて！	Everyone get out of Sector 7!	番街離	scene_06
だいじょうぶか？……ウェッジ！！	Wedge!! You all right!?		scene_06
……CLOUDさん…。俺の名前…覚えてくれたっすね	…CLOUD. You remembered…my name.	俺名前覚	scene_06
BARRETさんが…上で戦ってるっす。手をかしてやって……	BARRET's up top. …Help him…	上戦手	scene_06
CLOUDさん……めいわくかけて、すいません…っす	An' CLOUD… Sorry, I wasn't any help.		scene_06
CLOUDさん……い、痛いです……	CLOUD… It hurts…	痛	scene_06
CLOUD！！早くしなきゃ、BARRETが…	CLOUD!! You've gotta go now, or BARRET's…	早	scene_06
おっ！！おっおっと！！	Hey now!! Oops!!		scene_06
ああ、なんてことを！！じゃましないでくれよ……ったく！	What on earth are you doing? Just butt out…geez!		scene_06
ん？あんたも見にきたのか？	Huh? You came to see it, too?	見	scene_06
上で爆弾テロがあったんだってよ。この柱がぶっとんだら、このスラムも終わりだからな……	There was a bombing on top. If this pillar should come down, everyone in the slums is dust…	上爆弾柱終	scene_06
まあ、心配するだけむだだったな	Well, there's no point in worryin' about that.	心配	scene_06
なぁ！！見てみろよ。いつ見ても、どでかい柱だなぁ	Hey!! Check it out! It's huge, ain't it?	見柱	scene_06
ほら……。なんだか、素敵で不思議な場所だろ	Hey… This is a strange and wonderful place.	素敵不思議場所	scene_06
オレの場所だが、たまには見にきてもいいぞ。じゃな！！　きょうだい！	This is my place, but you can come here when you want. See ya, bro!	場所見	scene_06
あ、あ、あの……すいません。ここから先は、立入禁止なんですが	Ah…eh…uhm. Excuse me. You cannot pass without the proper clearance.	先立入禁止	scene_06
こ、こんな感じでいいでしょうか？先輩	Did I do good this time?	感先輩	scene_06
もっと、どうどうとせんか！	You gotta be tougher!		scene_06
え、で、でも……	But, uh, I…		scene_06
さ、さすが、先輩！！	W, wow! You're great!!	先輩	scene_06
おう！！むだぐちたたくんじゃねえ！	Damn right!! Don't waste time talkin's what I always say!		scene_06
きさま、何の用だ？この俺が何者か、知らんわけないだろう？	What the hell do you want? You know who I am?	何用俺者知	scene_06
ここから先は立ち入り禁止だ。俺はここでおまえみたいな浮浪者をおっぱらうケチな仕事をしてるもんだ	You can't pass. I got the miserable job of keepin' scum like you from trying to sneak in here.	先立入禁止俺浮浪者仕事	scene_06
わかったら、さっさとうせろ！！	If you understand, then scram!		scene_06
あ、あの……となりの先輩、こわいからさからわない方がいいと思いますよ	Listen… My partner's pretty mean, I wouldn't get him mad, if I were you.	先輩方思	scene_06
先輩！！ＬＯＶＥＬＥＳＳのチケット取れたんですけどいっしょにいきません？	You know, I got some tickets to Loveless', do you want to go?	先輩取	scene_06
やめとけ！ミッドガルは非常警戒体制に入ってる	What're you, retarded? Midgar's under martial law now!	非常警戒体制入	scene_06
あっ、先輩！僕のこと、心配してくれてるんですか！	Sir, are you really concerned for me?	先輩僕心配	scene_06
そんなんじゃねえ！！テロリストはスラムにひそんでる。俺たちだって、気をぬけねぇ	Hell no!! But in case you forgot, we're in the middle of a slum. They could be anywhere around, so stay on your guard.	俺気	scene_06
ああ、アバランチですか？	Right. You mean the AVALANCHE?		scene_06
大丈夫ですよ。なんてったってソルジャーが警備に導入されたんですから	Don't you worry. SOLDIER has been added to the police force.	大丈夫警備導入	scene_06
ソルジャーの出動かぁ、久しぶりですよね。ねえ、先輩	Boy, it's been a while since SOLDIER's been mobilized, hasn't it?	出動久先輩	scene_06
僕、ソルジャーの試験落っこちちゃったんですよ。この話、しましたっけ？	I ever tell you that I flunked the SOLDIER entrance exam?	僕試験落話	scene_06
おう！！ペラペラペラペラ……	Damn right!! blahblahblah…		scene_06
すこしはだまって、仕事できねえのか！	Hey shut up for a minute and let me get back to work!	仕事	scene_06
……しゅん	…sigh.		scene_06
アバランチと先輩……どっちがこわいんだろ？	What are you more scared of AVALANCHE or me?	先輩	scene_06
きっと、先輩だな	Oh, you, of course.	先輩	scene_06
おう！！ここから先は立入禁止だ！！	HALT!! No one is allowed to pass!!	先立入禁止	scene_06
だいじょうぶ。ここはまかせて	Don't worry. You let me handle this.		scene_06
オロオロ…柱壊れちゃうんですか	Uh oh… There goes the pillar.	柱壊	scene_06
こわいんですけどあんたたちのためにね	I'm scared, but it's for your own good.		scene_06
ほんとにやばくなったら逃げだしますから。めったに見れるもんじゃないですし	If things get too hairy, we'll escape. It's not something you'll see happen too often.	逃見	scene_06
ウウッ……守ってくれよ。俺の素敵で不思議な場所	Uhh…Help! My strange and wonderful little place.	守俺素敵不思議場所	scene_06
あ、あの……これが、僕の仕事だから…ギリギリまでここにいないとならないんだ	L, look… This is my job, so I have to be here until the absolute last minute.	僕仕事	scene_06
うん…責任感の強いあなた、好きよ。私、そばについてるわ	Umm… I just LOVE men with a sense of duty. Let me stay here with you.	責任感強好私	scene_06
あ、あの……アバランチの人たちだいじょうぶかな？	B, but… What happens if AVALANCHE shows up?	人	scene_06
うん…あなた、ふるえてるのね？やさしい人…好きよ	Umm…you're shaking. You're so gentle…I think I'm in love.	人好	scene_06
おう！　これが俺の最後の仕事だ！登ってけ！！	Doh! And this was supposed to be my last job! Do something!!	俺最後仕事登	scene_06
こんなことになるなんてな！いい気分じゃねえ！明日、じひょうだ！	I never thought this would ever happen to me! Great… I'm quitting tomorrow!	気分明日	scene_06
あ……CLOUD……最後に……話せて良かった……	…CLOUD… I'm glad……I could talk with you…one last time.	最後話良	scene_06
最後だなんて……	Don't say 'last'……	最後	scene_06
もう、いい……いいの……	That's…all right…		scene_06
私たち……私たちの作戦でたくさん……人、死んじゃったし……きっと……そのむくい……ね	Because…of our actions…many……people died…… this probably……is our punishment…	私作戦人死	scene_06
……そうか……ですって……？	…Is…that so……?		scene_06
フフ…………相変わらず……クールな……元ソルジャーさん。……そこが……いいんだけどね……	Ha……cool……as usual… ex-…SOLDIER. …always…I liked that…in you…	相変元	scene_06
CLOUD ……やっぱり……星の命なんて……どうなろうと……興味ないか？	CLOUD… so you don't care…what happens… to the…Planet?	星命興味	scene_06
悪いけど興味ない	Nope, not interested	悪興味	scene_06
それよりケガが……	You're wounded……		scene_06
へっ……変わんええな。まあ……いいや。	Hmph…you haven't changed. Oh, forget it.	変	scene_06
ありがとよ、CLOUDでも……おれわいいから……BARRETが……上で戦っている。手をかしてやってくれ……	Thanks, CLOUD. …don't worry 'bout me…… BARRET's…fighting up there. Go help him…	上戦手	scene_06
TIFA！　CLOUD！ 来てくれたか！	TIFA! CLOUD! You came!	来	scene_06
気をつけろ！　やつら ヘリで襲ってきやがる	Be careful! They're attacking from the helicopter.	気襲	scene_06
本格的にくる敵に 装備を整えておいたほうがいいわ！さっそく来たわ！	Better equip ourselves before they attack in full force!	本格的敵装備整来	scene_06
【メニューボタン】でメニューをひらく	Press the (MENU) button to access the Menu.		scene_06
【決定ボタン】で終了	Press the (OK)button when finished.	決定終了	scene_06
【カンセルボタン】Change Partyをはずす	Press the (CANCEL) button for Change Party.		scene_06
さっそく来だわ！	Here they come!	来	scene_06
おそかった、とこのスイッチを押すと……	You're too late. Once I push this button…	押	scene_06
はい、おしまい！　作業終了	That's all, folks! Mission accomplished.	作業終了	scene_06
くっ！時間爆弾か！	DAMN! It's a time bomb!	時間爆弾	scene_06
解除しなくちゃ！ CLOUD！　BARRET！　おねがい！	We have to disarm it! CLOUD! BARRET! Please!	解除	scene_06
そういうわけにはいかないぞ、と タークスのレノさまの邪魔は 誰にもさせないぞっ……と	I can't have you do that. No one get in the way of Reno and the Turks…	邪魔誰	scene_06
CLOUD！ 止めかたがわからないの。やってみて！	CLOUD! I don't know how to stop this. Try it!	止	scene_06
……ただの時限爆弾じゃない	…It's not a normal time bomb.	時限爆弾	scene_06
ツォン	Tseng		scene_06
そのとおり。それを操作するのは難しい	That's right. You'll have a hard time disarming that one.	操作難	scene_06
どこかのバカ者が勝手にふれると困るからな	It'll blow the second some stupid jerk touches it.	者勝手困	scene_06
おねがい、とめて！	Please, stop it!		scene_06
クックックッ……	Ha ha ha……		scene_06
緊急用プレート解除システムの設定と解除は神羅役員会の決定なしではできないのだ	Only a Shinra Executive can set up or disarm the Emergency Plate Release System.	緊急用解除設定神羅役員会決	scene_06
ゴチャゴチャうるせえ！	Shut yer hole!		scene_06
そんなことされると大切なゲストがケガするじゃないか	I wouldn't try that…… You just might make me injure our special guest.	大切	scene_06
おや、知り合いなのか？	Oh, you know each other?	知合	scene_06
最後に会えて良かったな。私に感謝してくれ	How nice you could see each other one last time. You should thank me.	最後会良私感謝	scene_06
AERISをどうする気だ	What are you gonna do with AERIS!?	気	scene_06
さあな	I haven't decided.		scene_06
われわれタークスにあたえられた命令は『古代種』の生き残りをつかまえろ、ということだけだ	Our orders were to find and catch the last remaining Ancient.	命令古代種生残	scene_06
ずいぶんと長い時間がかかったがやっとプレジデントに報告できる	It's taken us a long time, but now I can finally report this to the President.	長時間報告	scene_06
TIFA、だいじょうぶだから！あの子、だいじょうぶだから！	TIFA, don't worry! She's all right!	子	scene_06
だからはやく逃げて！	Hurry and get out!	逃	scene_06
クックックッ！そろそろ始まるぞ。逃げきれるかな？	Ha, ha, ha… Well, it should be starting right about now. Think you can escape in time?	始逃	scene_06
???	We're not going to make it!		scene_06
おい、このワイヤーを使って 脱出できるぜ！	Yo, we can use this wire to get out!	使脱出	scene_06
上のプレートが落ちてきたら ひとたまりもないわ.いそがなくちゃ！	Once that Plate starts coming down it'll be too late. We gotta hurry!	上落	scene_06
マリン！マリン！！	Marlene! MARLENE!!		scene_06
マリーーーン！！	MAR---LE---NE!!		scene_06
ビッグス！	Biggs!		scene_06
ウェッジ！！	Wedge!!		scene_06
ジェシー！！	Jessie!!		scene_06
こんちくしょう！	Goddamn it!!!		scene_06
こんちくしょう！！	Dammit!		scene_06
こんちくしょうーー！！！！	DAMMIT ALL!!!!		scene_06
なんだ、こんなもの！	What the hell's it all for!?		scene_06
うおぉぉーー！！	ARGGHHHH!!!		scene_06
おい、BARRET！	Hey, BARRET!		scene_06
BARRET！	BARRET!		scene_06
おい！	Hey!		scene_06
BARRET、もうやめて……おねがい、BARRET	BARRET, stop… Please stop, BARRET.		scene_06
うわぁぁぁーー！！！	URGHHHH!!!		scene_06
クッ！ちくしょう……	God damn…		scene_06
マリン……	Marlene…		scene_06
………ねぇ、BARRET……	… BARRET?		scene_06
マリンは、マリンはだいじょうぶだと思うの	Marlene is… I think Marlene is safe.	思	scene_06
……え？	…huh?		scene_06
AERISが言ってたわ。『あの子、だいじょうぶだから』って、マリンのことよ、きっと	Right before they took AERIS, she said, 'Don't worry, she's all right.' She was probably talking about Marlene.	言子	scene_06
ほ、本当か！！	Rrr, really!?	本当	scene_06
ビッグス……ウェッジ……ジェシー……	Biggs… Wedge… Jessie…		scene_06
……あの３人は柱の中にいた	All three of them were in the pillar.	人柱中	scene_06
わかってる……	Think I don't know that?		scene_06
でもよ、でもよ！いっしょに戦ってきた仲間だ！	But…we, all of us fought together.	戦仲間	scene_06
死んじまったなんて……思いたくねえ！	I don't wanna think of them as dead!	死思	scene_06
……７番街の人たちも	…And the other people in Sector 7.	番街人	scene_06
ああ、ヒドイもんだぜ	This is all screwed up!		scene_06
オレたちを倒すために街ひとつつぶしちまうんだからな。いったい何人死んだんだ……	They destroyed an entire village just to get to us! They killed so many people…	倒街何人死	scene_06
……私たちのせい？アバランチがいたから？関係ない人たちまで……	…Are you saying it's our fault? Because AVALANCHE was here? Innocent people lost their lives because of us?	私関係人	scene_06
ちがう！　ちがうぜ！　TIFA！！	No, TIFA! That ain't it! Hell no!!		scene_06
なにもかも神羅のやつらがやったことじゃねえか！	It ain't us! It's the damn Shinra! It's never been nobody but the Shinra!	神羅	scene_06
自分たちの金や権力のために 星の命を吸い取る悪堂ども！  	They're evil and destroyin' our planet just to build their power and line their own damn pockets with gold!	自分金権力星命吸取悪堂	scene_06
その神羅をつぶさない限りこの星は死んじまうんだ！	[EMPTY LINE]	神羅限星死	scene_06
神羅を倒すまでオレたちの戦いはおわらねえ！！	Our fight ain't never gonna be over until we get rid of them!!	神羅倒戦	scene_06
……わからない	…I don't know.		scene_06
オレが言ってることわからねえのか！？	What don't you know!? You don't believe me?	言	scene_06
ちがう……わからないのは自分の……気持ち	It's not that. I'm not sure about…me. My feelings.	自分気持	scene_06
おまえはどうなんだ？	An' what about you?		scene_06
あいつ、どこへ？	Where's he think he's goin'?		scene_06
あっ！　AERISのこと！	Oh! AERIS!		scene_06
ああ、あの姉ちゃんか。何者なんだ？	Oh yeah, that girl. What's up with her?	姉何者	scene_06
……私もよく知らない。でも、マリンのことをAERISに頼んだの	…I don't really know… but she's the one I left Marlene with.	私知頼	scene_06
そうだ！　マリン！！	Damn! Marlene!!		scene_06
マリンはだいじょうぶってAERISは言ってたけど……	AERIS said that Marlene was safe.	言	scene_06
TIFA。もう、あともどりはできねえんだ	TIFA. There ain't no turnin' back now.		scene_06
『みやぶる』のマテリアを手にいれた！	Received "Sense" Materia!	手	scene_06
CLOUD！	CLOUD!		scene_06
マリンのところへ連れてってくれ！	Take me to Marlene!	連	scene_06
AERISを助けにいくのね？	You're going to help AERIS?	助	scene_06
ああ……でも、その前に確かめたいことがあるんだ	Yeah… But before that, there's something I want to know.	前確	scene_06
なに？	What's that?		scene_06
……古代種	…It's about the Ancients.	古代種	scene_06
よく聞け！古代種こそがこの星の正当なる支配者！	Now listen good! The Ancients are the rightful rulers of this Planet!	聞古代種星正当支配者	scene_06
セフィロス……？	Sephiroth…?		scene_06
しっかりしてくれよ！	Pull it together, man!		scene_06
われこそ古代種の血をひきし者。この星の正統なる後継者！	In my veins courses the blood of the Ancients. I am one of the rightful heirs to this planet!	古代種血者星正統後継	scene_06