カーム	Kalm		scene_09
裏の塔	Rear Tower (Pagoda)	裏塔	scene_09
宿屋１階	Inn: 1f	宿屋階	scene_09
宿屋２階	Inn: 2f	宿屋階	scene_09
CLOUDの過去	CLOUD's Past	過去	scene_09
『ピースメーカー』を手にいれた！	Received "Peacemaker"!	手	scene_09
『ガードアップ』を手にいれた！	Received "Guard Source"!	手	scene_09
……『ラストエリクサー』が落ちてきた！	…Dropped "Megalixir"!	落	scene_09
『せんすい』のマテリアを手にいれた！	Received "Underwater" Materia!	手	scene_09
『マスターまほう』のマテリアを手にいれた！	Received "Master Magic" Materia!	手	scene_09
『マスターコマンド』のマテリアを手にいれた！	Received "Master Command" Materia!	手	scene_09
『マスターしょうかん』のマテリアを手にいれた！	Received "Master Summon" Materia!	手	scene_09
からっぽだ……	Empty…		scene_09
手がとどかない……	Can't reach it…	手	scene_09
ここが、カームだ	This is Kalm.		scene_09
カームに着いたね	We've reached Kalm.	着	scene_09
ここが、カームね	So this is Kalm?		scene_09
……カームに着いたな	…this must be Kalm.	着	scene_09
おい、先に宿屋で待ってるぜ。チンタラせずに、早くこいよ！	Yo, I'll be waitin' at the inn… Hurry and get your butt over there!	先宿屋待早	scene_09
みんな、もう着いてるかな。はやく宿屋に行きましょ！	I wonder if everyone's there already? Let's hurry over to the inn!	着宿屋行	scene_09
宿屋でみんなが待ってるわ。行きましょう、CLOUD	Everyone's waiting at the inn. Let's go CLOUD.	宿屋待行	scene_09
宿屋でおちあう手はずだったな。……行くか	We're supposed to meet at the inn. …Shall we go?	宿屋手行	scene_09
とっとと来いよ	Get over here!	来	scene_09
じゃあ、先、行ってるね	Well then, I'll go on ahead.	先行	scene_09
行きましょう、CLOUD	Let's go CLOUD.	行	scene_09
行こう、CLOUD	Let's go CLOUD.	行	scene_09
神羅カンパニーが魔晄エネルギーを実用化してくれたおかげでわしらの生活も便利になったもんじゃ	Thanks to the Mako energy Shinra, Inc. develops for us, everything's more convenient now.	神羅魔晄実用化生活便利	scene_09
ちと、便利になりすぎたかもしれんがの	Maybe a little too convenient.	便利	scene_09
魔晄炉のある場所の土地はどんどんやせていってしまうという話だ	I hear that the natural resources near the reactors are being sucked dry.	魔晄炉場所土地話	scene_09
この町みたいに魔晄エネルギーは供給してもらうだけってのが一番いい方法なのさ	We're better off with the Mako energy.	町魔晄供給一番方法	scene_09
空中に浮かぶ都市と言われるミッドガル。一度、この目で見てみたいものだわ	The famous floating city, Midgar… Just once I'd love to see it in person.	空中浮都市言一度目見	scene_09
何をしているのかって？ミッドガルから送られてくる魔晄エネルギーの圧力をチェックしてるのさ	What does it do? It checks the pressure of the Mako energy sent from Midgar.	何送魔晄圧力	scene_09
ここは、アイテム屋だよ	This is the Item Store.	屋	scene_09
ここは、武器屋だよ	This is the Weapons Store.	武器屋	scene_09
ここは、マテリア屋だよ	This is the Materia Store.	屋	scene_09
ミッドガルじゃ、テロリストが魔晄炉を爆破したらしいぜ	I heard terrorists bombed a Midgar reactor…	魔晄炉爆破	scene_09
最近、ぶっそうな事が多いよな。やだ、やだ	There have been a lot of dangerous accidents recently. I hate it, just hate it.	最近事多	scene_09
ミッドガルでは、アバランチという反神羅組織が活動していたらしいがついに神羅のソルジャーによって全滅させられたそうだな	It seems there was this group called AVALANCHE runnin' around, but I guess SOLDIER finally wiped them out.	反神羅組織活動神羅全滅	scene_09
神羅カンパニーは、自分たちに逆らう者たちを、どんどん排除しようとしている	Shinra is trying to eliminate anyone, who stands up to them.	神羅自分逆者排除	scene_09
我々は、好むと好まざるに関わらず神羅カンパニーの支配を受け入れなければならないのさ	It don't matter if we like it or not. Shinra's taken over, and we gotta live with it!	我好好関神羅支配受入	scene_09
ちゅうぼうに入ってこないでおくれ	Stay out of the kitchen.	入	scene_09
プレジデント神羅が殺されたそうだな。それに息子のルーファウス新社長も大ケガしたっていうじゃないか	I heard President Shinra was killed. And his son Rufus, the new president, was badly hurt.	神羅殺息子新社長大	scene_09
どうだ、初耳だろ？	Hey, I bet that's news to you?	初耳	scene_09
おっ、事情通！	You're pretty smart!	事情通	scene_09
ふふふ……ここだけの話だが神羅親子を襲ったのはアバラなんとかいう組織だって話だぜ	Heh, heh…Just between us… I heard it was them Ava-whaddya call-ums that got President Shinra and his son.	話神羅親子襲組織話	scene_09
関心なしか？旅をするなら神羅カンパニーの動きには注目したほうがいいぜ	Don't care? If you're going to travel, you'd best keep an eye on what Shinra's doing.	関心旅神羅動注目	scene_09
ぼく、大きくなったら神羅のソルジャーになるんだ！そのために、いまからモウクンレンしてるんだ！！	When I grow up I'm gonna be in SOLDIER. That's why I'm training hard now!!	大神羅	scene_09
……お兄ちゃん、子供っぽくてわたし、はずかしい	My older brother's so stupid. He's so embarrassing I could just puke!	兄子供	scene_09
うりゃー、アシコシのタンレン～	Hyah, hayah, eagghh!		scene_09
うりゃー、コンジョウのトックン～	Hyah, hayah, eagghh!		scene_09
うりゃー、うりゃ、うりゃ～	Hyah, hayah, eagghh!		scene_09
魔晄エネルギーのおかげで生活が色々と便利になったわ。神羅さまさまよね	Thanks to Mako energy, life's pretty darn convenient. Thanks to Shinra.	魔晄生活色便利神羅	scene_09
あなたも、そう思うでしょ？	Don't you think?	思	scene_09
そうかもしれない	Yeah, maybe		scene_09
そんなことはない	You're full of it		scene_09
そうでしょ！もう、魔晄エネルギーのない生活なんて考えられないわね	See!? How would we get by without Mako energy?	魔晄生活考	scene_09
ふ～ん。でも、魔晄エネルギーのない生活なんて、私は考えられないわね	Hmm. But I'd hate to think of what life'd be like without Mako energy.	魔晄生活私考	scene_09
魔晄エネルギーのおかげでいろいろと便利になったけど……	Mako energy's made things a lot more convenient…	魔晄便利	scene_09
でも、そのかわりに動物や植物がどんどんへっているような気がするわ	But a lot of plants and animals have been disappearing at a rapid pace.	動物植物気	scene_09
わたしは、むかしの方がよかったんじゃないかと思うの	I think the old life was better.	方思	scene_09
ね、そうよね？	Don't you think so?		scene_09
そうでしょ？　そう思うわよね	Yeah, sure I'm right! You think so, don't you?	思	scene_09
お母さんとおなじことを言うのね	That's just what my mom said.	母言	scene_09
私は、動物とあそべたころの方がよかったと思うわ……	Things were better when you could play with animals…	私動物方思	scene_09
あっ、聞いてくれよ！なんかミッドガルにでっかい大砲がついちゃって、すごい事になっているよ	Listen to me! Something really big's happening in Midgar.	聞大砲事	scene_09
テレビによると、ルーファウスの２つめの作戦だとか……	They were just saying on TV it was Rufus' second strategy and…	作戦	scene_09
あの大砲は真北に向いてるけど……目標は……セフィロス？？	That big cannon's pointed due north… Do you think the target is Sephiroth?	大砲真北向目標	scene_09
ウェポンがやってくるって神羅カンパニーの人間は大騒ぎしとるよ	Everyone at Shinra's in an uproar because they heard Weapon's coming.	神羅人間大騒	scene_09
秘密兵器を運んでいた飛空艇が空を飛ぶウェポンに襲われて海に沈んでしまったとか何やら……	I heard a big hydroplane carrying secret weapons, was attacked by Weapon and was sunk at sea…	秘密兵器運飛空艇空飛襲海沈何	scene_09
ルーファウス社長がいなくなってはもう、神羅カンパニーもおしまいじゃな。……そして、この世界も	If something ever happened to President Rufus, That'd be the end of Shinra, Inc. and the rest of the world, too.	社長神羅世界	scene_09
おまえたち、ミッドガルから来たんじゃと？	Did you say you came from Midgar?	来	scene_09
わしも以前ミッドガルに住んでいたんじゃが近頃はあそこも色々あるようじゃな	I used to live there, too. But I heard they got lots of troubles lately.	以前住近頃色	scene_09
モンスターってのは神羅がつくったってウワサがあるがホントかねえ？	Is it true that Shinra makes monsters?	神羅	scene_09
そのとおり	It's true		scene_09
たんなるウワサ	Just a rumor		scene_09
どっちにしたって魔晄炉の世話になってるかぎり神羅にゃさからえないんだけどね	Yeah, well either way, as long as we use reactors, we can't stand up to Shinra.	魔晄炉世話神羅	scene_09
怪しい黒マントの男がこの町にいたんだ！ぶっそうな刀なんか持ち歩いてさ	There was a suspicious-looking man in a black cloak! He was carrying a mean-looking sword.	怪黒男町刀持歩	scene_09
ミッドガルじゃ、神羅とアバランチとかいうヤツらが戦争しているそうじゃないか	They say Midgar's in the middle of a war between the Shinra and some terrorists called AVALANCHE.	神羅戦争	scene_09
一泊、２０ギルです。とまっていかれますか？	20 gil a night. What's it gonna be?	一泊	scene_09
CLOUDさまですね。お連れさまが２階でお待ちです	Mr…CLOUD? Your party is waiting for you on the 2nd floor.	連階待	scene_09
この世界は、神羅カンパニーの動きにふりまわされているのさ。あんたたちも、それを受け入れる事だな	Shinra's leading the world around by the nose, and you guys are just gonna sit back and take it?	世界神羅動受入事	scene_09
オレはよぉ、この町の南にある鉱山【ミスリルマイン】で働いていたんだ	Me? I used to work in a mine down south called Mythril Mine	町南鉱山働	scene_09
しかしよぉ、その鉱山にモンスターがわんさか出るようになっちまってな	But, awhile back, monsters started appearing.	鉱山出	scene_09
おかげで、商売あがったり。ここで日がな１日飲んだくれてるのさ	After that, business went to pot and now I spend the days here drinking.	商売日日飲	scene_09
ウィ～、ひっく。オレはヨってるぞォ～！！	Urrrp!…hic… I'm stinking drunk!!		scene_09
お金が足りないようですね。またのおこしを、お待ちしています	Seems like you're a little short. Why don't you drop by again… when you have money.	金足待	scene_09
なんで、誰も信じてくれないんだ～！……こどくなボク	Why doesn't anyone believe me? I'm so lonely…	誰信	scene_09
あっ、聞いてくれよ！たった今、黒マントの男が東の草原に向かって歩いていったんだ	Listen to me! Just now, some guy in a black cloak walked east towards that grassy field.	聞今黒男東草原向歩	scene_09
ぶっそうな刀なんか持ち歩いてさ。なんか、おっかないヤツだったよ……	He's got this killer sword, and looks REAL scary…	刀持歩	scene_09
あっ、聞いてくれよ！	Aw, c'mon! Listen to me! Got anything interesting to say?	聞	scene_09
何か、おもしろいことでもないかなぁ……？	Locked. Can't open it…	何	scene_09
カギがかかっていて、開かない……	I gotta hurry up and get strong so I can crush Meteor to bits! But I gotta train real hard to do it.	開	scene_09
ぼく、はやく強くなってメテオをぶっこわしてやるんだ！そのために、いまからモウクンレンするんだ！！	Oh man, oh man!	強	scene_09
見たことも聞いたこともないようなでっかいモンスターはうろつきまわるしメテオは落っこってくるし……	Meteor's gonna fall on us, and now some huge monster like I've never seen is wandering around out there!	見聞落	scene_09
あ～、ボクたちはどーなってしまうんだ～～～～～！！	What's going to happen to all of us?		scene_09
メテオが落ちてくるだって！？やめてほしいぜ、そーゆーことはよ	I want you to stop that talk about Meteor falling on us!	落	scene_09
今までいっしょうけんめい働いてきたのによぉ メテオでみんな、パーになっちまうってか！？ 	Listen, I work hard…and now you're tellin' me Meteor's gonna smash everything to bits?	今働	scene_09
ケッ、ばからしくて、やってられっかよ。まじめに働く気なんか失せちまったぜ	Well, I ain't standin' around listenin' to fool talk like this. Makes a person lose the will to work, that's what it does!	働気失	scene_09
ケッ、やってらんねーよ。ばからしいったら、ありゃしねぇ	What're ya, dense? Something like that'll never happen! It's ridiculous!		scene_09
ミッドガルじゃ、メテオを破壊しようとおおわらわらしいぜ	And all of Midgar's gonna be destroyed by a falling meteor? Oh, don't make me laugh!	破壊	scene_09
ミッドガルじゃ、アバランチの残堂が神羅カンパニーを叩きつぶしたらしいぜ	I heard the remaining members of AVALANCHE smashed the Shinra troops at Midgar.	残堂神羅叩	scene_09
ミッドガルでは、アバランチの残堂が神羅カンパニーの抵抗をはねのけて魔晄キャノンを破壊したという話だ	They say the remaining members of AVALANCHE broke Shinra's resistance and destroyed the Mako cannon at Midgar.	残堂神羅抵抗魔晄破壊話	scene_09
これから、この世界はどうなってしまうのだろう……	What's going to happen to the world?	世界	scene_09
神羅カンパニーは、メテオやウェポンに対抗するため、各地の施設から役にたちそうなものを、ジュノンやミッドガルに集めているという話だ	I heard Shinra's taking it's biggest artillery from Junon and other facilities and gathering it in Midgar to fight Meteor and Weapon.	神羅対抗各地施設役集話	scene_09
ミッドガルに行けば、あのメテオが落ちても大丈夫なんじゃないかしら？	Even if Meteor falls, you ought to be safe as long as you're in Midgar.	行落大丈夫	scene_09
『魔晄都市』って言うくらいだからなんとかなりそうな気がするんだけど……	They say it's a "Mako Metropolis" so it will survive.	魔晄都市言気	scene_09
お若いの、空いっぱいに見えとるあのメテオが落ちてくるなんて信じられるかの？	Ah, youth… You really believe that big meteor filling up the sky is going to fall?	若空見落信	scene_09
こうなってしもうては神羅カンパニーだけがわしらの頼りじゃて	If that's the case then all we can do is put our hope in Shinra, Inc.	神羅頼	scene_09
最後の頼みの神羅カンパニーもテロリストにやられてしもうて……わしらはこのまま死ぬのかのぉ？	If Shinra, Inc. was our last hope, and they've been beaten by terrorists… Are we all going to die?	最後頼神羅死	scene_09
メテオが落ちてくるんだろ？神羅カンパニーがなんとかしてくれないとみんな死んでしまうことになるな	Meteor's going to fall, isn't it? Then we're all history unless Shinra does something about it!	落神羅死	scene_09
いまさら魔晄エネルギーの圧力をチェックなんてしてもしかたがないのだろうけど……	Why're you checking the Mako energy pressure at a time like this? It's probably already too late.	魔晄圧力	scene_09
こんな時だからこそ、ヤケにならずに今までどおりキチンと生活していかなきゃいけない、そう思うんだ	You can't go into a tail spin at a time like this. You've got to keep living just like before. At least that's what I think…	時今生活思	scene_09
メテオが落ちてくると言うけど大丈夫！そんなもの、神羅カンパニーがきっとなんとかしてくれるわよ	They say Meteor's going to fall, but that's okay! I'm sure Shinra'll come through for us in the end!	落言大丈夫神羅	scene_09
あなた、信じられる！？あの神羅カンパニーがつぶれちゃったんですって！！	Dear, can you believe it? They say that Shinra's gone under!!	信神羅	scene_09
アバランチなんていうテロリストが余計なことしてくれたおかげでもう、この世はおしまいよ	This world is coming to an end all because some terrorists called AVALANCHE stuck their noses in the wrong place!	余計世	scene_09
メテオが落ちてくるなんて……わたしたちは、どうなってしまうのかしら？	I can't believe Meteor's really falling this way… What's going to happen to us?	落	scene_09
メテオが落ちてくるんでしょ？ヘソクリ、どこにかくそうかしら……いや、それよりもヘソクリを持ってどこかへ逃げ出した方がいいのかしら？	Meteor's coming, right? Where will I stash my money? Wait, maybe I'd better take it with me and get out of here!	落持逃出方	scene_09
一泊、３００ギルです。とまっていかれますか？	One night, 300 gil. Wanna check in?	一泊	scene_09
ん？　あんた、旅行者だね。世界を旅する時に知っておくと役立つことがあるのだけれど……	Tourists, huh? Here are a few things you should know that will come in handy when you travel around the world…	旅行者世界旅時知役立	scene_09
教えて欲しいかい？	Want to hear what they are?	教欲	scene_09
それじゃ、ワールドマップでのコントローラ操作について説明してあげるとしよう	Then let me explain how to use the world map.	操作説明	scene_09
さて、何を教えてあげようか？	Well then, what do you want to know?	何教	scene_09
視点の切替について	Changing camera angles	視点切替	scene_09
地図の表示について	Map indicators	地図表示	scene_09
ボタン操作について	Operating the buttons	操作	scene_09
他に何か、ききたいことがあるかい？	Anything else you'd like to know?	他何	scene_09
もう、いいです	Nope, I got it		scene_09
まず、ワールドマップではコントローラの【Ｌ２ボタン】を押すと視点を変えることができる	First press [CAMERA] to change the camera angle.	押視点変	scene_09
選べる視点は２種類あるから自分の好きな方を選ぶといいね	There are 2 angles to choose from, select the one you like.	選視点種類自分好方選	scene_09
そして【Ｌ１ボタン】や【Ｒ１ボタン】を押してやれば、視点を左右に回してやることができるんだ	Then rotate the camera either way by pressing [PAGEUP] or [PAGEDOWN].	押視点左右回	scene_09
いろいろ試してみて自分にあった視点をさがしてやれば旅は、もっと楽しくなると思うよ	Try different angles until you find the one you like best. It makes the journey a lot more fun!	試自分視点旅楽思	scene_09
この世界の地図は【スタートボタン】を押してやると、見ることができる	Press [START] once to view the World Map.	世界地図押見	scene_09
地図には、大きいものと小さいものがあるから場合によって使い分けてやれば道に迷うことも少なくなると思うよ	There is a large and small map. Learn when to use which and you won't get lost.	地図大小場合使分道迷少思	scene_09
【スタートボタン】を何回か押してやれば地図を切り替えたり、消すことができるんだ。便利だろ？	Push [START] twice to change the size of the map, and once more to turn it off.	何回押地図切替消便利	scene_09
[COULDN'T FIND]	Pretty easy, huh?		scene_09
【決定ボタン】を押せば、乗り物に乗り【キャンセルボタン】を押せば乗りものから下りる。このへんは、そんなに難しくないね	Ride things by pressing [ASSIST] and get off by pressing [CANCEL]. This isn't so hard, either!	決定押乗物乗押乗下難	scene_09
あ、そうそう。ワールドマップではダッシュができないから【キャンセルボタン】は、乗り物から下りるときにしか押さない方がいいね	Oh, right. You can't dash on the World Map, so make sure not to press [CANCEL] unless you want to get off.	乗物下押方	scene_09
特にチョコボは下りると逃げちゃうからね。気をつけた方がいいよ	Remember this because Chocobos will run away as soon as you get off them, so be careful.	特下逃気方	scene_09
ワールドマップではメニューを開けばどこでもセーブできるからセーブはこまめにとったほうがいいよ	Once on the World Map you can access the menu to save your game anywhere. It's a good idea to save frequently!	開	scene_09
それじゃ、よい旅を	Well then, bon voyage!	旅	scene_09
そうかい？　それは残念。それじゃ、よい旅を	Is that so? Well, that's that. Have a nice trip.	残念旅	scene_09
……いいかげんに、しろっ！！	Damn!!		scene_09
ん、もうっ！！	Oh! You!!		scene_09
……なめてんじゃねぇっ！！	…don't mess with me!!		scene_09
え？　友人をさがしてる？ライフストリームはどこかって？	Huh? You're looking for your friend? You want to know where the Lifestream is?	友人	scene_09
ん～、君の友人の事はしらないけどライフストリームについては聞いたことあるよ	Hmm, I can't help you find your friend, but I've heard about the Lifestream.	君友人事聞	scene_09
【南の島】に旅行に言った時ある医者に世話になったんだけどその時に医者からそんな言葉を聞いたような覚えがあるけど……	When I traveled to the Southern islands, a doctor was very kind to me. I seem to recall him telling me something about the Lifestream…	南島旅行言時医者世話時医者言葉聞覚	scene_09
あっ、聞いてくれよ！神羅軍の動きが活発になってきたんだ	Hey, listen to me! The Shinra troops are on the move.	聞神羅軍動活発	scene_09
テレビによると、ルーファスは２つの作戦を打ち立てたらしいね。なんでもその１つはヒュージマテリアを集めて、ロケットで宇宙に飛ばすとか……	The TV news said Rufus came up with two plans. One, is to launch a rocket into space containing Huge Materia…	作戦打立集宇宙飛	scene_09
ヒュージマテリアの破壊力ってのはそんなにすごいのかなぁ？	Is Huge Materia really that destructive?	破壊力	scene_09
北のクレーターにセフィロスは巨大なバリアをはったんだ	Sephiroth put up a huge barrier around the North Crater.	北巨大	scene_09
ルーファスは、あの大砲でそれをぶち壊す計画なんだ	Rufus wants to use a mammoth cannon to smash the barrier.	大砲壊計画	scene_09
バリアがなくなったスキに神羅軍でセフィロスを直接攻撃するつもりなのさ	He plans to have Shinra troops rush in and attack Sephiroth after the barrier falls.	神羅軍直接攻撃	scene_09
北のクレーターのバリアがブッこわれたんだって！？	The North Crater barrier's been demolished?	北	scene_09
じゃあ今こそが、セフィロスを倒す好機なわけだ	So now's the time to defeat Sephiroth.	今倒好機	scene_09
あっ、聞いてくれよ！セフィロスを守っていたバリアはなくなったんだって！	Hey, listen to me! I heard the barrier protecting Sephiroth is gone!	聞守	scene_09
でも、ルーファスが死んでしまったから神羅軍は右往左往するばかり。ハイデッカーやスカーレットじゃ神羅をまとめるには力不足だし……	But with Rufus dead, the Shinra troops don't know what to do. Heidegger and Scarlet don't have what it takes to lead the troops.	死神羅軍右往左往神羅力不足	scene_09
せっかくなんとかなると思ったのにこれじゃ、何も変わってないのと同じじゃないか～！	I really thought something was finally going to happen, but everything's the same… Not a damn thing changes around here!	思何変同	scene_09
ボクのお父さん、炭鉱夫なんだけどミスリルの鉱山にモンスターがでてきて仕事ができなくなっちゃったんだ	My old man was a miner, but he couldn't go to work after monsters started appearing in the Mythril Mines.	父炭鉱夫鉱山仕事	scene_09
今じゃ、この奥の酒場でお酒ばっかり飲んで酔っぱらっているよ	Now all he does is sit around getting drunk in the bar…	今奥酒場酒飲酔	scene_09
ボクのお父さん、もうすぐメテオが落ちてくるというのにこの奥の酒場でお酒ばっかり……	My dad still just sits at the bar drinking, even though he knows Meteor's coming!	父落奥酒場酒	scene_09
いい大人のクセに、現実見えていないってのは、情けないよね。まいっちゃうなぁ、もう	It's sad. Even though he's an adult, he just doesn't want to see the world as it really is. I dunno what to do.	大人現実見情	scene_09
この町の南にある【ミスリルマイン】を抜けてさらに西へ行くと【ジュノン】という神羅カンパニーの港があるの	South of this town past the Mythril Mine and far to the west is a Shinra harbor called Junon.	町南抜西行神羅港	scene_09
そこにも魔晄炉があって大きな建物がたくさん建っているそうよ。ああ、行ってみたいわぁ	They say there's a reactor and many tall buildings there. I hope to see it someday.	魔晄炉大建物建行	scene_09
すべて、世は事もなし……、っと。和平じゃのう	The world's at peace… all's well.	世事和平	scene_09
明日は明日の風がふく……、っと。和平じゃのう	Tomorrow's another day… all's well.	明日明日風和平	scene_09
今日も元気だ、ごはんがうまい……、っと。和平じゃのう	I got my health, and enough to eat… all's well.	今日元気和平	scene_09
この数日で、この世界は大きく様変わりしてしまった……	The world's changed a lot in the past few days…	数日世界大様変	scene_09
天空をおおうメテオ……我が物顔でかっぽする巨大なモンスター……	That huge Meteor is covering up the sky and acting like it owned it.	天空我物顔巨大	scene_09
……ワシの友人も、おおぜい死んでしまった	A lot of my friends have died…	友人死	scene_09
ワシは、死んでしまった友人たちのめいふくをいのる旅に出ようと思う	I'm goin' on a journey to pray for their souls.	死友人旅出思	scene_09
沈ぼつ船とともに沈んだというめい界の地図。……【ガイドブック】千年に一度、砂ばくにさくという花。……【デザートローズ】きく者の心をおだやかにするたてごと。……【アースハープ】	A map that was sunk along with the ship. ..."Guidebook" A rose that blooms once every 1000 years in the desert. ..."Desert Rose" A harp that soothes those who hear it. ..."Earth Harp"	沈船沈界地図千年一度砂花者心	scene_09
誰かワシのもとに持ってきてくれる人はおらんかのう……	I wonder if there's anyone who'll bring it to me?	誰持人	scene_09
あとは【ガイドブック】さえあれば旅に出られるのじゃが……	Now if I can just get the "Guidebook", I can start my journey…	旅出	scene_09
あとは【デザートローズ】さえあれば旅に出られるのじゃが……	Now if I can just get "Desert Rose", I can stary my journey…	旅出	scene_09
あとは【アースハープ】さえあれば旅に出られるのじゃが……	Now if I can just get "Earth Harp", I can start my journey…	旅出	scene_09
【ガイドブック】と【デザートローズ】……おぬしたち、探してきてくれんか？	"Guidebook" and "Desert Rose"… Will you guys look for them for me?	探	scene_09
【ガイドブック】と【アースハープ】……おぬしたち、探してきてくれんか？	"Guidebook" and "Earth Harp"… Will you guys look for them for me?	探	scene_09
【デザートローズ】と【アースハープ】……おぬしたち、探してきてくれんか？	"Desert Rose" and "Earth Harp"… Will you guys look for them for me?	探	scene_09
おお、それは【ガイドブック】！ワシの持っている【水中呼吸マテリア】と交換せぬか？	OH! It's "Guidebook"! Wanna trade it for this Underwater Materia?	持水中呼吸交換	scene_09
どうじゃ？	How about it?		scene_09
交換する	Trade	交換	scene_09
交換しない	Don't trade	交換	scene_09
おお、それは【デザートローズ】！ワシのペットの【チョコボ】と交換せぬか？	OH! It's "Desert Rose"! Wanna trade it for that Chocobo over there?	交換	scene_09
おお、それは【アースハープ】！ワシの持っている【マスターマテリア】と交換せぬか？	OH! It's the Earth Harp! Wanna trade it for some Master Materia?	持交換	scene_09
１個なんてケチな事は言わん！３個セットにして渡すぞ	I'm not bein' stingy either! I'll give you all three of 'em!	個事言個渡	scene_09
よし、交換成立じゃな	Ok then, it's a done deal!	交換成立	scene_09
何が不満なんじゃ……	I dunno…	何不満	scene_09
【潜水マテリア】じゃ。持っていってくれ	it's Underwater Materia. Go on, it's yours!	潜水持	scene_09
【ウルトラチョコボ】じゃ。連れてゆくがええ	It's a Chocobo. Take it, it's yours!	連	scene_09
【マスターマテリア３点セット】じゃ。持っていってくれ	It's a 3-piece Master Materia set, …and it's all yours!	点持	scene_09
では、ワシはとむらいの旅に行くとするか……	I guess it's time to go on a journey for the souls of my departed friends…	旅行	scene_09
『チョコぼう』がいっぱいだな。空きをつくってから連れていくことにしよう	Looks like my Stable's full. I'll come back when I have room.	空連	scene_09