コスタ・デル・ソル港	Costa del Sol Harbor	港	scene_16
カッ～！！あついな、ここは！	Damn! Sure is hot here!		scene_16
だがよ、せいせいしたぜ！これで、ちっこいセーラー服とおさらばだからな	But I sure feel better now that I can say good-bye to this sailor suit.	服	scene_16
いいか！！こっからは一般人として行動しろ！	Yo listen up!! Y'all be sure to mingle like regular folks here!	一般人行動	scene_16
あら残念、BARRETの水兵姿。かわいかったのに、けっこう	Oh, too bad. I liked BARRET's sailor suit. He looked so cute.	残念水兵姿	scene_16
……かわいいだと	…What'ya mean 'cute'?		scene_16
うんうん	Right…well, uh…		scene_16
BARRET、あのセーラー服パジャマにしなさい	BARRET, why don't you use that sailor suit for pajamas?	服	scene_16
ね、CLOUDもそう思うでしょ？	Right, CLOUD?	思	scene_16
そんなことよりセフィロスを	Keep your mind on Sephiroth		scene_16
俺たちはバカンスで来たんじゃない。セフィロスを追うんだ	Remember, this isn't a vacation. We're here after Sephiroth.	俺来追	scene_16
先を急ぐぞ	I'm going on ahead.	先急	scene_16
ケッ！！　CLOUDさんよ。道草が好きなのは、おまえさんだろ	Hmmph, CLOUD. You're the one who's always hangin' around wastin' time.	道草好	scene_16
こんな場ちがいなリゾート地はすっ飛ばしていくぜ！！	I'm going to skip this resort!	場地飛	scene_16
ああ…マシュマロかぶったクマみたいでぴったりだったな	Ahhh… You look like a bear wearing a marshmallow.		scene_16
なにっ！！　よけいな世話だ！オレはこの一張羅がいちばん落ちつくんだ	The hell's that supposed to mean!? This happens to be the most comfortable, so shu'up!	世話一張羅落	scene_16
ゼェゼェ……	…puff…puff…		scene_16
すまないが、少し急いでくれないか。ここは暑い、私のアカハナがかわいてしまう	Would you kindly hurry? The heat here is drying my nose.	少急暑私	scene_16
あたしもっ！！	Yeah, mine, too!!		scene_16
わかった。小休止の後、出発する	All right. We'll take a break and then head off.	小休止後出発	scene_16
あまり、遠くへは行くな	Don't wander too far off.	遠行	scene_16
チッ！すっかりリーダー気取りだな	I'll wander wherever I damn well want! Who made him the leader?	気取	scene_16
じまんのけなみがみだれてきたようだ	It looks like my mane got messed up.		scene_16
すずしいところで休んでいるよ	I'm going to rest somewhere cool.	休	scene_16
およぎにいっちゃおうかな	I think I'll go swimming.		scene_16
そうしよっか？	Sounds good to me!		scene_16
んん……？　CLOUD君いまなんか想像しちゃったかな？	Hmm? CLOUD, are you thinking of anything in particular?	君想像	scene_16
クールな顔がくずれてますよ～	Your cool exterior's cracking…	顔	scene_16
さ、いこいこ！	Well then, let's go!		scene_16
たまには日焼けでもしちゃおっかな	Maybe I should get a tan for a change.	日焼	scene_16
CLOUDはどっちが好み？	Which do you like, CLOUD?	好	scene_16
はだは白いほうが好きだ	I like fair complexions	白好	scene_16
元気に焼けてるほうがいいかな	Maybe a healthy tan is nice	元気焼	scene_16
ハイっ、参考にしとくね	Got it. I'll remember that.	参考	scene_16
さがさないでくれよっ！	Don't bother looking for me!		scene_16
長時間の船旅おつかれさまです！！	What a long boat ride that was!!	長時間船旅	scene_16
ウム……ごくろう……	Hmmm… Good work everyone…		scene_16
ガハハハハ！！スキッフの準備を急げ！	Gya, Haa, haa…ha!! Hurry up with that!	準備急	scene_16
ハッ！！	Yes, sir!!		scene_16
セフィロスが乗っていたらしいな	I heard Sephiroth was on board.	乗	scene_16
……はっ	Yes.		scene_16
CLOUDたちも乗っていたらしいな	And it seems CLOUD and the others were on board, too.	乗	scene_16
どちらも取り逃がした……。大失態だな、ハイデッカーくん	They all slipped through… You messed up big this time, Heidegger.	取逃大失態	scene_16
めんぼくない……です	I'm ashamed of myself.		scene_16
いつから返事とあやまることしかできなくなったのだ…きみは	Is that all you can do? Give one word answers and apologize for everything?	返事	scene_16
……なんとかしたまえ。期待している	Do something. I'll be expecting results.	期待	scene_16
スキッフ発進準備完了いたしました！！	Ready for departure, sir!!	発進準備完了	scene_16
わかった。早かったな	Very well then. That was fast.	早	scene_16
ウム…君は優秀だ。覚えておこう	You're outstanding. I'll remember you.	君優秀覚	scene_16
ハッ！！ありがとうございます	YES, SIR!! Thank you, sir.		scene_16
いいかね？　ハイデッカーくん。失敗は１度までだ	Remember Heidegger, You're allowed only one mistake.	失敗度	scene_16
オレ、わかだいしょう！	I'm the boss!		scene_16
あなたたち、アクセク働く運搬船の労働者にはわからないでしょうねえ	But a bunch of hardworking deckhands like you wouldn't understand.	働運搬船労働者	scene_16
マリンブルーの海の上、どこまでも続くイターナルな空をながめながらセスナのつばさの上でおひるねする気分	On the marine blue sea, Gazing at the eternal skies that seem to go on forever… Gives you the feeling like you're taking a nap on the wing of a Cessna.	海上続空上気分	scene_16
そりゃあ、もう最高なのよ	It's the ultimate high!	最高	scene_16
なかなか、いい男ね……	He's quite handsome, isn't he?	男	scene_16
あっ！　あなたのことじゃないから安心して	Oh, don't worry, I'm not talking about you.	安心	scene_16
ルーファウス社長のことよ。魅力的よね、お金もってるし金髪だし、ダブルのスーツだし	I'm talking about President Rufus. Charming, rich, blond… He even looks good in a double-breasted suit.	社長魅力的金金髪	scene_16
ヘラヘラ……もうじき、神羅のお偉方がつくんだってよ	Heh, heh… I hear the Shinra brass are arriving soon.	神羅偉方	scene_16
ヘラヘラ……俺たちにはぜんぜん関係ねえよな	Heh, heh! Got nothing to do with us, does it?	俺関係	scene_16
おっと！！離れて離れて！！	Hey! Spread out, all of you, out!!	離離	scene_16
しもんつけたり、傷つけたりへこませたりしたらただじゃおかないぞ	Put any fingerprints, scratches, or dents on that plane and I'll put one in your head!	傷	scene_16
飛・行・機！！君たちには、一生手のとどかないしろもの	Da plane, da plane!! This's something you'll never be able to do in your lifetime.	飛行機君一生手	scene_16
ま、せいぜい遠くからながめるだけにしてくれよ	So you just watch from a distance… and wish.	遠	scene_16
ここは太陽ふりそそぐ常夏の楽園。コスタデルソルの港！	Costa del Sol…a harbor paradise where the sun always shines and it's summer all year round!	太陽常夏楽園港	scene_16
う～ん、うまくいきません…。観光案内は、街のほうでどうぞ	Hmm…Things aren't going well… You can go sightseeing in the city.	観光案内街	scene_16
君たち密航者なんでしょ	You're stowaways, right?	君密航者	scene_16
いやあ、いいですよ。もう、なれっこですから	It's okay. I'm used to them.		scene_16
じつは、僕もここに就職する前ね。密航の常習者だったりなんかしちゃって	The truth is, before I worked here, I was one of the best.	僕就職前密航常習者	scene_16
じゃましないでくれよ。ルーファウスさんが社長就任以来初の到着なんだ	Don't bug me. This is Rufus's first official visit since becoming President.	社長就任以来初到着	scene_16
今回はめずらしく仕事の用事みたいなんだけどね	It seems like he's here on business this time.	今回仕事用事	scene_16
でも、うらやましいよなあ。ボクとそんなに年もかわらないのに社長だもんなあ	I'm so jealous of him I could spit. We're both about the same age but he's President.	年社長	scene_16
まいったなあ…。神羅の課長さん、おりてこないんですよ	Oh crap… The manager of Shinra won't come down.	神羅課長	scene_16
出張で来てるのにねえ。仕事忘れちゃって、遊んでばっかり	Even though the President's here on business. All he does is play, forgetting everything to do with work.	出張来仕事忘遊	scene_16
ルーファウスさんにほめられちゃいましたよ！	Rufus complimented me on my job!		scene_16
いやあ～～仕事のしがいがあるってもんです	Wow!! I guess it pays to do good work.	仕事	scene_16
まいったなあ。パンツまでびしょびしょ	Damn. I'm soaking wet down to my underwear.		scene_16
あ！　あんたたち、もしかしてちまたで噂のアバランチの残堂！！	Oops! You must be those AVALANCHE guys!	噂残堂	scene_16
さ！　早く逃げて逃げて。運搬船はハイデッカーの管理下に置かれちゃいましたよ	Quick! Let's get outta here! Heidegger's in charge of the transport ship.	早逃逃運搬船管理下置	scene_16
たいへんですね、おたがい	That's tough for both of us.		scene_16
神羅のスキッフ、乗ってみたいかい？	Ride the Shinra ship?	神羅乗	scene_16
そうだな、悪くないな	Yeah, I could go for that	悪	scene_16
そうじゅう、難しそうだな	Don't think I could steer it	難	scene_16
そうか……そうなのか	Oh…is that so?		scene_16
う～ん！中古の払い下げスキッフがあるんだけど観光客相手の商売でもはじめようかと思ってね	Yep! Actually, we do have an old junker we're gonna get rid of, And I was thinking about going into the tourist business.	中古払下観光客相手商売思	scene_16
でも、いざやるとなると大変だから…。もすこし、考えさせてよ	But it's probably tougher than it looks I better think this through a little more…	大変考	scene_16
そうだよな！素人には無理だよな！	Yeah. It's too much for an amateur!	素人無理	scene_16
ウォォォ！！！こんな会社、やめてやるぅ！！	Oh, oh, oh!!! I'm gonna quit this company!!	会社	scene_16
やめてやるっぞう！！	I mean it, I'm really gonna quit!!		scene_16
ハイデッカーのバカヤロウッー！！	Heidegger's such an idiot!!		scene_16
ルーファウスのかっこつけやろうー！！	And Rufus, acting all big!!		scene_16
ああ、きもちいい……	God, that sure felt good…		scene_16
運搬船は、当分の間、出航しませんよ。ハイデッカーの指示なしにはね	The transport ship won't be sailing for quite awhile. Heidegger's orders.	運搬船当分間出航指示	scene_16
ただし！！　僕にも家ではらすかせて待ってる家族がいる。ただってわけにはいかない	Thinking of being stowaways?	僕家待家族	scene_16
ジュノンまで１００ギル。そんだけもらえれば船長に口聞いてあげてもいいぜ	It's 100 gil to Junon. Give it to me, and I'll put in a good word with the captain.	船長口聞	scene_16
どうする？	What'll we do?		scene_16
１００ギル払う	Pay up	払	scene_16
そうかい、密航したくなったらいつでもおいでよ	Thank you. Come back any time you want to stowaway on our ship.	密航	scene_16
お～い、金もないのに密航だなんて笑わせんなよ	Hey! No money? And you're trying to stowaway? Don't make me laugh!	金密航笑	scene_16
おっけ～。ほら、こっちだ	Okay. Come on. This way.		scene_16
快適な船旅とはいえないだろけどがまんしてくれよな	It's not the most pleasant ride but make the best of it.	快適船旅	scene_16
ルーファウスさんにほめられて以来ひとしきり走り回って来ましたがなんの音さたもなし……	Ever since Rufus complimented him, he strutted around for awhile, and haven't heard a peep from him since…	以来走回来音	scene_16
今日も最高のおひるね日平。もうそれだけでごっきげんなのよね～！	Today's a great day for a nap in the sun. It always puts me in a good mood!	今日最高日平	scene_16
あれ、君たち？世界を飛びまわってるって顔してるね。なんだか知らないけど、がんばってくれよ	Hey, who're you? You look like you've been around the world twice.	君世界飛顔知	scene_16
メテオだなんだと、みなさん大あわてで最後のヴァカンスをとりにやってくるもんだからボクら、かえっていそがしいですよ	I don't know what your story is, but hang in there.	大最後	scene_16
はぁ……ボク、最後まで走りまわっているんだなあ	Everyone's in a rush to get one last vacation in before the Meteor strikes. That's why it's so busy here.	最後走	scene_16
ジュノン行きはでてないんだ。最近、物資の買い占めが多くてもうてんてこまいさ	There's no ship to Junon. Recently, there's been a hoard on materials. Everything's topsy-turvy.	行最近物資買占多	scene_16
こうしておひるねしていられるのもあとわずかな時間なのね	Not gonna be able to nap like this for much longer.	時間	scene_16
そう思うとなんだかさみしい気分になっちゃうのよ	When you put it that way, I feel kind of sad.	思気分	scene_16
ま、俺は気楽なもんだよ。いざとなれば空に逃げちゃうからねえ	Well, I'm not worried. When it all comes down, I'm heading for the skies.	俺気楽空逃	scene_16
一番の間題は……おりる場所が残っているかどうかだよな	The only problem is… will there be anywhere left to land?	一番間題場所残	scene_16
カッー！！あついな、ここは！	Damn! Sure is hot here!		scene_16
あら、BARRETの水兵姿。かわいかったよ、けっこう	Oh‚too bad. I liked BARRET's sailor suit. He looked so cute.	水兵姿	scene_16
うんうん。	Right…well, uh…		scene_16
そんなことより黒マント男を	Concentrate on Sephiroth	黒男	scene_16
すまないが、少し急いでくれないか。ここは暑い、私のしたがかわいてしまう	Would you kindly hurry? The heat here is drying my nose.	少急暑私	scene_16
あなたたち、アクセク働く運搬船の労働者には わからないでしょうねえ。	You'll never know what it's like to toil away on the ship.	働運搬船労働者	scene_16
マリンブルーの海の上、どこまでも続く イターナルな空をながめながら セスナのつばさの上でおひるねする気分。	Sailing over the blue sea, gazing up at a sky that seems to drift on forever. Feels like you're taking a nap on birds wings.	海上続空上気分	scene_16
あっ！　あなたのことじゃないから 安心して。	Don't worry‚I'm not talking about you.	安心	scene_16
ヘラヘラ…… もうじき、神羅のお偉方がつくんだってよ。	Heh‚heh… I hear the Shinra brass are arriving soon.	神羅偉方	scene_16
おっと！！ 離れて離れて！！	Hey! Spread out‚all of you‚out!!	離離	scene_16
しもんつけたり、傷つけたり へこませたりしたら ただじゃおかないぞ。	Any of you put a scratch or a dent in that plane and I'll put one in your head!	傷	scene_16
飛・行・機！！ 君たちには、一生 手のとどかないしろもの。	Da plane‚da plane!! Here's something you'll probably never get to do in your lifetime.	飛行機君一生手	scene_16
ここは太陽ふりそそぐ常夏の楽園。 コスタデルソルの港！	Costa del Sol…a harbor paradise where the sun always shines and it's summer all year round!	太陽常夏楽園港	scene_16
君たち密航者なんでしょ。	Stowaways‚right?	君密航者	scene_16
いやあ、いいですよ。 もう、なれっこですから。	It's okay. I'm used to them.		scene_16
じゃましないでくれよ。 ルーファウスさんが社長就任以来 初の到着なんだ。	Don't bug me. This is Rufus's first official visit since becoming President.	社長就任以来初到着	scene_16
今回はめずらしく仕事の用事みたい なんだけどね。	It seems like he's here on business this time.	今回仕事用事	scene_16
まいったなあ…。 神羅の課長さん、おりてこないんですよ。	Oh crap… The Shinra Manager won't come down.	神羅課長	scene_16
ルーファウスさんに ほめられちゃいましたよ！	Rufus complimented me on my job!		scene_16
まいったなあ。 パンツまでびしょびしょ。	Damn. I'm soaked down to my underwear.		scene_16
あ！　あんたたち、もしかして ちまたで噂のアバランチの残堂！！	Oops! You must be those AVALANCHE guys!	噂残堂	scene_16
さ！　早く逃げて逃げて。 運搬船はハイデッカーの管理下に 置かれちゃいましたよ。	Quick! Let's get outta here! Heidegger's in charge of the transport ship.	早逃逃運搬船管理下置	scene_16
そうか……そうなのか。	Oh…is that so?		scene_16
う～ん！ 中古の払い下げスキッフがあるんだけど 観光客相手の商売でもはじめようかと 思ってね。	Yep! Actually‚we do have an old junker we're gonna get rid of, And I was thinking about going into the tourist business.	中古払下観光客相手商売思	scene_16
ハイデッカーの バカヤロウッー！！	Heidegger's such an idiot!!		scene_16
売り家（旧神羅べっそう）	House for Sale	売家旧神羅	scene_16
CLOUDべっそう	CLOUD's Villa		scene_16
ふかふかベッド……ん～　きもちいい…	What a fluffy bed! It feels so great		scene_16
ん～もうちょっとだけ…	Mmm… five more minutes…		scene_16
いやはや……お客さんとは気がつきませんではずかしいところをお見せしました	Oh, I'm sorry. I didn't know you were here. This is so embarrassing.	客気見	scene_16
どうぞごゆっくりごらんください	Take your time and look around.		scene_16
ところで、お客さん。ほんとに買う気あるんですかい？	So are you seriously considering buying?	客買気	scene_16
なんのことだ	The heck do ya mean?		scene_16
失礼する	I'm out of here	失礼	scene_16
まあ、そうでしょう。ひきとめはしませんよ	Yes, you're right. I'm sorry, please continue.		scene_16
ここは何を売ってるんだ	What are you selling?	何売	scene_16
いやですねえ。やっぱりひやかしですか？	That's pretty low. Are you pulling my leg?		scene_16
このお家ですよ。お家。もとプレジデント神羅所有のべっそう。最近、売りにでましてねえ	I'm talking about this house. This villa used to belong to President Shinra. It only recently came back on the market.	家家神羅所有最近売	scene_16
どうですか？	How do you like it?		scene_16
広い敷地にごうか家具＆ふかふかベッド。おまけに地下室までついちゃう	It has a large lot, comes fully furnished with this goose-down bed, and there's even a basement to boot.	広敷地家具地下室	scene_16
土地のみんなには神羅べっそうと呼ばれてますよ	The villagers call it the Shinra Villa.	土地神羅呼	scene_16
もっちろん、値ははりますがね	Of course, we're not giving it away…	値	scene_16
いくらだ？	How much is it?		scene_16
おろっ？買う気ある、ビンボー人のくせに？	Wha? How do you plan to buy it without a dime on you?	買気人	scene_16
ま、社会勉強のため値段だけは教えときましょはい、ポッキリ３０万ギルね。	Well, the price, for your information, is a steal at 300,000 gil.	社会勉強値段教万	scene_16
手がでないでしょ。帰った！帰った！	Out of your range? Out! Go on, out!	手帰帰	scene_16
地下室の品は、ほんのサービスですよ。	All items in the basement are included in the sale.	地下室品	scene_16
まあ、お金でもたまったらまたおいでください	Well, please come by again if you should strike it rich.	金	scene_16
もっとも、ゴールドソーサーでひとやま当てたりでもしなけりゃむりでしょうけどねえ	I wouldn't hold my breath waiting for that to happen unless you win big at Gold Saucer.	当	scene_16
どうです。りっぱなもんでしょう	Well, what do you think? Isn't it a fabulous villa?		scene_16
べっそうをもつ……その心地とステータス。いいもんですよ	The feeling you get with owning a villa is simply… indescribable.	心地	scene_16
ま、気長にまつことにしますよ	Well, let's wait for the captain.	気長	scene_16
ん～ひやかしはやめてください	Hmm Is this some kind of joke?		scene_16
ん～　きせきだ！！まさか、ほんとにお金をもってるお客がたずねてくるとは……	'Praise the Lord,' it's a miracle!! Who'd ever think someone with some real money would ever come here?	金客	scene_16
なにもいいことないと思いますけどほんとに買いますかい？	I probably shouldn't even ask, but are you really going to buy it?	思買	scene_16
３０万ギル支払う	Yep, 300,000 gil	万支払	scene_16
気が変わった	I changed my mind	気変	scene_16
ん～　さようなら！！ボクのふかふかベッド！！	Hmm, good-bye!! Good-bye fluffy bed!!		scene_16
ん～よかった～！	Oh well, I'm kind of glad!		scene_16
『CLOUDべっそう』を手にいれた！	Bought "Villa CLOUD"!	手	scene_16
俺のべっそうだ。休んでいくかな	This is MY villa. Rest up in your new villa?	俺休	scene_16
休む	With pleasure	休	scene_16
地下室	Cellar	地下室	scene_16
ん～こしがいたい～	Geez my lower back's killing me!		scene_16
ども！わし、管理人です	How do you do? I'm the manager.	管理人	scene_16
どぞ、よろしく	Nice to meet you.		scene_16
では、失礼して…おやすみなさい	Well, if you'll pardon me, I'll be leaving. Good-night.	失礼	scene_16
あっ、そのへんの品はサービスですからご自由におもちください	Oh, those items are free, so please help yourself.	品自由	scene_16
『モータードライブ』を手にいれた！	Received "Motor Drive"!	手	scene_16
『炎の指輪』を手にいれた！	Received "Fire Ring"!	炎指輪手	scene_16
コスタ・デル・ソル	Costa del Sol		scene_16
ねえ、たいくつしてない？	Say, aren't you bored?		scene_16
それほどでもない	Not that much		scene_16
バトルがおおくてね	Yeah, we fight a lot		scene_16
あら、いいじゃない。そりゃあ、ぜいたくってもんよ	Isn't that good? You're just expecting too much.		scene_16
あら、そ～う。わたしは、ちょっ～とたいくつな気分なのよ	Oh, really? I'm a little bored.	気分	scene_16
さっ、お仕事ね！	Come on, back to work now!	仕事	scene_16
はい、こちら！コスタ・デル・ソル観光案内で～す	Here you are! The Costa del Sol tourist information guide.	観光案内	scene_16
なにが知りたいのかしら？	What do you want to know?	知	scene_16
宿を探してる	Where's the inn?	宿探	scene_16
店を探してる	Where're the stores?	店探	scene_16
観光案内してくれ	Show me around town	観光案内	scene_16
そうねえ、街はずれのリゾートインがおすすめよ	Let's see. I recommend a resort located on the outskirts of the city.	街	scene_16
あら？　もしかして、アッチ関係のお店？それなら、ＢＡＲで話してみるといいわ	If you're looking for souvenirs, we recommend Butch's.	関係店話	scene_16
ちょっと、まってね。いま、マニュアル見るから	Wait a minute. I'm going to look at my guidebook.	見	scene_16
ここ、コスタ・デル・ソルは西の大陸のげんかんとしてまた、世界有数のリゾート地として古くから発展してきました……	It says, Costa del Sol is the gateway to the West, and is a prominent world renown resort, which has been around for ages.	西大陸世界有数地古発展	scene_16
あ～ん、もう！どうでもいいわね。そんなこと	Come on! I don't care about that!		scene_16
遊ぶんだったら、ビーチへどうぞ。かわいい女の子もたくさんいるわよ	If you want a good time, go to the beach! There are lots of beautiful women.	遊女子	scene_16
あなたたち、もしかしてお金持ち？	You wouldn't happen to be…rich?	金持	scene_16
そうでもない	Well, not so		scene_16
うそ～！身なりを見れば、わかっちゃうわよ	You're kidding! You can't tell just by looking.	身見	scene_16
でも、いちおう、教えとくね	But I'll tell you just in case.	教	scene_16
コスタ・デル・ソルで休んだ後はゴールドソーサーへぬけるのがリッチでメジャーな観光コースなの	After relaxing at Costa del Sol, stop by the Gold Saucer. It's a rich and exciting place to play!	休後観光	scene_16
やっぱりね～	I thought so.		scene_16
でも、もしかして興味あるかしら？ゴールドソーサーへの道	Are you interested? This is the road to Gold Saucer.	興味道	scene_16
ここから、ずっ～と南のゴールドソーサーにはカジノや遊園地があるのよ	Head south to the Gold Saucer, and you'll find casinos and an amusement park.	南遊園地	scene_16
でもね～　歩いていくのは山こえ谷こえ、そりゃもうたいへんらしいの	But if you're planning to walk, you'll have to cross mountains and valleys. I wouldn't recommend it.	歩山谷	scene_16
ま、旅してるなら一度は行ってみるといいんじゃない	But if you're on a vacation, you should go there at least once.	旅一度行	scene_16
よぅ！　元気！！オイラ、のんき！！	Yo! Wassup! We jus' hangin' out!!	元気	scene_16
あ～ん！　まぶしい太陽！今日もいい天気！	Oh, the sun's so bright! Looks like another wonderful day!	太陽今日天気	scene_16
１、２、３！！キッキン！	1, 2, 3, here we go!		scene_16
わたし、聞いちゃった。あの大きなイヌ、人の言葉話すの	I heard. That big dog talks like a human.	聞大人言葉話	scene_16
じっちゃん、あついよぅ……だって、へんなの！	That's cool …but weird.		scene_16
海でね。気持ちの悪いおじさんがてまねきしてたの	It's the ocean. A creepy man was signaling for us to come.	海気持悪	scene_16
こわかったからね。ここで遊んでるの！	I was scared to come here!	遊	scene_16
フム、興味深い	Hm, that's interesting.	興味深	scene_16
この行動だが、私はやりたくてやってるわけではないのだ	It's not as if I'm doing this because I want to.	行動私	scene_16
このシッポめが私の意志とは無関係に動いてしまうのだよ	You see, this tail of mine, moves quite independently of my will.	私意志無関係動	scene_16
ガルルル……	Grrr…		scene_16
ね、このへんで手をうっちゃおうか	Shall we play our hand around here?	手	scene_16
だめ、だきょうしちゃいけない	Not yet. Remember, no compromises.		scene_16
そうね。旅費だって高かったんだし	You're right. After all, this trip was expensive.	旅費高	scene_16
でも、なんだってこのくらいのしか声をかけてこないの	But only your average Joes are trying to pick us up.	声	scene_16
それはきっとあれ。あたしたちがうつくしすぎるってやつ	Well, that's because we're just too beautiful and hard to approach.		scene_16
そうね。あ～ん、ふつうの子がうらやましい	I guess so. Well, I envy the plain Janes.	子	scene_16
ね、もういいんじゃない？コレで、がまんしちゃおう	Why don't we compromise? We'll make do with what we have.		scene_16
あなたの楽しい旅の記念にコスタ・デル・ソル特製『金の針』はいかがですか？	How about some 'Soft' as a memento of this wonderful trip? Made especially in Costa del Sol!	楽旅記念特製金針	scene_16
ブッチ	Butch		scene_16
いやあ、ピチピチした女の子でもやとって楽がしたいですなあ	Yeah, I'd like to find a gorgeous chick and have a great time.	女子楽	scene_16
いやあ、バイトでかわいい子がはいってくれたんで大助かりです	Well, we're lucky to have that cutie working for us part-time.	子大助	scene_16
やられました……。やとったばかりのバイトの女の子	You got me there… We just hired her part-time.	女子	scene_16
店の売り上げと商品のマテリアもってとんずらしちゃいましたよ	She ran off with our money and Materia.	店売上商品	scene_16
世の中、うまい話はないもんですなあ。 	I guess any situation that seems too good to be true, usually is.	世中話	scene_16
ま、あまりもんでよかったら、見てってください	Well, please feel free to browse around. Just don't mind looking at leftovers.	見	scene_16
あ、CLOUD！ちょっとだけ、かせがせてよ	Ah, CLOUD! Let me make a buck why don't you?		scene_16
ここはマテリアも売ってんだ。ね、なんか買ってってよ！	I'm sellin' Materia. Why don't you buy some?	売買	scene_16
お客さん、注文はカウンターでおねがいします	Orders are taken at the counter.	客注文	scene_16
はだしでけるのいた～い！	It hurts when you kick me with your bare feet!		scene_16
どうして！！	Why's that!?		scene_16
まだ！！	Not yet!!		scene_16
キッ～～！！	Eaghhh!		scene_16
あなたのせい！！	It's your fault!		scene_16
なによっ！	What's wrong with you!?		scene_16
やるのっ！！	You wanna go!?		scene_16
フッーーーー！！！	Whew!!!		scene_16
男……	A man…	男	scene_16
いい男……	A good-looking man…	男	scene_16
どこ……	Where?		scene_16
オホホホホ……	Ho! Ho! Ho…		scene_16
もう観光案内どころじゃないのよ。……ほんとはね。ゴールドソーサーも休業続きらしいし	I don't feel like sightseeing around town. What I really want to do is have fun…  …too bad Gold Saucer is temporarily closed.	観光案内休業続	scene_16
でも、メテオ好きのお客さんがけっこう多くて…いやだわ	Butch	好客多	scene_16
もうだしおしみなし！世界の終わり大セールだよん！！	Wanna buy a souvenir to remember participating in the Meteor tour?	世界終大	scene_16
メテオかんしょうツアー参加しるしの入ったアイテムはいかが？	Oh wow!! Man, that's huge!!	参加入	scene_16
うひゃ～！！でっけ～！！	The stars!! They're in flames!!		scene_16
お星さま～！！メラメラ～！！	They're burning. Someday they'll burn out.	星	scene_16
燃えてるわ。でも、いつか燃えつきるの	The stars are just like our youth.	燃燃	scene_16
わたしたちの青春とおなじよ	Ho! Ho! Ho! It's the end of the world.	青春	scene_16
オホホホ……終わりなのよ	Bar	終	scene_16
おキャクさん、ノむか、サケ？ソだな、ウン、ゆっくりしてケ	Mukki		scene_16
僕、この街、気にちゃった	You could walk around here naked, and no one'd look twice.	僕街気	scene_16
はだかで歩いてても白い目で見られないもんね	…huff…puff… I can't stand hot places…	歩白目見	scene_16
ゼェゼェ……あついとこ、苦手……	…HIC… Mm? Wanna order? We're outta that now.	苦手	scene_16
ヒッッック…ん？　注文かい？いまはないよぅ	Hey! I thought you'd drop by.	注文	scene_16
あらっ！　いらしてくれるとおもってたわ♥	(That's 1, 2…4 fishes all together…not bad.)		scene_16
（つったさかなが１匹２匹…これで、４匹め。まあまあね）	Come on…please. If you don't buy from me… I won't be able to pay the rent.	匹匹匹	scene_16
たのむよ、買ってくれないと俺の生活が…	Yeah, snowboarding's what's happening this year.	買俺生活	scene_16
やっぱ、今年はスノボかな。もうサーフィンはあきちゃったよ	I'm sick of surfing.	今年	scene_16
オレたち、これからゴールドソーサーへむかうんだ	We're all headin' over to Gold Saucer now.		scene_16
噂のチョコボレースで旅費をかせいで	We're gonna make a ton of money at the Chocobo races.	噂旅費	scene_16
スノボやりにアイシクルロッジへ長い旅するのさ	Then we're gonna take a trip to Icicle Inn and snowboard.	長旅	scene_16
バールデルソルへようこそ！トロピカルな夜にかんぱい！	Welcome to Bar del Sol! Here's to tropical nights!	夜	scene_16
オレたちには、やっぱサーフィンがおにあいさ	We look like great surfers…		scene_16
なんてたって、水着しか着る服もってないんだから	But the only clothes we have are these swim trunks.	水着着服	scene_16
長い旅してわかったよ。この街の海が最高だったてことがさ	I traveled around a long time… And this town has the most beautiful ocean I've ever seen.	長旅街海最高	scene_16
見なれちゃったり、近すぎたりしてさ 	Sometimes you can't recognize things when they're right in front of you.	見近	scene_16
そこにあるのがあたりまえみたいになるとわからなくなることってあるよな	I guess I took it for granted because it's so close, and I was so used to seeing it all the time.		scene_16
ま、そんなわけでまいもどってきたわけよ	That's why I came back here.		scene_16
メテオだかなんだか知らないがオレはまだあきらめない！	I don't care whether Meteor comes or not, I'm not giving up yet!	知	scene_16
コスタデルソルの海の最高の波にのってないんだからな！	I still haven't surfed the best waves of Costa del Sol!	海最高波	scene_16
それまでは、ふってくるんじゃねえ	I hope the Meteor doesn't strike before I do.		scene_16
夜の海にうつるメテオの姿は不気味だぜ～。さすがにふるえちまったよ	It's weird seeing Meteor's reflection on the sea in the evening! It gives you the creeps.	夜海姿不気味	scene_16
でもなあ、それでも太陽はのぼってきたぜ！な、すてちゃいけないよな、アレをさ	But the sun has risen! ???	太陽	scene_16
ま、そんなわけで今日もこの店にいるわけよ	Well, for that reason, I'm at the store today too.	今日店	scene_16
おキャクさん、ワタシ、コトバできるよにもっとおボえたい	I wan' learn how speak beddah.		scene_16
ホシ、ふってくるのこまル。おキャクさんも、そだな、ウン！	But don' wan' have stars fall down. You think…same?		scene_16
僕は静かにお酒を飲むです	I just want to sit here with my drink.	僕静酒飲	scene_16
ボクチンは先輩の考え方がわからない！	My boss is a total arrogant ass!	先輩考方	scene_16
ボクチンはさけぶぞ！みにくいくらいのたうちまわるぞ！	I'm gonna tell him off! I'm gonna scream my head off!		scene_16
生きるってのはそういうことじゃないのかい！どですかね？	Isn't that what life's all about? What do you think?	生	scene_16
ゼェハァ……暑さも寒さも星の思い出…	…huff…wheeze… Heat and cold are just memories of the Planet…	暑寒星思出	scene_16
たのむよ、買ってくれないと俺の生活どころか…みんなの生活が……	Come on…please. If you don't buy from me… I can't pay the rent. No one else will either.	買俺生活生活	scene_16
お店のなかではや～なことなんてわすれてたのしんでいってね♥	While you're here, forget all those awful things going on outside, and just enjoy yourself.	店	scene_16
コスタデルソル・イン	Costa del Sol Inn		scene_16
チェッ！　調子わるっ！あっ！！　あんたさ！	Uggh!  I feel God awful! Oh!! You!	調子	scene_16
あの大きな水兵さんの連れの方だろ？	Weren't you with that big sailor?	大水兵連方	scene_16
俺には関係ないな	Wasn't me	俺関係	scene_16
……人ちがいか。こまるんだよね。あの人、トイレ占拠しちまって	Wrong guy? This is bad for us. That guy's taken over the john.	人人占拠	scene_16
宿代の支払いもまだだし	And he hasn't even paid his hotel bill yet.	宿代支払	scene_16
聞いてくれます？	Listen to this…	聞	scene_16
いきなり！　大きな水兵さんがドカドカとやってきてトイレ占領しちまって	A big sailor just busted in here all of a sudden, and took over the restroom.	大水兵占領	scene_16
それっきりずっ～と、うなってるんだ	He's been in there moaning ever since.		scene_16
まいっちゃうよ	I don't know what I'm gonna do.		scene_16
はぁ……あっ、お泊まりなら悪いけど、あの人の分もたのむね	Ah…if you're checking in, would you please pay his bill, too?	泊悪人分	scene_16
やだなあ、やっぱり知り合いじゃないの…うそつき	Come now, we know he's a friend of yours…(fibber)	知合	scene_16
どうすんの？　もう休むかい？	What now? Call it a night?	休	scene_16
一泊２００ギルだよ	200 gil a night.	一泊	scene_16
どうすんだい？もうお休みにするかい？	What now? Call it a night?	休	scene_16
休んでいくか	Stay	休	scene_16
波音に抱かれて……いい夢を	Cradled by the sound of the ocean… sweet dreams…	波音抱夢	scene_16
そうですかい。またおいでくださいね	Are you sure? Please come again.		scene_16
チェッ！！　おしいっ！	Shucks!!  Too bad!		scene_16
あっ！　あんたさ！連れに、かわいい女の子がいるでしょ	Hey! Hey you! Does your friend have a cute lady?	連女子	scene_16
さっき、探しにきてたけど。いいのかい？ほっといても	She came in here looking for him a while ago. You better find her.	探	scene_16
どうすんだい？ほっといて、もう休みます？	What are you going to do? Just forget about her and go to bed?	休	scene_16
気がかわった	Changed my mind	気	scene_16
ほ～う、よゆうだね。では……	You look like you can handle it. Well then…		scene_16
そりゃそうだよね。どうぞ、どうぞ。またあとで、おこしください	That's right. Don't worry. Please come by again.		scene_16
毎度どうも！！どうします？	Welcome!! What's it going to be?	毎度	scene_16
一泊２００ギルになりますけど	200 gil a night.	一泊	scene_16
そうですかい。私、ここで遊んでますから気がむいたら、またおこしください	You sure? I'll just be playing around here so drop by whenever you feel like it.	私遊気	scene_16
はい、おつかれさまでした	You must be tired.		scene_16
コスタデルソル地方の明日の天気はいつもの通り、晴れとなっております	The weather for Costa del Sol tomorrow is going to be…sunny, again.	地方明日天気通晴	scene_16
おはようございます。道中お気をつけて	Good morning. Be careful traveling.	道中気	scene_16
お連れのみなさんは先立たれましたよ	Your party has departed.	連先立	scene_16
あっ……	Oops…		scene_16
これは縁起でもないことを…	That's bad luck…	縁起	scene_16
正しくは…一足先に出発しましたという意味です	I mean, they have already left.	正一足先出発意味	scene_16
おっっと！お金がたりないようですぜ	Wait a minute! There's not enough money here.	金	scene_16
おはようさんっ！！	Good morning!!		scene_16
う～ん！	Uh uh!		scene_16
んんっ～！	Hmmm!?		scene_16
マリ～ン！元気かぁ…？	Marlene! You OK?	元気	scene_16
とうちゃんこれ着て会いにいくからなぁ	I'll wear this when I go to see you.	着会	scene_16
おう！！　CLOUD！まだはやいんじゃねえか！	Yo, CLOUD! Still too early, ain't it?		scene_16
おう！！！いま使用中だっ！	Hey, yo!!! Someone's in here, alright!?	使用中	scene_16
フゥ……。なんだか、つかれちゃったね	Whew… I don't know why I'm so tired.		scene_16
わからないこと、おおくて…	There's so many things I don't understand…		scene_16
ちょっとだけ、不安なんだ	I feel a little uneasy.	不安	scene_16
わたしのこと、どう思ってる？	What do you think of me?	思	scene_16
どうもこうもわからないよ	I don't understand anything.		scene_16
悪いけどそういうこと考えたこともない	Sorry, but I never think about those things.	悪考	scene_16
あたまっ、きちゃうなあ！そんなこといえちゃうわけっ	How could you say such a thing! Sometimes you make me so mad!		scene_16
も～う！相談したわたしがまちがってました	Oh, I never should have brought it up!!	相談	scene_16
…………そうだよね	…You're right.		scene_16
わたしもね、わからないの。自分のこと	Even I don't understand myself.	自分	scene_16
わたし、どのへんが古代種なの？	I wonder what part of me is like an Ancient?	古代種	scene_16
古代種ってどこがどうなるの？	What is an Ancient supposed to be like? It's strange, isn't it?	古代種	scene_16
へんだよね。わからないよ…	I don't understand it…		scene_16
はぁ…　どうどうめぐり。こういうのってこたえ、あるのかなあ。むずかしいよね、いろいろ	Ahh…I'm going around in circles. I wonder if there's any answer to this? Everything's so complicated.		scene_16
さきに休ませてね	I'm going to sleep.	休	scene_16
もういいですよっ！	I don't want to talk about it!		scene_16
お気をつけて！	Be careful!	気	scene_16
もう遊ぶ気も働く気もないです。最後の人生、ねだめですよ、ねだめ	I don't feel like doing anything. I just want to spend the rest of my life sleeping.	遊気働気最後人生	scene_16
では、おやすみなさ～い	Good night.		scene_16
いっしょにねますかい？	Will you be staying together?		scene_16
やめとく	No, thanks		scene_16
せっぱつまった顔なんてやめ！なるようにしかなりません	Stop looking like a hunted animal! Whatever happens…happens.	顔	scene_16
あんまり、無理はしなさなんなって	Just go with it.	無理	scene_16
ジョニーの新居	Johnny's New Home	新居	scene_16
なななななんだ？あななななたは！！	What's with YOU?		scene_16
ああっ、あんたは？もしかしてぇ！	Hey, is it really you?		scene_16
元ソルジャーかつ幼なじみでモテモテの遊び人	We were in SOLDIER, and childhood friends before that. You were such a playboy.	元幼遊人	scene_16
そ、そして……人殺し野郎！！	And a $#&^ murderer!!	人殺野郎	scene_16
えっっと……お名前なんでしたっけ？	Why can't I remember your name?	名前	scene_16
おまえこそ誰だ？	Who are YOU?	誰	scene_16
CLOUDだ、おぼえとけ	I'm CLOUD, and don't forget it		scene_16
そうだよな、ひさしぶりだもんな。俺のことなんか、わすれちゃったか	That's right. Long time no see. Do you remember me?	俺	scene_16
いいぜ、このまま、あんたと俺は関係なし。	That's okay. We'll just pretend like we don't know each other.	俺関係	scene_16
俺はこの街で新しいくらしをはじめた	I started a new life in this town.	俺街新	scene_16
おたがい、いろいろあったよな。や！　もうぐちるのはやめ！いいよな、あんたたちみたいにの～天気に生きられりゃよ	A lot of things happened to us. Heh, I better stop my complaining! I sure envy you all living out under the stars.	天気生	scene_16
どうどうと名乗るくらいのご身分とはね！	You think you're good enough to brag about how big you are?	名乗身分	scene_16
聞いてあきれるぜ！や！　もうぐちるのはやめ！	I don't wanna hear it! Heh, no more complaining from me!	聞	scene_16
おたがい、新しい人生を生きような！	From now on, I'm turning over a new leaf!	新人生生	scene_16
はやく出てってくれよ！	Go on and beat it!	出	scene_16
俺は、これでもハッピーにやってんだ。俺のラブリーなどうせい生活をじゃましないでくれ！	I'm happy like this. So keep out of my life.	俺俺生活	scene_16
お客さん、ごめんなさいね！彼、ここんとこ、ショックなことがおおくてず～っと、ふさぎこんでるのよ～	I'm sorry about that. He's had some big shocks and has been depressed lately.	客彼	scene_16
そうそう！そんなことも、あったね～	Oh, right! I remember that, too.		scene_16
でさ、でさ！そんとき…	Yeah, yeah! And you remember the time when….		scene_16
ウフフフ！	Hee, hee, hee!		scene_16
イヒヒヒ……！	Ha, ha, ha!		scene_16
やだ～！そうなの～	Ha, ha…oh stop it! That's right. Oh really…		scene_16
そうそう。でね……	Yeah. Oh yeah, and then that time…		scene_16
うんうん！	Yeah, yeah!		scene_16
CLOUD……。ごめん、今日はふたりにさせてね！	CLOUD, would you mind leaving us alone for the day?	今日	scene_16
ひさしぶりだしたまには息抜きもね	We haven't seen each other for ages and sometimes it's fun to talk about old times for a change.	息抜	scene_16
そういうことだから……。悪く思うなよ	Yeah, don't get mad or anything.	悪思	scene_16
あんまり遅くならないようにするから	I'll try not to be back too late.	遅	scene_16
ね、心配しないで！	So please don't worry about us!	心配	scene_16
心配なんて…	Worry?	心配	scene_16
ああ…	Yeah…		scene_16
べつに心配なんて	I'm not worried.	心配	scene_16
明日には出発だからな	Just remember we're leaving early tomorrow.	明日出発	scene_16
そうなんだ…	You're right…		scene_16
うん、わかった	OK, I know.		scene_16
ムニャムニャ……（TIFAちゃん絶対、しあわせになんだぞ）	…mumble…mumble… (TIFA, promise me you're gonna be happy.)	絶対	scene_16
エヘヘへ……彼女とはなかよくやってますよ	Heh, heh, heh! She and I are getting along pretty good.	彼女	scene_16
でも、俺みたいな情けねえ野郎じゃね…	But I'm such a pitiful waste…	俺情野郎	scene_16
はあ……俺なんかじゃ、資格がねえよ。どうしたら、いいんだろ	…sigh…I'm not good enough for her. What should I do?	俺資格	scene_16
メテオのどさくさにまぎれて彼女にプロポーズしちゃったよ！	I proposed to her in the middle of all that Meteor stuff!	彼女	scene_16
たとえこのまま世界が終わってもそれはそれ！	I don't care even if the world were to end right now!	世界終	scene_16
いまはなにも考えられません！	I can't think of anything else!	考	scene_16
ダメだダメだダメだ！！メテオがどんどんでかくなってる！！	No, no, NO!! Meteor's getting closer every minute!!		scene_16
俺はいまがむしゃらに生きたい！！彼女といっしょに生きのびて所帯をもつのだ！！	I wanna live my life right now!! I want to build a home and grow old together with her!	俺生彼女生所帯	scene_16
あんたにできなきゃ、俺がやる！！ただそれだけだ！	If you can't do it, then I will! And that's that!	俺	scene_16
俺もがんばるから、あんたもがんばれ！	I'm gonna do my best, so you hang in there too!	俺	scene_16
あっ！CLOUD！！	Oh! CLOUD!!		scene_16
あれ、見て！	Look, look at that!	見	scene_16
あいつは宝条…	Who, Hojo?	宝条	scene_16
水着の女の子か…	That girl in the bikini?	水着女子	scene_16
あの男、宝条か？	Is that man over there, Hojo?	男宝条	scene_16
ね、話つけてきてよ	Go over and talk to him.	話	scene_16
悪くないながめだな…	Not a bad view…	悪	scene_16
もう！！　どこ見てんのよ！	What're you looking at?	見	scene_16
あそこの男、神羅の宝条よ！ふざけてないで話つけてきて！	That man over there. That's Hojo from Shinra. Get outta here Go talk to him!	男神羅宝条話	scene_16
あら！！なにか御用？	God!! What do you want?	御用	scene_16
そこの男に用がある	I want to talk with him	男用	scene_16
そいつは宝条か？	Is that Hojo?	宝条	scene_16
（なによっ、えらそうに）	(Hey, who do you think you are?)		scene_16
ねぇ、宝条博士～。こわい人が、用があるって～	Professor Hojo. That scary man says he wants to talk with you.	宝条博士人用	scene_16
（なんなのこの人）	(What's his problem?)	人	scene_16
そうよぅ～。博士なのよぅ～	Yes, that's right. It's the Professor!	博士	scene_16
博士～お客さんよぅ	Professor… someone's here to see you, sir.	博士客	scene_16
やな予感するね	I have a bad feeling about this.	予感	scene_16
いまいそがしい	I'm busy right now.		scene_16
……だって～。残念でしたぁ～	…But, Too bad.	残念	scene_16
いや、まちたまえ。きみはたしか、私の記憶にある……	No, I remember you all now…	私記憶	scene_16
クックックッ……。わかったよ、騒々しいなきみは	Heh heh heh… All right. You sure are loud.	騒	scene_16
ひさしぶりだなCLOUDくん	Long time no see, CLOUD.		scene_16
ああ、そうそう。思い出しましたよ	Yes, yes. I remember now.	思出	scene_16
宝条……	Hojo…	宝条	scene_16
たまにはこういうのもいいものだね	Sometimes you just gotta do something like this.		scene_16
……何をしている	What are you doing?	何	scene_16
見てのとおりだ。日光浴	It should be obvious, I'm getting a tan.	見日光浴	scene_16
まじめに答えろ！	Answer me!	答	scene_16
ふん……私の目的は君と同じだと思うが	Hmm! I believe we're both after the same goal.	私目的君同思	scene_16
セフィロスか？	You mean Sephiroth?		scene_16
君たちは会えたのか？	Did you see him?	君会	scene_16
そうか……ふむふむ	I see…Ha! Ha!		scene_16
なんだ？	What is it?		scene_16
いや、ちょっとした仮説を思いついたのだが……	Nothing. I just remembered a certain hypothesis…	仮説思	scene_16
君は、何かに呼ばれているという感じがしたことはないかな？	Haven't you ever had the feeling something is calling you?	君何呼感	scene_16
または、どうしてもある場所へ行かなくてはならないという気持ちになるとか……	Or that you had to visit some place?	場所行気持	scene_16
俺はセフィロスがいる場所ならどこへでも行く！	I'll go anywhere Sephiroth is at!	俺場所行	scene_16
あいつを倒すために！決着をつけるためにな！	To beat him and put an end to all this!	倒決着	scene_16
なるほど……これはイケるかもしれないな	I see… This could be interesting.		scene_16
ソルジャーか……クックックッ。ん、私の実験のサンプルにならんか？	Were you in SOLDIER? Heh heh heh! Would you like to be my guinea pig?	私実験	scene_16
ん…なんだ？剣でもぬくか？	Oh, now what? Are you going to draw your sword?	剣	scene_16
CLOUD、だめっ！この人、死んだら何もわからなくなっちゃう！	CLOUD, don't. If he dies, we won't find out anything!	人死何	scene_16
やめて、CLOUD！気持ちはわかるけど、ダメよ	Stop, CLOUD! I know how you feel, but you mustn't.	気持	scene_16
お、おいっ！こいつをやるのはマズイんじゃねえのか？	Yo, yo! It's a bad idea to kill him.		scene_16
ゼェゼェ……やめろ、CLOUD	…huff…puff… Stop, CLOUD!		scene_16
だめだよ、CLOUD！アタシにはわかんないけどこいつ、いろいろ知ってんだろ？	Knock it off, CLOUD! Look I don't know, but he knows a lot of stuff, right?	知	scene_16
おや、ときにきみは……古代種の娘ではないか	Say, aren't you the 'Ancient'? 	古代種娘	scene_16
わたし、AERIS。名前くらい覚えなさいよ	I'm AERIS. The least you can do is remember my name.	名前覚	scene_16
ねえ、宝条博士教えてほしいの	I want you to tell me something, Professor Hojo…	宝条博士教	scene_16
わたし、自分が古代種なのは知ってる。母さんに聞いたから	I know I'm an Ancient. My mother told me.	自分古代種知母聞	scene_16
母さん？ああ、イファルナか。元気にしてるのか？	Your mother? Oh, you mean Ifalna. How is she?	母元気	scene_16
知らないの？死んじゃったよ	You didn't know!? She died.	知死	scene_16
……そうか	…I see.		scene_16
……ねえ、博士	Professor Hojo?	博士	scene_16
ジェノバは古代種なの？セフィロスは古代種なの？わたしと同じ血、流れてるの？	Is Jenova an Ancient? Is Sephiroth an Ancient? Do we all have the same blood?	古代種古代種同血流	scene_16
……ボソボソ………西へ…………………	…mumble…mumble…head west…	西	scene_16
ボソボソ作戦？ってことは、何か隠してる！	He's mumbling slowly… That must mean he's hiding something!	作戦何隠	scene_16
ねぇ！答えなさいよ！！	Hey! Answer us!!	答	scene_16
ガルルル……！！……ゼェハァ……	Grrr, Grrr… …huff…puff…		scene_16
……だめだ。むだだよ	It's no use. It's no go.		scene_16
宝条博士ってやさしいんだよ。わたしを実験してくれるんだって	Professor Hojo is so sweet. He's going to experiment on me.	宝条博士実験	scene_16
この暑さのなか、実験服をぬぐことはない。知的な男のダンディズムよね～	He never takes off his lab coat even in this heat. I guess that's the mark of an intellectual.	暑実験服知的男	scene_16
宝条先生のボソボソを通訳するね	I'll interpret Professor Hojo's whispers.	宝条先生通訳	scene_16
ここから西のコレル山をこえて進んでる……	Head west, past Mt. Corel and keep going…	西山進	scene_16
わかったかしら？わたし、よくわかんな～い	Did you get that? I didn't understand it well, myself.		scene_16
宝条先生だったら、よろこんで実験台になっちゃう！	I'd be happy to be a guinea pig, if it's for Professor Hojo!	宝条先生実験台	scene_16
はあ……宝条先生。いま、いずこ	Yes, Professor Hojo. Where?	宝条先生	scene_16
先生、なにかを発見～解明～したみたいなの	It looks like the Professor discovered or found a solution to something.	先生発見解明	scene_16
で、それっきり……やっぱり、西のコレル山にむかったのかしら	You know, I wonder… if they headed west for Mt. Corel?	西山	scene_16
ちょっとくやしかったな	I'm getting a little sad.		scene_16
宝条先生、なにかを発見したとき子供みたいにうれしそうな顔でクックックッって笑って……	Professor Hojo looks happy like a child when he discovers something. He gets this big smile and then laughs…	宝条先生発見子供顔笑	scene_16
あと、追っかけちゃおうかな。コレル山からゴールドソーサーへふたりのバカンス♥	I guess we should chase after him. A vacation for two from Mt. Corel to Gold Saucer.	追山	scene_16
そうだっ！！わすれてたわ！	That's right!! It totally skipped my mind!		scene_16
な～んか、あなたにつたえなきゃいけないことがあったのよ	There was something I was supposed to tell you.		scene_16
そうよ！あれよ！	That's right! It's about that!		scene_16
きのうのことなんだけど海から黒マントの男があがってきたの。ザバザバってさあ	It was yesterday. A man wearing a black cape came up from the ocean.	海黒男	scene_16
ゴールドソーサーのチケットもってたような気がしたけど……そんなわけないよね。あれって、まぼろしかなあ	I think he had tickets for the Gold Saucer… no, that wasn't it… I wonder if it was all just an illusion?	気	scene_16
ねえ、ねえ？きのう、ルーファウス来たんでしょ	Hey! President Rufus came here yesterday.	来	scene_16
彼、昔はプレジデントのボンボンで～。ついたあだなが、プレジデントボンボン！	He used to be the President's little boy. We nicknamed him the little Prez!	彼昔	scene_16
そこで遊んでるサーファーたちとたいして変わらなかったのよ	He didn't look much different than the surfers on the beach.	遊変	scene_16
へへ……ぜんぶ、とられちゃったよ	heh heh… All the good ones are gone.		scene_16
いまきた子でがまんすっか？	What about that one? Shall we make do with her?	子	scene_16
でも、彼がいっしょじゃん	But she's got a guy with her.	彼	scene_16
あんくらいならだいじょぶだいじょぶ	No problem, I can handle him.		scene_16
ねぇ？　そだろ！	Right? You thought so, too?		scene_16
ウヒ……あの二人組にするか？	Geez! What about those two?	二人組	scene_16
へへ……おれ、左の子がいい！	Heh heh…I want the one on the left.	左子	scene_16
じゃ、おれ右でがまんするよ	Well then, I guess that leaves me with the one on the right.	右	scene_16
ねぇねぇ……ヘヘ……ちょっとは俺とも話してよ	Hey… heh heh…don't forget to talk to me, too.	俺話	scene_16
うひゃ～！！たちけて～！！	Yipes!! Help!!		scene_16
ハァッハァッ……！いきつぎわすれちゃうだろ～！！	…breath…breath! Kind of takes your breath away, don't it!?		scene_16
きみたち、コレル山へ向かうなら『金の針』を買っていくほうがいいよ	If you're headed for Mt. Corel, then you'd better buy some "Soft".	山向金針買	scene_16
よくいうでしょう？	At least that's what they always say, don't they?		scene_16
そなえあればうれいなし。とらぬたぬきのかわざんようってばボクってインテリ！	Be prepared, and you'll never fear.		scene_16
う～ん、調子でません。これも神羅の男たちのせいさ	Hey, I'm no idiot. I NEVER count my chickens before they hatch! Not bad, huh?	調子神羅男	scene_16
うらむよなあ、神羅カンパニー！悪者だよな、神羅	Hmm. Man, I'm draggin' today. It's all Shinra's fault.	神羅悪者神羅	scene_16
へヘ……でも、これってひがみってやつだなあ。さわやかじゃないなあ	I really hate Shinra, Inc.! They're all crooked, those Shinra.		scene_16
うひゃ！！話しかけないで～！	Hmm… What a bitter guy Chill out a bit.	話	scene_16
ウップ！　ブクブク………しずんじゃうよ～	Eeeew!! Leave me alone!		scene_16
いつものことだが本日もあいてにされないのであった	Ublk! …glug…glug… You're gonna make me drown!	本日	scene_16
ナンパならおことわりよ。まにあってますから	Always the same story… Women never pay any attention to me…		scene_16
海の風と太陽。自然っていいわね～。いきかえるわ～	If this is your idea of flirting…forget it. I do fine as it is.	海風太陽自然	scene_16
あら？　ちょうどいいところに	The sea, the wind and the sun. Don't you just love the outdoors? It always puts me back on track.		scene_16
オイルぬっていただけますか？	Hey, good timing. Would you mind putting lotion on me?		scene_16
よろこんで	With pleasure		scene_16
おことわりだ	Sorry		scene_16
あ～ん♥	Uhhhnn…		scene_16
ありがと♥	Than--kyu!		scene_16
あら、おかたいのね	Hey, loosen up a bit.		scene_16
世界の終わりまでに上手におよげるようにがんばってんだから～	I'm trying to learn how to swim before the end of the world.	世界終上手	scene_16
メテオはねてまてか……なんだってあんなもんがふってくんだろ	Sitting around waiting for Meteor to come…… Why's it gotta fall on us?		scene_16
だんだん近づいてきてるの。だれか、なんとかしてくれるのよね	It's getting closer and closer. Someone will do something, don't you think?	近	scene_16
海の風と太陽とメテオ。自然って不思議よね～	The sea breeze, sun and Meteor. Isn't nature strange?	海風太陽自然不思議	scene_16
世界の終わりでもおいしいカクテルを飲みながらゆるりゆるゆるとすごしたいわ～！	I don't care even if it is the end of the world, I just want to sit here and drink cocktails!	世界終飲	scene_16
ウェッ……の・み・す・ぎ	Ooooh…I think I drank too much.		scene_16