……私を悪夢から呼び起こすのは	…To wake me from the nightmare	私悪夢呼起	scene_22
だれだッ！	Who is it!?		scene_22
……見知らぬ顔か。出ていってもらおうか	…I don't know you. You must leave.	見知顔出	scene_22
ずいぶんうなされていたようだな	You were having a nightmare.		scene_22
ずいぶんうなされていたようね	You were having a nightmare.		scene_22
ずいぶんうなされてたぜ	You were having a nightmare.		scene_22
起こしてやったんだ。感謝されたいぜ	I woke ya up. Ya outta be thankin' me.	起感謝	scene_22
目、さめて良かったなぁ	Aren't you glad you woke up?	目良	scene_22
こんなとこで眠れば夢だって暗～くなるよ	You'll dream about bad things if you sleep in a place like THIS.	眠夢暗	scene_22
どんなひどい夢を見てたの？	How bad was your dream?	夢見	scene_22
……顔色、悪いよ	…You don't look good.	顔色悪	scene_22
ホント、すごいうなされかた！こっちまで気持ち悪くなっちゃうよ	Man, you really WERE having a bad dream! Even I feel bad!	気持悪	scene_22
空気がドヨヨーンとしてるぜ	The air's pretty heavy here.	空気	scene_22
こんなところでよく眠れるな	How can you sleep in a place like this?	眠	scene_22
フッ……悪夢にうなされる長き眠りこそ私に与えられたつぐないの時間	Hmph…a nightmare? My long sleep has given me time to atone.	悪夢長眠私与時間	scene_22
何を言ってるんだ？	What are you saying?	何言	scene_22
何を言ってるの？　この人……	What's he talking about?	何言人	scene_22
何言ってんだぁ？	What the hell are you saying?	何言	scene_22
他人に話すようなことではない。ここから出ていけ	I have nothing to say to strangers. Get out.	他人話出	scene_22
この屋敷は悪夢の始まりの場所だ	This mansion is the beginning of your nightmare.	屋敷悪夢始場所	scene_22
……確かに、そうだな	…You can say that again.	確	scene_22
……確かに、そうね	…That's for sure.	確	scene_22
……確かに、その通りらしいな！	…It's startin' to look that way!	確通	scene_22
おや？　何を知っているのだ？	Hmm? Do you know something?	何知	scene_22
何も言わない	Don't say a thing	何言	scene_22
セフィロスのことを話す	Talk about Sephiroth	話	scene_22
他人に話すようなことじゃない	Nothing I'd tell a stranger.	他人話	scene_22
他人に話すようなことじゃないわ	Nothing I feel like telling a stranger about.	他人話	scene_22
他人に話すようなことじゃねえ	Nothin' I'd tell a stranger.	他人話	scene_22
またか……何か聞きたいことがあるのか？	Again… Do you know anything?	何聞	scene_22
何もない	Nothing	何	scene_22
なるほど。ならば私は悪夢へもどろう。では……	I see. Then, I'll return to my nightmare…	私悪夢	scene_22
……まだ何か？	…Do you have something to tell me?	何	scene_22
いや、おやすみ	No, good night		scene_22
……ふむ	…Hmm.		scene_22
あんたが言ったとおりこの屋敷が悪夢の始まり	Like you said, this mansion is the beginning of a nightmare.	言屋敷悪夢始	scene_22
あなたが言ったとおりこの屋敷が悪夢の始まり……	Just like you said, this mansion is the start of a nightmare…	言屋敷悪夢始	scene_22
あんたが言ったとおりこの屋敷が悪夢の始まりらしいな	It's like you said, this mansion's the beginning of a nightmare.	言屋敷悪夢始	scene_22
いや、夢ではなく現実だな	No, it's not a dream, it's for real.	夢現実	scene_22
いえ、夢じゃない……現実よ	No, not a dream…it's reality.	夢現実	scene_22
うんや、夢ではなく現実だな	No, it's not a dream, it's the truth.	夢現実	scene_22
セフィロスが正気を失った。この屋敷に隠された秘密がセフィロスを……	Sephiroth has lost his mind. He found the secrets hidden in this mansion…	正気失屋敷隠秘密	scene_22
セフィロスが正気を失った。この屋敷に隠された秘密がセフィロスを……だぜ	Sephiroth's gone nuts. He found a ton of secrets hidden in this mansion…	正気失屋敷隠秘密	scene_22
セフィロスだと！？	Sephiroth!?		scene_22
セフィロスを知っているのか？	You know Sephiroth?	知	scene_22
セフィロスを知っているの？	You know Sephiroth?	知	scene_22
君から話したまえ	You start first.	君話	scene_22
……というわけだ	…That's how it was.		scene_22
……というわけよ	…That's how it was.		scene_22
セフィロスは５年前に自分の出生の秘密を知ったのだな？ジェノバ・プロジェクトのことを？	So Sephiroth knows he was created five years ago? And about the Jenova Project?	年前自分出生秘密知	scene_22
……以来、行方不明だったが最近姿を現した	…He was missing, but has just recently reappeared.	以来行方不明最近姿現	scene_22
多くの人々の命をうばいながら約束の地をさがしている、と	He has taken many lives and is seeking the Promised Land.	多人命約束地	scene_22
今度はあんたの話だ	Now it's your turn.	今度話	scene_22
今度はあなたのばんよ	Now it's your turn.	今度	scene_22
今度はおめえの話だ	Now it's your turn.	今度話	scene_22
悪いが……話せない	Sorry…I cannot speak.	悪話	scene_22
おい！　そりゃないぜ！	Hey! You lyin' white-faced…		scene_22
そら、あかんわ～	Hey, that's not right---		scene_22
ひっど～い！	That's dirty!		scene_22
あ……がっかり	Hmm…I'm disappointed.		scene_22
え……本気ィ？	What…you're serious?	本気	scene_22
あ、いいよそれでも。どうせ暗～い話なんでしょ	Oh, that's okay. It was probably depressing anyway.	暗話	scene_22
おう！　長い話ならゴメンだぜ。さっさとこっから出ようや	Good! I'm not in the mood to hear long stories. Let's get the hell outta here!	長話出	scene_22
君たちの話を聞いたことで私の罪はまたひとつ増えてしまった	Hearing your stories, is yet another sin for me.	君話聞私罪増	scene_22
これまで以上の悪夢が私を迎えてくれるだろう	More nightmares shall come to me now, than I previously had.	以上悪夢私迎	scene_22
さあ……行ってくれ	Now…please leave.	行	scene_22
……まだいたのか	…You're still here.		scene_22
あんた、何者だ？	Who are you?	何者	scene_22
名前くらい教えろ	At least tell us your name.	名前教	scene_22
名前くらい教えなさい	At least tell us your name.	名前教	scene_22
私は……元神羅製作所総務部調査課通称タークスの……	I was with…Shinra Manufacturing in Administrative Research, also known as--the Turks.	私元神羅製作所総務部調査課通称	scene_22
VINCENTだ	VINCENT.		scene_22
タークス！？	The Turks!?		scene_22
元タークスだ	Formerly of the Turks.	元	scene_22
今は神羅とは関係ない	I have no affiliation with Shinra now.	今神羅関係	scene_22
……ところで君は？	…And you?	君	scene_22
元ソルジャーのCLOUDだ	CLOUD, formerly of SOLDIER.	元	scene_22
元神羅兵のCLOUDだ	Former SOLDIER, CLOUD.	元神羅兵	scene_22
元アバランチのTIFAよ	TIFA, formerly of the AVALANCHE.	元	scene_22
元神羅宇宙開発部のCIDだ	CID, formerly of the Space Program Department.	元神羅宇宙開発部	scene_22
君も元神羅か……ではルクレツィアを知っているか？	You were also with Shinra…? Then do you know Lucrecia?	君元神羅知	scene_22
元アバランチか……ではルクレツィアの事は知るまい……	Ex-AVALANCHE… Then you wouldn't know Lucrecia…	元事知	scene_22
誰だって？	Who?	誰	scene_22
誰？	Who?	誰	scene_22
…………ルクレツィア	…Lucrecia.		scene_22
知らないわ	No.	知	scene_22
知らねえな	No idea.	知	scene_22
セフィロスをうんだ女性だ	The woman who gave birth to Sephiroth.	女性	scene_22
うんだ？	…gave birth…?		scene_22
セフィロスの母親はジェノバではないのか？	Wasn't Jenova Sephiroth's mother?	母親	scene_22
セフィロスの母親はジェノバじゃないの？	Isn't Jenova Sephiroth's mother?	母親	scene_22
セフィロスの母親はジェノバじゃねえのか？	Isn't Jenova Sephiroth's mother?	母親	scene_22
それは……間違いではないがひとつのたとえなのだ	That isn't completely wrong, but just a theory.	間違	scene_22
実際には美しい女性から生まれた	He was born from a beautiful lady.	実際美女性生	scene_22
その女性がルクレツィア	That lady was Lucrecia.	女性	scene_22
ジェノバ・プロジェクトチームの責任者ガスト博士の助手。美しい……ルクレツィア	She was an assistant to Professor Gast of the Jenova Project. Beautiful…Lucrecia.	責任者博士助手美	scene_22
…………人体実験？	…A human experiment?	人体実験	scene_22
実験を中止させることができなかった	There was no way to cancel the experiment.	実験中止	scene_22
彼女に思いとどまらせることができなかった	I couldn't stop her.	彼女思	scene_22
それが私が犯した罪だ	That was my sin.	私犯罪	scene_22
愛する、いや、そんけいする女性を恐ろしいめにあわせてしまった	I let the one I loved, the one I respected most, face the worst.	愛女性恐	scene_22
そのつぐないが眠ることだぁ？笑わせるんじゃねえよ！	So you started sleepin' in a box? Gimme a break!	眠笑	scene_22
そのつぐないが眠ること？それって……なんかへん	So your punishment was to sleep? That's…strange.	眠	scene_22
そのつぐないが眠ること？何かへんよね	So the punishment was sleep? That's weird.	眠何	scene_22
ねむることでそれをつぐなうって？何か変じゃないのか？　その考え……	So you slept as punishment? Isn't that rather strange logic?	何変考	scene_22
だからってねるこたァねえだろ？　ねるこたァよ、ええ？	You shouldn't sleep just because of that. Sleep?		scene_22
そんなんでつぐないのつもりかいな？ねとるだけやないか	You think that's punishing yourself? You're just sleeping.		scene_22
やっぱ、つま～んない話	OK. Boring story no.1.	話	scene_22
眠らせてくれ……	Let me sleep…	眠	scene_22
まて！	Wait!		scene_22
おまえたちについていけば宝条に会えるのか？	If I go with you, will I meet Hojo?	宝条会	scene_22
おまえたちについていけばセフィロスに会えるのか？	If I go with you, will I meet Hojo?	会	scene_22
さあな。でもヤツもセフィロスを追っているとなれば、いずれは……	Dunno. But we're after him and Sephiroth. So, I guess sooner or later…	追	scene_22
さあ、どうかしら。でも宝条もセフィロスを追っているわ。だから、いつかは出くわすことに……	Hmm, I don't know. But we're going after Hojo and Sephiroth. So, we might……	宝条追出	scene_22
ああ。きっとな……	Yeah, probably…		scene_22
ええ。たぶん……	Yes, probably…		scene_22
おお。たぶんな……	Yeah, probably…		scene_22
ルクレツィア……	Lucrecia…		scene_22
よし、わかった。おまえたちについていくことにしよう	All right. I've decided to go with you.		scene_22
な、なんだ？	W, what?		scene_22
は？　つ…ついていくって	What? You're coming with us?		scene_22
何？	What?	何	scene_22
ずいぶん急な心がわり、ね？	That sure was a quick change of heart.	急心	scene_22
どないやねん	What?		scene_22
オイオイ、強引だぜ！	Hey, hold on sleepy. You're pretty damn pushy!	強引	scene_22
はぁ？　変なやつ……	Huh? Oh great just what I needed…	変	scene_22
元タークスと言うことで何かと力にもなれると思うが……	Being a former Turk, I may be of help…	元言何力思	scene_22
よし、いいだろう	All right, then.		scene_22
ええ、わかったわいいわよ	All right, I understand.		scene_22