海流の村　ミディール	Mideel	海流村	scene_33
ほい。こんにちわ、ぺっぴんさん。ここは、ミディール。のどかな温泉村じゃよ	Ahoy! Hey ain't you a beaut. This here's Mideel. It's a quiet little Hot Springs town.	温泉村	scene_33
わしらのような年寄りがのんびりくらすにはうってつけの場所じゃて	Just the perfect place for old folks like us to live out our lives.	年寄場所	scene_33
どうも外では、なにやら大変なことになっとるらしいがまだここは静かなもんじゃよ	I hear that things ain't so peaceful on the outside. But here it's still nice and quiet.	外大変静	scene_33
ほい、ここはミディール。のどかな温泉村……と言いたいところじゃが……	Ahoy! This here's Mideel. A quiet Hot Springs town… At least it used to be…	温泉村言	scene_33
最近どうも海がさわがしいんじゃ。またライフストロンガーちゅうのが海底であばれとるんじゃろうて	Lately the sea's been in a tizzy. Lifestream has been mixin' things up at the bottom of the ocean.	最近海底	scene_33
星も怒っとるのかもしれんのう。いままでわしらは、この星にやりたいほうだいじゃったからなあ	I think the Planet's pretty angry, too. We've pretty much done whatever we've wanted to the Planet up till now.	星怒	scene_33
おや、見なれない顔だね。外からきたのかい？どうだい、むこうのようすは？	Huh? Never seen you here before. You from outta town? How're things on the outside?	見顔外	scene_33
地震だの、メテオだの……この世の終わりがくるってのはほんとなのかねえ	Between the earthquakes and Meteor… It just might be the end of the world like everyone's been sayin'…	地震世終	scene_33
ああ、しんきくさい！イヤな世の中だよまったく……	Oh, how depressing! What a miserable world this is…	世中	scene_33
地震やメテオで大変だってのにその上ライフストリームまで活発になってきたっていうじゃない	It's bad enough with earthquakes and Meteor, but on top of all that now the Lifestream has become active again, too.	地震大変上活発	scene_33
またドカーンとあふれたりして大騒ぎにならなきゃいいけどねえ。シャレになんないよ、まったく	I hope it doesn't blow and cause a panic like it did before. That was really bad, I tell ya.	大騒	scene_33
ねぇ、ちょっとあなた……いいこと教えてあげましょうか。見てしまったのよ、わたくし	Everything must come to an end. And someday it's gonna be your turn. The world's gotta end sometime.	教見	scene_33
あのドケチ女の、子チョコボがはねの下に、緑色のきれいな石をしまいこむのを……	Everybody goes sometime or another. And everyone gets left too. It's just fate…	女子下緑色石	scene_33
ええ、あれはまちがいなくすごい宝石かなにかですわよ！チョコボには、もったいないわ	It's sad, but there's nothing that can be done about it. So that's why I'm prayin' for all of you.	宝石	scene_33
まあ、あの子チョコボから緑の石をもらったのね！うらやましい	That kid got a green stone from that Chocobo! I'm so jealous.	子緑石	scene_33
どうしたの、おまえ？ひとりぽっちなの？	What's the matter? Are you all alone?		scene_33
見失っちゃったのね大切なだれかを……？バカだね……	You got lost didn't you? Separated from someone you love? Silly thing…	見失大切	scene_33
……もう一週間にもなるかの海岸にうちあげられた……あの、ツンツン頭の若いの……	I guess it's been about a week now since he washed up here on the shore… Poor pokey-headed young thing…	一週間海岸頭若	scene_33
ああ、ムゴイこっちゃが……でも、ありゃどうも変だで……どでかい長剣、にぎりしめて……	It was really sad…but weird. He was holding this really long sword.	変長剣	scene_33
なんや不吉な気がするんや。なんちゅうても、ほれ……あの、ふしぎな青い目……	I dunno. The whole thing feels unlucky to me. But the amazing thing was those weird blue eyes…	不吉気青目	scene_33
えッ！？	Wha!?		scene_33
ちょ……ちょっと待ってください！！いま、なんて！？	Wh…wait a minute!! What did you just say!?	待	scene_33
すみません！いまの話の若い人って……もしかして……	Excuse me! That person you were just talking about…	話若人	scene_33
ああ……この先の海岸で村の者が見つけたんじゃよ……。もう一週間ほど前のことじゃ	Yeah…a villager found him a little ways down the coast… It was about a week ago I think.	先海岸村者見一週間前	scene_33
うん、かわいそうに……。ありゃ、かなり遠くから流されて来たんやで……	Poor kid… He must've drifted from somewhere pretty far away.	遠流来	scene_33
CLOUDよ！！まちがいない！！CLOUDだわ！！	CLOUD!! It must be!! It's CLOUD!!		scene_33
ほんとか！？	You sure!?		scene_33
あ……！？おい、TIFA！！	Uh…!? Yo, TIFA!!		scene_33
やっぱり、ここに！	Over here!		scene_33
待って！	Halt!	待	scene_33
へっ、やったな、TIFA	Heh, good job, TIFA.		scene_33
ビンゴね！！	BINGO!!		scene_33
あん、ちょっとお！	Oh, HEY!		scene_33
よっしゃ、大当たりや！	Jackpot!	大当	scene_33
ちょっと待って～や！	Wait up!	待	scene_33
うむ、見つけたな	You've found him.	見	scene_33
それで、その人は！？無事なんですか！？いま、どこに……！？	So where is he? Is he safe!? Where is he now?	人無事	scene_33
ああ……この先の……ほれ、その治療所に……	Yeah…up ahead here… At the, uh, clinic…	先治療所	scene_33
生きてる……！	He's alive!	生	scene_33
CLOUDが……CLOUDが生きてる！！	CLOUD… CLOUD's alive!!	生	scene_33
CLOUD……！！	CLOUD!!		scene_33
どうじゃ、兄ちゃんのぐあいは？かわいそうにのう。よほどつらいめにおうたんじゃろうなあ……	So how is the boy? Poor kid. He sure got the worst of whatever it was…	兄	scene_33
はやくようなると、ええのう。こんな時だからこそ、さいごまであきらめずになあ	Sure hope he gets better soon. Right now is when he really needs to hold on and not give up.	時	scene_33
しかし、よう助かったもんじゃ。はこびこまれてきたのを見たときはこりゃあかんと思うたのに	It's amazing he recovered. When they carried him here after they first discovered him, I thought for sure he was a goner.	助見思	scene_33
きっとあの兄ちゃんにはごっつう強い守り神はんがついとってくだはるんちゃうか	That boy must have one powerful guardian angel watchin' over him.	兄強守神	scene_33
あれれ……？なにかしら、これ？	Huh? What could that be?		scene_33
なにか、カギみたいなものが奥にはさまってるけれど……。ちょっと取りづらいわね	There's something stuck deep inside that looks like a key… It's hard to get out.	奥取	scene_33
まあ、とりあえずいいか、別に……	Well, I'll just let it go for now…	別	scene_33
あれれ……なにかしら？古いカギみたいなものがおくにはさまってるわ	There's something stuck deep inside that looks like an old key…	古	scene_33
おう……？なんだあ、これ？	Huh? The hell's this?		scene_33
なんか、カギみたいなもんが奥にはさまってやがるがちょっと取りづれえな	Looks like a key but it's stuck way down inside, and I can't get it out.	奥取	scene_33
まあ、かまわねえかこんなもん……	Well, what the hell? That's life…		scene_33
おう……なんだあ？カギみたいなもんがおくにはさまってやがるな	Hey…what's that? Looks like a key but it's stuck way down inside and		scene_33
よし、なんとかして……取れないかしら、これ	I wonder if there's some way to get this outta here.	取	scene_33
ここを、こうずらして……。そっちを、こう押して……。オッケー！　はずれたわ！	If I just move this… And push that… Okay! I got it out!	押	scene_33
おうし、なんとか……取ってやるぜ、こいつ	Okay, there's gotta be a way to get it out.	取	scene_33
ここを、こうずらして……。そっちを、こう押してだな……。おっしゃ！　はずれたぜ！	Maybe if I move this a bit… and push that over… HAH! Gotcha!	押	scene_33
『ぜったいに、まったく、何の役にもたちそうにない、ボロボロのカギ』をひろった！！	Received "Beat-up Useless Old Key"!	何役	scene_33
さあ、さあ、出血大サービス！！ほかじゃぜったい手に入らない最高の武器や防具がせいぞろい。はやい者勝ちだよ、チクショー！	Gather 'round, gather 'round, this is a bargain!! We've got the best armor and weapons, the likes of which you won't find anywhere else. But it's first come, first served, so get yours now!	出血大手入最高武器防具者勝	scene_33
さ、お客さんもそんなとこでつったってないでなかへどうぞ！　どうぞ！えんりょなんか、いらないから	Step right up! You there, don't just stand around outside. Go on in! Come on! Don't be shy, step right up!	客	scene_33
しかし、なんだってまたこんなのんきな村なんかに店を出そうと思いついたんだろうねうちの人は……？　はあ……	I'll never know why he wanted to open a store in a dead town like this. What's with him? …sigh…	村店出思人	scene_33
な、なんだ、こりゃあ……！？	What's this?		scene_33
地下のライフストリームが地表に吹き出すってえのか！？	The Lifestream is gushing up from below the surface of the earth!	地下表吹出	scene_33
おい、ありゃあ……！？やべえぞ、こりゃ……！！	Damn, that's… This is bad!!		scene_33
CID……！？どうしたの！？	CID!? What's wrong?		scene_33
な、なんでもねえ！！CLOUDと一練に、なかにいろ！！	N, nothin'!! You and CLOUD get inside quick!!	一練	scene_33
でも……！？	But I…		scene_33
ヘッ、心配すんねえ。このオレ様が、そう簡単にくたばってたまるかってんだ	Hey, don't worry about a thing. I ain't about to die that easily.	心配様簡単	scene_33
気をつけて……！	Be careful!	気	scene_33
ようし、行くぜ！めにもの見せてやらあ！！	Okay, here I go! Watch this!!	行見	scene_33
ミディール　民家	Mideel Residence	民家	scene_33
いつ何時、空から大きな星が降ってくるかわからないんだって？ほんとに、ほんとの話なのかい？	You say you don't know when the stars are gonna fall from the sky? Is that for real?	何時空大星降話	scene_33
わたしには、まだ信じられないよ。なんでこんなことになってしまったのかしらねえ？	I still don't believe it! How could this happen?	信	scene_33
古代ウェポン？　世界の終末？そんなもん、知ったことか！わしは、百まで生きるのじゃ	Ancient Weapon? End of the world? Malarky! I'm gonna live to be a hundred!	古代世界終末知百生	scene_33
やり残したことがやまほどあるんじゃぞ。まだまだ、これからじゃい	There's still tons of stuff I gotta do! This's just the beginning.	残	scene_33
そもそも神羅やソルジャー軍はなにやっちょるのだ？　ああ？ぶったるんどるわい！！	And what have Shinra and SOLDIER done about it? Tell me! They're useless!!	神羅軍	scene_33
あたしゃ美人のメイドだけどねないしょくで、アクセサリーの売り買いもしてるのさ	Actually, I'm a beautiful maid. I only work in this accessory store part-time.	美人売買	scene_33
どこ出したってはずかしくない極上の品ばっかだよ。どうだい、ひとつ？	Our goods compare with the best goods anywhere. So, how about one?	出極上品	scene_33
どうも、ありがとさん。また、よっておくれよ	Thank you. Stop by again.		scene_33
なにやらよくないことがおこっとるというじゃないか？だいじょうぶなのかのう	I gotta feelin' something bad's gonna happen. Is everything gonna be okay?		scene_33
わしは、いいんじゃ。もうじゅうぶん長く生きさせてもろうたからね	I'm all right. I've lived a long, full life.	長生	scene_33
ただ、遠くの町でくらしとる息子ふうふや孫たちのことが気がかりでなあ……	But I'm worried about my son and his family living in that far-off town…	遠町息子孫気	scene_33
ちゃんと無事でいてくれたらええんじゃが……	I hope they're safe…	無事	scene_33
CIDたちは、エリクサーを手にいれた！	Received "Elixir"!	手	scene_33
ちょいと待ちなさい	Wait a minute.	待	scene_33
おまえさんたち、なんか取らんかったかね？	Did you just take something?	取	scene_33
お、おう。そりゃ……	Uh, oh. I'm…		scene_33
取ったぜ、おやじ！	Yeah, I took it, old man!	取	scene_33
知らん、まったく知らん！	I know nothin' about it!	知	scene_33
ありゃ、このCID様がいただいた！バッチリ有効につかわせてもらうぜ	Hey, it's mine now! An' I'll make good use of it, believe-you-me!	様有効	scene_33
ほっほっ、変わったお人じゃな。気に入ったわい。そいつは好きに使うとええじゃろ	Heh, heh. What an oddball. We'll let him use it.	変人気入好使	scene_33
すまねえな。助かるぜ、じーさん	Hey thanks. It'll help, pops!	助	scene_33
さ、さあ……？おりゃ、なにも知らねえぞ	Wh, wh-huh…? I don't know nuthin' about that.	知	scene_33
なに、古くなってくさっちまったエリクサーを、すてようと思ってそこいらに出しといたんじゃが	What the hell happened to that rotten old elixir I was gonna throw out?	古思出	scene_33
まちがってあんなもの飲んだら腹をこわすくらいじゃすまされんからのう……	If someone took that by mistake it'll do more than make them sick…	飲腹	scene_33
いや、知らんのならいいんじゃよ。知らんのなら	Well, if you don't know then I guess you don't know.	知	scene_33
…………うそ……	…		scene_33
ミディール　武器屋	Mideel Weapon Store	武器屋	scene_33
なんでももうすぐあの巨大なお月さんが降ってくるっていうじゃない？	So that overgrown moon's gonna fall on us, huh?	巨大月降	scene_33
じょうだんじゃないわ！とりあえず必要なものは買いだめしとかなくっちゃ！	This's no joke! We've got to start stocking up on supplies before they're all gone!	必要買	scene_33
ジャマよ、あんたたち。ほら、どいた、どいた！	Outta the way! Hey, move it, move it!		scene_33
あら、また会ったわね！まさか、あんたたちも買いだめしてるっての！？	You again! You aren't hoarding up goods too, are you?	会買	scene_33
横取りなんかしないでよ！このお店にあるのは、みんなわたしのなんだから！	Don't reach in front of me! Everything in this store is mine!	横取店	scene_33
お金なら、山ほどあるわよ！こんな日もあろうかと必死でためこんだんだもの！	I've got money to burn! I've been saving like mad just for a time like this!	金山日必死	scene_33
ああ……、時間が足りないわ！！いつ、あの月が降ってくるかも知れないってのに！！	Oh…not much time left!! You never know when that moon's gonna come crashing down!!	時間足月降知	scene_33
けっきょく世の中、お金と物よ！それさえあれば、いつだってどこでだって、やってける！	When it all comes down to it, this world's about money and material things! If you got 'em, you can get by whenever, wherever!	世中金物	scene_33
買わなくちゃ！！とにかく、買って、買って買いまくるのよ！！	Gotta buy!! Gotta buy, buy, buy!! I'm gonna shop till I drop!!	買	scene_33
いらっしゃい！愛と勇気の、博愛ショップ！今日は、どんなごようですか？	Welcome to the charity store, a store of love and courage! What can I get you today?	愛勇気博今日	scene_33
ありがとうございました！また、どうぞ	Thank you very much! Please come again.		scene_33
いらっしゃい！愛と勇気の、博愛ショップ！と、行きたいとこなんですが……	Welcome to the charity store, a store of love and courage! Unfortunately, regarding the place you'd like to go…	愛勇気博行	scene_33
そこのお客さんがみんな予約しちまったんで……なにも残ってないんですよ	The other customers have booked it all up… I'm afraid nothing's left.	客予約残	scene_33
……というのは、じょうだんです。アハハハハ！さて、それじゃ、どんなごようです？	…just kidding! Ha, hah, hah! Now how can I help you?		scene_33
ダメだわ……。カギが、かかってるのかしら	No good… I wonder if it's locked?		scene_33
ダメだな……。カギが、かかってやがるのか？	No good… Someone must've locked it.		scene_33
へえ……、でもほんとよくかけてるよねえ、これ	Hmm…you really locked this one up good.		scene_33
けっ、まぎらわしいものつくりやがってよ	Damn, why the hell did they make something tricky like this?		scene_33
……。折れたカギが中につまって取れないよ、これ……	…The key broke off inside, and I can't get to it…	折中取	scene_33
………。わ、私……知ーらないっと	… I don't know anything about it.	私知	scene_33
……。折れたカギが中につまって取れねーぞ、こりゃ……	…The key broke off inside, and I can't get to it…	折中取	scene_33
………。し、知らねえかんな、おれは……	… I don't know a thing about it…	知	scene_33
そうだ、あのボロボロのカギ……ためしてみようかな？	Oh yeah, shall I try that old beat up key?		scene_33
ははあん、ここは一発……あのボロカギをためしてみっか！	Hey, I know what'll do it… Let's try that beat up old key!	一発	scene_33
ボロボロのカギを使う！	Use the beat up old key!	使	scene_33
やっぱり、使わない	Forget it	使	scene_33
やっばり、やめとこ。どうも、これじゃ合いそうにないし	I'd better not. It doesn't look like it fits.	合	scene_33
やっぱ、やめとくか……。どうも、こいつじゃ合いそうにないしな	Naw, forget it… It doesn't even look like it fits.	合	scene_33
よし、これこれ	Okay, this is it.		scene_33
おう、これこれ	Yeah, this is it.		scene_33
ん……。あれ……？きついな、これ……	Hmm…Huh? This is pretty tight…		scene_33
うん？　ありゃ……？まわらねえな……	Huh? Wha? Won't turn…		scene_33
キャッ……！？	Eyaaah!?		scene_33
おおっと……！？	Wha?		scene_33
あちゃー、いっけない！折れちゃった……。とれないよ、これ……	Oh no! …it broke. Now I can't get it out…	折	scene_33
ちい、やべえ。折れちまったよ……。とれねーぞ、これ……	Hoo, *&%$^% Busted it… Can't get the damn thing out…	折	scene_33
どうかしましたか……お客さん？	Is something wrong?	客	scene_33
ギクギクッ！？	Ulp!?		scene_33
ギクッ！！	Ulp!!		scene_33
え？　いえ、その……	Huh? Uh, no…		scene_33
ど、どうしよう……？	What am I gonna do?		scene_33
ごまかしちゃおうか！	Lie your butt off!		scene_33
正直にあやまろう！	Tell them the truth!	正直	scene_33
おう、その、なんだ……	Oh, uh, no, uh I…		scene_33
やべえな、こりゃ……	Damn, this's bad…		scene_33
ええい、ごまかしちめえ！	What the hell…lie!		scene_33
正直にあやまっちめえ！	Just apologize and get it over with!	正直	scene_33
な、なんでもないんです！ただ、ステキなドアだなあって	Nothing! I was just thinking how nice that door was, that's all.		scene_33
な、なんでもねえぜ。ハハッ。いや、いかしたドアだな、これ	Er, nothin'. Hah, hah. That's one nice door you got there, y'know.		scene_33
アハハッ、そうですか？それは、どうも	Oh…why, thank you very much.		scene_33
ホッ……助かった。でも、ちょっと、あとあじわるいな……	Whew…that was close. But I feel bad…	助	scene_33
ひゅう……、助かったぜ。だが、ちょいとばっかし気がひけるな……	Phew…that was a close one. But I kinda feel a little bad about it.	助気	scene_33
ご……、ごめんなさい！むりやりカギをまわしたらこわれちゃいました！	I'm…sorry! I forced the key and it broke!		scene_33
むむ……、すまねえ！むりやりカギをまわしたら折れちまいやがった	Mmm…sorry! I twisted the ^%$#^ and it broke.	折	scene_33
え？カギって、そのドアの……？	Huh? Key? You mean the one to that door?		scene_33
アハハハ！そいつはいいや！	Hah, hah, hah! That's a good one!		scene_33
？？？	???		scene_33
カギがあかなくて当然ですよ。だって、そいつは壁にかかれたただの「えなんだから」	Of course there's no key. It's a wall. We just painted a door on it.	当然壁	scene_33
えーっ！？本物じゃないの、このドア？	What!? It's not a real door?	本物	scene_33
なんだってえ？壁にかかれたドアだあ？	Say what? You drew that door on the wall?	壁	scene_33
そうです。そのドアをぬけてどこか別の世界へ行けたら……。そんな気持ちで、かいたんですが	That's right. We drew it on there to make it feel like you could pass through it to another world.	別世界行気持	scene_33
ビックリさせちゃいましたね。おわびといっちゃなんだけどこれをさしあげますよ	Sorry to have surprised you. It's not much of an apology, but please take this.		scene_33
え、ほんとに？それじゃ……、ありがとう	Really? Thank you.		scene_33
TIFAたちは、呪いの指輪を	TIFA and the others	呪指輪	scene_33
もらってしまった！	received "Cursed Ring"!		scene_33
おう、まあ……、そんじゃありがとうよ	Oh, uh…well Thanks.		scene_33
CIDたちは、呪いの指輪を	CID and the others	呪指輪	scene_33
できることなら、ボクらはみんなそこにあるような夢のドアをぬけて別の世界へ行ってみたいとねがってるんじゃないでしょうか？	We're hoping to pass through a door like that one into another world.	夢別世界行	scene_33
なんだかあなた方はぼくのかわりにそのねがいをかなえてくれるような気がします。ヘンですね……	I feel that you all might be able to make my dreams come true. Weird, isn't it?	方気	scene_33
どうしたの、おまえ？やけに、ひとなつっこいわね？	What is it? You're being awful friendly all of a sudden.		scene_33
はは～ん、さてはこれかぁ。ミメットの野菜がねらいだな……おまえ？	Oh, so that's it. You want the Mimmet Greens…don't you?	野菜	scene_33
ミメットの野菜をあげる	Give it some Mimmet Greens	野菜	scene_33
野菜はあげられない	Don't give it any	野菜	scene_33
ゴメンね、おチビさん。この野菜はあげられないのよ	Sorry, little guy. I can't give you any.	野菜	scene_33
しょうがないわね。ほら、お食べなさい	Well, okay. Here, go ahead and eat.	食	scene_33
うふふ……。かわいい！ちょっと、こちょこちょしちゃおうかな	hee hee…how cute! I just want to tickle him.		scene_33
なんでえ、こいつ。やけに、ひとなつっこい野郎だな？	What's this!? You're bein' awful friendly.	野郎	scene_33
ははぁ、さてはこれか。ミメットの野菜が好物なんだな……おめえ？	Oh, so that's it. You want the Mimmet Greens…don't you?	野菜好物	scene_33
ち、冗談じゃねえぜ！	Don't give it any.	冗談	scene_33
おっと、残念だけどよ。野菜はやれねえな、チビ助	Sorry, shorty. But I can't give ya any.	残念野菜助	scene_33
けっ、しょうがねえなあ。ほらよ、チビ助。食いな	Well, guess there's no way around it. Here ya go, shrimp. Eat up.	助食	scene_33
へへっ、案外かわいいな。どれ、そいじゃついでにひとつこちょこちょでもしてやっか？	Heh heh, hey he's kinda cute. Aw, maybe I'll just tickle him a little.	案外	scene_33
チョコボは、おいしそうに野菜を食べた。	The chocobo looks like it enjoyed eating the Greens.	野菜食	scene_33
足の裏をこちょこちょ	Tickle his feet	足裏	scene_33
おなかをこちょこちょ	Tickle his stomach		scene_33
のどをこちょこちょ	Tickle his neck		scene_33
おへそをこちょこちょ	Tickle his belly button		scene_33
耳の裏をこちょこちょ	Tickle behind his ears	耳裏	scene_33
わきの下をこちょこちょ	Tickle under his arms	下	scene_33
チョコボは、よろこんでいるようだ。	The chocobo looks like it loves that.		scene_33
チョコボは、くすぐったいようだ。	The chocobo looks a little ticklish.		scene_33
チョコボは、怒っているようだ。	The chocobo looks a little angry.	怒	scene_33
チョコボは、はずかしがっているようだ。	The chocobo looks a little shy.		scene_33
チョコボは、どうでもいいようだ。	The chocobo looks bored.		scene_33
タダ食いだった。	Dined and dashed.	食	scene_33
チョコボに、『ふういん』のマテリアをもらった！	Received Materia from the Chocobo!		scene_33
しかし、マテリアがいっぱいで	But you've got too much Materia		scene_33
これいじょう持てない……。	you can't take on anymore…	持	scene_33
チョコボは、マテリアをしまってしまった。	The chocobo put the Materia away.		scene_33
あ～、ビックリした……！死んだかと思っちゃった！	Oh, you scared me…! I thought you were dead!	死思	scene_33
ひゅ～、驚かしやがって。死んだかと思っちまったぜ！！	Sheesh, you scared me. I thought you croaked!!	驚死思	scene_33
チョコボは、好物の野菜をくれそうにない人間にはつめたかった。	Chocobos ignore humans who don't look like they'll give them greens.	好物野菜人間	scene_33
ミディール　アイテム屋	Mideel Item Store	屋	scene_33
なんでももうすぐあの巨大なお月さんが、降ってくるっていうじゃない？	So that overgrown moon's gonna fall on us, huh?	巨大月降	scene_33
けっきょく世の中、お金と物よ！それさえあれば、いつだって……どこでだって、やってける！	When it all comes down to it, this world's about money and material things! If you got 'em, you can get by whenever, wherever!	世中金物	scene_33
いらっしゃい、アルね。やすらぎといこいのショップ。今日、どんなようアルか？	Welcome! Cash is welcome here! How may I help you?	今日	scene_33
まいどあり、のことね！また来てちょー、アルね	Thank you! Come again!	来	scene_33
へい、らっしゃい！いつもニコニコ現金払い！と、行きたいとこなんだが……	Welcome! We always welcome cash! Now, about where you want to go…	現金払行	scene_33
いやあ、そこのお客さんがみんな予約しちまったもんでもうなにも残ってないんで……	I'm afraid other customers have already booked it up. There's nothing left.	客予約残	scene_33
……なんちゃってえ！じょうだんですよ、お客さん。さてそれじゃ、どんなごようで？	…just kidding! Just a little joke.	客	scene_33
ミディール　マテリア屋	Mideel Materia Store	屋	scene_33
いらっしゃいアルね。やすらぎといこいのショップね。と、行きたいとこアルが……	Welcome! We always welcome cash! Now‚about where you want to go…	行	scene_33
あいや、そこのお客さん、みな予約しちゃったんで、もうなにも残ってないよ、お店	I'm afraid other customers have already booked it up. There's nothing left.	客予約残店	scene_33
……というのは、じょうだんアル。エヘヘ！さて、それじゃ、どんなごようね？	…just kidding! Just a little joke. Now what can I do for you?		scene_33
ミディール　治療所	Mideel Clinic	治療所	scene_33
ドクター	Doctor		scene_33
おやおや。そんなにあわててメテオでも降って来たかねおじょうさん？	Hey! You barged in here like Meteor was crashing down or something.	降来	scene_33
すみません、どうやら友人がこちらでお世話になってるらしいと聞いたもので……	I'm sorry…but I heard a friend of mine was here…	友人世話聞	scene_33
友人……？	A friend?	友人	scene_33
ああ……！　あの若者のことか！？	Oh…that young fellow!?	若者	scene_33
安心なさい。君の友人なら、となりの部屋だよ。ただ、まだ具合が……	Don't worry. He's next door. But his condition isn't good.	安心君友人部屋具合	scene_33
こちらですか？	Here?		scene_33
失礼します！	Over here.	失礼	scene_33
CLOUD……！？	CLOUD!?		scene_33
ああ……CLOUD！！よかった、無事だったのね！？	Oh…CLOUD!! I'm so glad you're safe!?	無事	scene_33
う……ああ……？	Uh…aaa…?		scene_33
ど……どうしたの……CLOUD……？	Wh…what's wrong… CLOUD?		scene_33
あ……。ぐげ……？	Aaa..gurk..		scene_33
CLOUD！どうしちゃったの……！？	CLOUD! What happened to you?		scene_33
魔晄中毒だよ……。それも、かなり重度の、ね……	Mako poisoning… Quite an advanced case.	魔晄中毒重度	scene_33
どうもこの若者は強烈な魔晄エネルギーに長時間さらされたようだな	It appears this young man's been exposed to high levels of Mako energy for an extended period of time.	若者強烈魔晄長時間	scene_33
おそらく、自分が誰なのか自分がいまどこにいるのかすら理解していないだろう……	He probably has no idea who or where he is now…	自分誰理解	scene_33
かわいそうだが、君の声もとどいてはいまい……。本当の彼は別の場所にいるんだ	Poor fellow, he can't even speak. He's literally miles away from us.	君声本当彼別場所	scene_33
誰もいったことがないような遠い場所に……ひとりぽっちでね……	Some place far away where no one's ever been… All alone…	誰遠場所	scene_33
そんな……！！	Doctor!!		scene_33
チクショー。なんてこった……	This's bad…		scene_33
なんて、むごい……	How horrible…		scene_33
あんまりやなぁ……	That's terrible…		scene_33
チ……ひでえ話だ	Damn, that's evil.	話	scene_33
ウソでしょ！？	You lyin' or what!?		scene_33
コホン！　わたしたちはちょっと席をはずすとしようか	Ahem! Let's excuse ourselves.	席	scene_33
さあ、君たちも、一練に……。外で待っていよう	Listen, would you all mind… waiting outside?	君一練外待	scene_33
どうして……？どうして、こんなことに……！	Why? What do you want me to do?		scene_33
おねがい、CLOUD……。こたえてよ……	Please, CLOUD… Talk to me…		scene_33
ちゃんと私のこと見てるって私の声が聞こえるって……言ってよ、ねえ……	Tell me you see me, that you can hear me… Tell me, please…	私見声聞言	scene_33
あなたとの思い出を信じたくてここまで来たのに……	I made it this far believing in the memories we shared.	思出信来	scene_33
こんなの、ないよ……！ひどすぎるよ……	This isn't happening! It's too cruel!		scene_33
ああ、CLOUD……！私……	Oh, CLOUD! I…	私	scene_33
話っていうのは、ほかでもないCLOUDのことなんだけど……	I don't care about anything else, only CLOUD…	話	scene_33
私……彼のそばにいてあげたいの……	I…want to be by his side…	私彼	scene_33
ああ……そうしてやるのが一番かもしれんな……	Yeah, that's probably best…	一番	scene_33
CLOUDにとっても……おまえにとっても……	For CLOUD… and you…		scene_33
うん、それがいいよ！	Yes, that's best!		scene_33
ああ、わかってるって。なにも言うねぇ	Yeah. Right. Hang in there, TIFA.	言	scene_33
やっぱ、そうこなくちゃ。自分に正直に生きなきゃ、ね	Then you gotta do it. You gotta be true to yourself.	自分正直生	scene_33
TIFAさんがかんびょうしてくれるんやったら、CLOUDさんと代わってほしいくらいですわ	If TIFA were my nurse, I'd switch places with CLOUD any day!	代	scene_33
好きにするがいい	Do what you wish.	好	scene_33
ゴメンね、みんな……。こんな時に……	I'm sorry, everyone… Especially now…	時	scene_33
あやまるヤツがあるかよ。オレたちも、また様子をみによるよ	Why you apologizin'? We'll come back again an' check on ya.	様子	scene_33
がんばれよ、TIFA。CLOUDのことは、まかせたぜ	You take care now, TIFA. And take care of CLOUD.		scene_33
いいってことよ。オレ様も、また顔を出すからよ	Don't worry. I'll stop by again.	様顔出	scene_33
がんばりな、TIFA。CLOUDのことは、たのんだぜ	You hang in there, TIFA. Take care of CLOUD.		scene_33
いいんだよ、そんなこと。オイラたちも、またよるからさ	That's all right. We'll be by again.		scene_33
がんばって、TIFA。CLOUDのことは、たのんだよ	Do your best, TIFA. Take care of CLOUD.		scene_33
気にしない、気にしない。アタイらも顔みせるからさ	No big, no big. I'll pop in again later.	気顔	scene_33
CLOUDのこと、たのんだね。がんばるんだよ、TIFA	Look after CLOUD. Take care, TIFA.		scene_33
ええって、みずくさいなぁ。また顔みせにきますわ	What're you talkin' about? We'll stop in again.	顔	scene_33
CLOUDさん、はよようなるとええのにな	Hope CLOUD gets better soon.		scene_33
気にするな。私たちもたまには様子をみによる	Don't worry. We'll return and check on him later.	気私様子	scene_33
CLOUDのことは、まかせたぞ	Take care of him.		scene_33
うん……	Right…		scene_33
それとな、TIFA……。こんなことは言いたかねえんだが……	Oh, and uh, TIFA… I don't like askin' this but…	言	scene_33
ヤツはたしかに、おまえの幼なじみのCLOUDにまちがいないのか？セフィロスの影なんかじゃなく	Are you sure he's really your friend? And not Sephiroth's shadow?	幼影	scene_33
え！？それは……たぶん……	Huh!? Well…that is…		scene_33
……ううん、きっと！	No, I'm sure of it!		scene_33
そうか……。なら、いいんだ……。ヘンなこと、聞いちまったな	Yeah? OK, then… Sorry for askin'.	聞	scene_33
よし、それじゃオレたちはハイウインドにもどるぜ	We gotta get back to the Highwind.		scene_33
よし、それじゃオレ様のハイウインドにもどるとするか	Now, we gotta be headin' back to the Highwind.	様	scene_33
よし、それじゃオイラたちはハイウインドにもどろう	We should be getting back to the Highwind.		scene_33
よし、それじゃアタシたちはハイウインドにもどろうよ！	Hey, shouldn't we be gettin' back to the Highwind?		scene_33
ほな、ハイウインドにもどりましょか	Well, I guess we'd better go back to the Highwind.		scene_33
……それでは、私たちはハイウインドにもどるぞ	Very well then, we should return to the Highwind.	私	scene_33
なあ、お医者の先生。ほんとうのとこを聞かせてくれないか？	So what about him?	医者先生聞	scene_33
あいつは……、CLOUDはどうなんだ？なおるみこみはあるのかい？	You know… CLOUD?		scene_33
なあ、先生さんよ。ほんとうのところを教えてくれよ	Listen Doc, why don't you tell us the truth.	先生教	scene_33
CLOUDのヤツはどうなんだ？ちゃんと元にもどるのか？	What about CLOUD? Is he all right?	元	scene_33
ねえ先生、CLOUDはだいじょうぶなのかな？ちゃんと、なおるの？	Tell me doctor, is CLOUD all right? I mean will he heal?	先生	scene_33
ね、先生、CLOUDはほんとにオッケーなの？ちゃんとなおるの？	Hey Doc, is he okay? Is he gonna heal?	先生	scene_33
なぁ先生、ほんまはどうなんです？CLOUDさんは、だいじょうぶなんですか？ほんま、どないなっとるんやろ	Hey doctor, is CLOUD all right? Is he gonna get better? Come on, tell us the truth	先生	scene_33
くりかえすが彼は重度の魔晄中毒だ。あそこまでひどいのは、わたしも見たことがない……	I'll say it again, he's got Mako poisoning. I've never seen a case this bad…	彼重度魔晄中毒見	scene_33
魔晄エネルギー内に潜むぼうだいな知識の量……。それがいっぺんに彼の頭の中に流れこんだんだろう……	An immense amount of Mako-drenched knowledge was infused into his brain.	魔晄内潜知識量彼頭中流	scene_33
ふつうの人間にはたえきれるものじゃない……。生きてるだけでも、きせきだ！	It's a miracle he survived! No normal human could have.	人間生	scene_33
ライフストリームに落ちてここまで流されて来たんじゃ……ムリないぜ、それも……	No wonder… After fallin' in the Lifestream an' bein' washed up here…	落流来	scene_33
ムリねえかあ……。ライフストリームに落ちてここまで流されて来たんじゃなあ	No wonder… After all, he fell into the Lifestream and was carried down here.	落流来	scene_33
ムリないよ。生身でライフストリームにどっぷりつかっちゃったんだから……	No wonder. He fell into the Lifestream and washed up here…	生身	scene_33
あったりきだよねえ。ライフストリームに、頭から飛びこんじゃったんだもんね	No lie. After fallin' head first into the Lifestream.	頭飛	scene_33
しゃあないよな。ようさんライフストリームにつかってしもたからなぁ……	No wonder. After falling into the Lifestream…		scene_33
しかし、どんなところにも希望の光はある。あきらめては、いけない	But remember, the light of hope can be found anywhere.	希望光	scene_33
いいかい、君たちが希望をすててしまったら……いったい彼はどこへ帰ればいいというのかね？	If you give up hope… What will happen to him?	君希望彼帰	scene_33
……希望か……	…hope…	希望	scene_33
でもよ、正直な話……オレはあいつに帰ってきて欲しいとホントにねがってるんだろうか？	Hey, but honestly, man… Do I really want him to come back?	正直話帰欲	scene_33
ヤツがこの世界に何をした？この先、オレたちに何をもたらす？セフィロスの影でしかないのかもしれねえんだぞ……	What did he do for the world? What can he do for us from here on out? He may be nothing more than Sephiroth's shadow…	世界何先影	scene_33
どうかしたかね？	Is something wrong?		scene_33
いや……。何でもねえよ	No, nothin'. Nothin' at all, Doc.	何	scene_33
……。希望か……	…Hope…	希望	scene_33
たしかにいま、オレたちに残されてるのは、そいつだけかもしれねえなあ……	I guess that's all that's left now…	残	scene_33
うん、きっとよくなるよね！強いソルジャーだもの、CLOUD	Hmm, I know he'll recover! CLOUD was a strong member of SOLDIER.	強	scene_33
そうだよね。アタシたちがついてんだもん。きっと元気になるよね！	Yeah, that's right. Besides, WE'RE here for him. He's gotta get better!	元気	scene_33
ほんま、そうや。CLOUDさん、元気になるわ！ほんまに……	Yeah! I know CLOUD'll get better!	元気	scene_33
こないに心配してくれはるおともだちが、ようさんおるんやおちおちねとられへんて	With friends like us worrying about him He'll pull through.	心配	scene_33
もういいのか？	You okay?		scene_33
だいじょうぶ、TIFA？	Are you all right, TIFA?		scene_33
オッケーなの、TIFA？	You okay, TIFA?		scene_33
だいじょうぶなんですか？	You all right?		scene_33
ええ……。 心配かけて、ごめんなさい。	Yes… I'm sorry to worry you all.	心配	scene_33
それで……ちょっとみんなに話があるんだけど……	There's something I want to say to you…	話	scene_33
コレルだと～！！	Corel!		scene_33
これ以上コレルをどうしようってんだ！	What else can they do to Corel!?	以上	scene_33
それにヒュージマテリア……	And the Huge Materia…		scene_33
大きなマテリアのことでしょ？オイラ、聞いたことがあるんだ	You mean the Huge Materia, don't you? I've heard about it.	大聞	scene_33
えっと、オイラたちの小さなマテリアを大きなマテリアに近づけると何かがおこるはずだよ、きっと	When our small Materia nears the larger one, there should be some reaction.	小大近何	scene_33
だからオイラたちがマテリアの力を借りて戦いを続けるのなら……	I'm certain of it. That's why we're using the Materia power in our fight…	力借戦続	scene_33
ヒュージマテリアを神羅に渡すわけにはいかねえ！	Can't let Shinra get a hold of the Huge Materia!	神羅渡	scene_33
それによ、CLOUDが帰ってきたらヒュージマテリア見せてよびっくりさせてやろうぜ	Besides, when CLOUD gets back, I wanna show him this Huge Materia. He's gonna be shocked.	帰見	scene_33
なぁ～んや、BARRETさん	So, what are you saying, BARRET?		scene_33
なんやかんや、言うてもCLOUDさんが帰ってきはったらええなと思ってはるんや	Even though you're always knocking him, you really want CLOUD to return.	言帰思	scene_33
いいじゃねえか、そんなことはよ。それより、なんだ……	I ain't sayin' nothin' 'bout nothin'. So just…shut your face!		scene_33
団体行動にはリーダーが必要だ	Every group's gotta have a leader.	団体行動必要	scene_33
リーダーはオレだ！	An' that's me!		scene_33
そう言いてえところだがオレはリーダーには向いてねえ	Or at least I wanna be… But I ain't cut out to be no leader.	言向	scene_33
最近気づいたんだけどよ	I never knew that till lately.	最近気	scene_33
んなわけでよ……	That's what it is.		scene_33
ＺＺＺＺ……？	…ZZZZ…hmph?		scene_33
おっ！？　な、なんでい！	Wha? What's goin' on?		scene_33
あんたがリーダーに決まった	You been chosen to be the new leader.	決	scene_33
そんな面倒なことはイヤだぜ	Pain in the ass. Forget it.	面倒	scene_33
これからの戦いにはあんたと、あんたのこの飛空艇ハイウインドが必要なんだ	But for us to fight, we gotta have Highwind, and you.	戦飛空艇必要	scene_33
これは星を救う船だぜ。その大切な船を仕切ってるのは誰だ？あんただろ？	We need it to save the Planet. An' who's runnin' this ship? You!	星救船大切仕誰	scene_33
だからオレたちのリーダーはCID、あんたしか考えられねえ	That's why you're our new leader. Ain't no one else can do it.	考	scene_33
へ……星を救う船か。……ちょっと熱いじゃねえか	Hmm…this ship's gonna save the Planet, huh? Ain't that gonna be just a little tough?	星救船熱	scene_33
今のはハートにズンと来たぜ	Oh man, stab me in the heart.	今来	scene_33
オレ様も男だ！	I'm a man, too!	様男	scene_33
やったろうじゃねえか！オレ様についてきやがれ！	Okay, I'll do it! Everyone, follow me!	様	scene_33
というわけで最初の仕事だ	Alright, now here's the first job.	最初仕事	scene_33
オペレーション・ルームがあんたを待ってるぜ！	The Operation Room's waiting for you!	待	scene_33
準備ができしだいコレル魔晄炉へ出発だ！	As soon as we're ready, we'll head for the Corel reactor.	準備魔晄炉出発	scene_33
急げ、CID！	Hurry, CID!	急	scene_33
見習いパイロット（ＬＶ５）	Pilot in training (LV5)	見習	scene_33
あわわわわ！艇長、リーダー就任おめでとうさんです！	Eaggggghh! Congrats' on becoming our leader, Cap'n!	艇長就任	scene_33
あわわ！　いくですか？	Yaaah! Are we taking off?		scene_33
あわわ！　いくで～す！	Eagggggh! We're taking off now!		scene_33
あのよぅ	Hey…		scene_33
リーダーってのはつかれるよなぁ	It's tough being the leader.		scene_33
CLOUDはよくやってたぜ。まったくよう……	CLOUD did a great job. Sheesh…		scene_33
ミディールに様子でも見に行くかあ？	Shall we go to Mideel to check on things?	様子見行	scene_33
CLOUD……どうしてるかな？	I wonder how CLOUD's doing.		scene_33
TIFA、つかれてないかな？	I wonder if TIFA needs a break…		scene_33
オイラ、看病かわってもいいな	I could look after him instead.	看病	scene_33
ええっと……どこへ行けばいいんだ？	Well, let's see… What's a good place to head to?	行	scene_33
コレルかぁ？コンドルフォートかぁ？	Corel? Fort Condor?		scene_33
お次はなんだ？コレルの魔晄炉だったかぁ？	Where shall we go next? Shall we head for the Corel reactor?	次魔晄炉	scene_33
お次はなんだ？コンドルフォートだったかぁ？	What's next? Shall we head for Fort Condor?	次	scene_33
見習いパイロット（ＬＶ６）	Pilot in training (LV6)	見習	scene_33
あわ！　いくですか？	Yaah! Shall we take off?		scene_33
あわ！　いきま～す！	Yaah! We're taking off!		scene_33
な～にシケた顔してるんだぁ？	What's that sad face for?	顔	scene_33
CLOUDがいなくちゃダメかよ……最初はあいつ無しでやってきたじゃねえか……	What? Does CLOUD always gotta be around? We did fine without him in the beginning…	最初無	scene_33
ん？　強いTIFAさんはどこに行っちまったんだぁ？	Right? An' what happened to the tough girl I used to know? Where'd she go to?	強行	scene_33
オレはよう、CLOUDのこと考えるとワケがわかんなくなっちまうんだ	Whenever I think of CLOUD, everything gets all jumbled up.	考	scene_33
いくら神羅や宝条でもよ人間をつくっちまうなんて信じられねえしな	No matter how powerful Shinra or Hojo is, I can't believe they can create humans.	神羅宝条人間信	scene_33
でも、あいつのせいでメテオが来ちまうのは確かだ……	But because of them, we know that Meteor is heading towards us.	来確	scene_33
はっきり言って、あいつに会ってもどうしたらいいのか、わかんねえぜ……	Y'know, even if I saw him, I don't have a damn idea what I'd do.	言会	scene_33
リーダーさんよ！　急いでくれ！	Yo, Leader-man! Get your pilot ass up here!	急	scene_33
ん～？　リーダーさん、次はどうするよっ！	Leader-man? What's next!?	次	scene_33
おい、ちらっとTIFAたちの様子でも見にいかねえか？	Yo, wanna see what TIFA and the gang are doing?	様子見	scene_33
元気だしてよ、TIFA……	Cheer up, TIFA…	元気	scene_33
ライフストリームに近い場所……小さな島があるらしいんだ	There appears to be a small island near the Lifestream……	近場所小島	scene_33
南の島で、ときどきライフストリームがブワーッてふきだしたりするんだって	They said the Lifestream sometimes suddenly gushes out at the Southern island.	南島	scene_33
うんと小さいころ、セトに聞いたんだけどよく覚えてないんだ……	I remember hearing about this from Seto when I was a child, but I don't remember much else…	小聞覚	scene_33
ごめんね……TIFA	I'm sorry…TIFA.		scene_33
CLOUDとTIFAのぶんもオイラ、がんばるからね	We'll do our best for CLOUD and you.		scene_33
…………AERISのぶんもね	…And AERIS, too.		scene_33
ね、CID	CID.		scene_33
時々CLOUDとTIFAに会いに行こうね	Let's visit CLOUD and TIFA from time to time.	時会行	scene_33
TIFAとCLOUD……どうしてるかな？	I wonder how TIFA and CLOUD…are doing.		scene_33
TIFAさん	TIFA.		scene_33
スカーレットのほっぺたバシバシしばいてましたやろ？	You saw him slapping Scarlet around?		scene_33
いや、よ～やってくれました。すか～っとしましたわ	Yeah, he did a good job, too. It felt good just watching.		scene_33
あの元気をず～と、忘れんようにがんばりましょうや！	Let's never forget that spirit, and give it our all!	元気忘	scene_33
TIFAさん、ボク、いろいろと神羅の情報を流しますからね	TIFA, I'll give you info on Shinra.	神羅情報流	scene_33
わからんことがあったらボクに聞いて下さいな	Ask me if there's anything you don't understand.	聞下	scene_33
神羅の動きは特にありませんわ	Everything appears calm right now at Shinra.	神羅動特	scene_33
今のうちにCLOUDさん、探しましょ。ボクも気になりますのや	So now's the time to look for CLOUD. I'm worried about him, too.	今探気	scene_33
あの人、どこにおるのやろなぁ？それとも、もう……	I wonder where CLOUD is. Or could he already be…	人	scene_33
TIFAさん……ボクは、神羅やめた方がええんでしょうかねぇ？	TIFA… Do you think it's a good idea for me to quit Shinra?	神羅方	scene_33
あ、す、すんません	Oh, I'm sorry.		scene_33
TIFAさん、それどころやあらへんもんなぁ……	TIFA, there's no way I can quit right now…		scene_33
CIDさん、期待してますで～	CID, I'm expecting big things from you	期待	scene_33
CIDさん、つかれてますなぁ	CID, you're tired, huh?		scene_33
代わってあげたいんやけどボク、情報係ですから、すんませんなぁ	I'd like to change places with you, but I'm in charge of information, so I can't. Sorry.	代情報係	scene_33
ええと、ヒュージマテリアはコレル、コンドルフォート……	Hmmn, the Huge Materia is at Corel, Fort Condor, and…		scene_33
他にもまだあったような気がしますけど、どこやったかなぁ……	I'm sure there was another place that had it. Where was that…?	他気	scene_33
神羅の動き……止まりましたで	Shinra's…stopped.	神羅動止	scene_33
でも、こういう時は要注意ですのや。ハイデッカーたちがなんか考えてるにちがいまへんわ	Now we've got to be careful. I know Heidegger and his gang are plotting something.	時要注意考	scene_33
……無事で良かったな、TIFA	…So glad you're all right, TIFA.	無事良	scene_33
ふくらみすぎた希望は絶望の裏返し	Too much hope is the opposite of despair.	希望絶裏返	scene_33
大きすぎる愛はおまえを打ちのめすことになるかもしれない……	An overpowering love may consume you in the end.	大愛打	scene_33
CID……あんたのその熱さがうらやましいよ	CID…I wish I had your go-get-them attitude.	熱	scene_33
私の心は長い眠りのうちにとけてなくなってしまったようだからな……	It appears my feelings vanished into thin air ever since my long slumber….	私心長眠	scene_33
……戦闘以外で私に何かを期待するな	…Don't expect me to do anything other than fight beside you.	戦闘以外私何期待	scene_33
ねぎらいの言葉すら、私は知らない。もっとも、あんたは他人の優しさにすがるような人間ではなさそうだが……	I have no words of comfort. Of course, I don't believe you're the type who needs the kindness from others…	言葉私知他人優間	scene_33
ずいぶんつかれているようだがそろそろリーダーをおりるのかな？	You look really tired, maybe you're ready to give up being leader?		scene_33
落ちこんでてもしょうがねえぞ、ネエちゃん。とにかくいろいろ動きまわるこったぜ	No use singing the blues, baby. The best thing to do is to keep movin'.	落動	scene_33
あ、あの、話しかけられるとドキドキしちゃって仕事しくじっちゃいます	Whenever anyone talks to me, I get all nervous and mess things up!	話仕事	scene_33
オラッ！　なにやってんだよ！	Hey you! What the hell are you doin'!?		scene_33
艇長！　ごくろうさまです！	Good day, Captain!	艇長	scene_33
お、おれたち見てるだけでいいんです。話しかけてくれなくってもいいです	All we have to do is just pilot. They don't have to talk to us.	見話	scene_33
やっぱり艇長がリーダーじゃなくっちゃ……でっす！	Looks like you turned out to be the leader after all, Captain…	艇長	scene_33
見習いパイロット（ＬＶ７）	Pilot in Training (LV7)	見習	scene_33
わ！　いくですか？	Yaaah!  Shall we take off?		scene_33
わ！　いきます！	Man!  We're taking off!		scene_33