オヤジ小屋	Old man's house	小屋	scene_36
ぐー、ぐー	…zzzz…zzzz…		scene_36
なに、勝手にさわってんじゃ！	What're you groping around for?	勝手	scene_36
ぐー、ぐー…	…zzzzz…zzz…		scene_36
なんじゃ、お前さんは	Who're you?	前	scene_36
ふん、じゃがワシが起きたとき会ったのもなにかの縁じゃわい。ほれ！	Hmph. I guess it was fate that I woke up and met you here!	起会縁	scene_36
『ミスリル』を手にいれた！！	Received "Mythril"!!	手	scene_36
『雷の指輪』を手にいれた！！	Received "Bolt Ring"!!	雷指輪手	scene_36
けしから～ん回も逃げてんじゃな～いぐー、ぐー	Come on. You already escaped  times. …zzz…zzzzzzz…	回逃	scene_36
回も戦っとるのかぁ…ぐー、ぐー	You've already fought  times… …zzzzz…zzzzzzzz…	回戦	scene_36
大っきいマテリアはレベルが高～いマテリアが欲しいのかぁ……ぐー、ぐー	Large Materia needs high level Materia…  …zzzzzz….zzzzzzz…	大高欲	scene_36
？？？の家	Mystery House	家	scene_36
チョコボせんにんの家	Chocobo Sage's House	家	scene_36
ほーほっほこんなヘンピな所に人が来たのは……	Ho ho. It's unusual for people to come to such an out of the way place…	所人来	scene_36
何年ぶりじゃろうなおぼえておらんわぁ	I can't remember how long it's been since my last guest.	何年	scene_36
あんたは何者だ？	Who are you?	何者	scene_36
あなたは、だれ？	Who are you?		scene_36
おまえ、何もんだ？	Who are you?	何	scene_36
わしか？わしは……	Me? I'm…		scene_36
誰じゃったかのぉ？	I don't know.	誰	scene_36
はぁ？あんた自分のことだろ？	You don't know who you are?	自分	scene_36
えっ？自分が誰だかわからないの？	Wha? You don't know who you are?	自分誰	scene_36
あ？　おめぇってば　自分のこともわかんねぇのかよ？	Huh? You're sayin' you don't even know who you are?	自分	scene_36
長いこと考えておらんかったしのぉ……	Been a while since I gave it any thought…	長考	scene_36
なんて、呼ばれておったかのぉ	What was it they used to call me?	呼	scene_36
そうじゃ！！人は私を『チョコボせんにん』と呼んでおった！！	Oh yeah!! They used to call me the 'Chocobo Sage'. That's right!!	人私呼	scene_36
そうじゃ、そうじゃ『チョコボせんにん』じゃ！	Right, that was it, The Chocobo Sage!!		scene_36
（忘れるなよ、そんなこと）	(No one would forget that)	忘	scene_36
（普通、忘れないわよね……）	(Who would forget that?)	普通忘	scene_36
（なに、考えてんだコイツ）	(The hell's wrong with this guy?)	考	scene_36
チョコボせんにん	Chocobo Sage		scene_36
さて、この私になんのようかのぉ？	Now what can I do for you?	私	scene_36
なんか売って	Sell me something?	売	scene_36
あのチョコボは？	What about that Chocobo?		scene_36
何か思い出した？	You remember anything?	何思出	scene_36
おお、あのチョコボか？あのチョコボは……	That Chocobo? Well that one is…		scene_36
なんじゃったかのぉ思い出せんのぉ…	Let's see now, I don't quite remember…	思出	scene_36
おお、思い出したぞ！あのチョコボはのぉ	I remember now! That's the one they call…	思出	scene_36
『山チョコボ』じゃ。名の通り、山も越えられるチョコボじゃて	It's a Mountain Chocobo. And like the name says, he can cross any mountain.	山名通山越	scene_36
他にも川を越えられる『川チョコボ』とかもおったのぉ	There is another one that can cross rivers, too. They call him a 'River Chocobo'.	他川越川	scene_36
どこで捕まえる？	Where can we catch one?	捕	scene_36
どこで捕まえられるの？	Where can we find one?	捕	scene_36
どこにいるんだその何とかチョコボってのは？	Where can I get one of those Whatdyacallem Chocobos?	何	scene_36
いやいや、今はおらんよ	There aren't any around now.	今	scene_36
………いるだろ、そこに	… That's one right there, isn't it?		scene_36
ちょっといるじゃない、そこに	What about that one right there?		scene_36
ふかしこいてんじゃねぇよいるじゃねぇか、そこに	What're you flappin' about? There's one right there!		scene_36
はて？なんでいるんじゃろうのぉ	Wha? I wonder what he's doing there?		scene_36
思い出せんのぉ…	Can't remember for the life of me…	思出	scene_36
生まれたんじゃ。『すごくいいチョコボ』か『いい感じのチョコボ』にのぉ	…was bred from a Great Chocobo' and a Good Chocobo'.	生感	scene_36
『カラブの実』を使ってタマゴを生ませると生まれる時があるんじゃ	If you give them "Carob Nuts" during breeding, there's a chance you'll get one of these Chocobos.	実使生生時	scene_36
それで、そのチョコボはどこにいるんだ？	So where's this Chocobo?		scene_36
それと、その『カラブの実』はどこで手に入る？	So where can I get some of these 'Carob Nuts'?	実手入	scene_36
それで、そのチョコボはどこに行けば捕まえられるの？	So where can I find those Chocobos?	行捕	scene_36
それと、その『カラブの実』ってどこに行けば手にはいるの？	…And what about those 'Carob Nuts'?	実行手	scene_36
で、そのチョコボはどこにいるんだよ	So where is this Chocobo?		scene_36
それと、その実ってのはどこにあるんだ？	And what about those nut things?	実	scene_36
はぁ？　どこで？どこじゃったかのぉ	Huh? Where? Where was that?		scene_36
それに、実ってなんじゃったかのぉ？	And what was that nut?	実	scene_36
こっから、ずぅっ～と南東にある島か。緑にかこまれたコレルじゃったかのぉ	…Is on an island southeast of here, In a place called Mideel surrounded by greenery.	南東島緑	scene_36
そこと、コレルから西の方で捕まえられるんじゃ。それと『カラブの実』はのぉ	You should be able to catch one just west of Mideel. And some Carob Nuts', too.	西方捕実	scene_36
こっから南におるモンスターがよくもっとるぞ。さらにじゃなぁ	There used to be some monsters just south of here that had them. Or you might…	南	scene_36
……………。おかしいのぉ何、言おうとしたのかのぉ	… Funny…I forgot What I was saying just now.	何言	scene_36
おお、思い出したぞ！	Oh right!	思出	scene_36
こないだ教えた『山チョコボ』と『川チョコボ』じゃがなぁ	It was about the Mountain Chocobo and the River Chocobo I told you about.	教山川	scene_36
この２つのチョコボになぁ タマゴを生ませると	When you mate these two together…	生	scene_36
山も川も越えられるチョコボになるんじゃ	…You get one that can cross rivers AND mountains.	山川越	scene_36
さらにじゃなぁ…さらに……なんじゃろうのぉ	And… And…uh, what was I saying?		scene_36
おお、思い出したぞ！さらにじゃなぁ	Oh, yeah! And also…	思出	scene_36
海もわたれるチョコボもおるんじゃ	There's one that can cross oceans, too!	海	scene_36
また、忘れてるとは思うが……	You probably don't remember but…	忘思	scene_36
そのチョコボはどうやって手に入れるんだ？	How can I get one of those Chocobos?	手入	scene_36
どうせまた忘れてると思うけど……	You probably forgot already but…	忘思	scene_36
その、チョコボはどうすれば、手に入るの？	How can I get one of those Chocobos?	手入	scene_36
ケッ！　どうせまた忘れてるんだろうけどよ	Great! I know you probably already forgot but,	忘	scene_36
その、チョコボはどこに行きゃあ手に入れられるんでぇ	Where can I get one of those Chocobos?	行手入	scene_36
バカにするでないぞ！海を渡れるチョコボはのぉ	Hey, don't talk like that! To get an Ocean-crossing Chocobo, you just…	海渡	scene_36
なんじゃったかのぉ…ぜんぜん思い出せんのぉ	Let's see now… …Nope. Don't remember a thing.	思出	scene_36
おお、思い出したぞ！海を渡れるチョコボはのぉ	Oh, I remember! The Ocean-crossing Chocobo is…	思出海渡	scene_36
山と川を渡れるチョコボにのぉ………………。なんじゃったかのぉ	The Mountain-and-River-crossing Chocobo is…uh… Oh, what was I saying?	山川渡	scene_36
おお、思い出したぞ！山と川を渡れるチョコボにのぉ	Right, right! I remember! You take the Mountain-and-River-crossing Chocobo…	思出山川渡	scene_36
このスグそばで取れるそれはいいチョコボとタマゴを生ませるとのぉ	Mate it with a 'Wonderful Chocobo' you can catch right around here… And you'll get…	取生	scene_36
海を渡れるチョコボが生まれるんじゃ。おおっ、それにのぉ	A chocobo that can cross the ocean will be born. Oh, but for that to happen...	海渡生	scene_36
『実』が必要じゃはて、なんの『実』じゃったかのぉ	You’ll need a certain type of nut. Just what type was it again...	実必要実	scene_36
おお、思い出したぞ！その実はのぉ	Oh, right! You'll need a…	思出実	scene_36
『ゼイオの実』じゃ『ゼイオの実』はのぉたしか……	'Zeio Nut'. Now let me see, as I remember, the Zeio Nut…	実実	scene_36
どこで手に入ったかのぉ	Where was it you could find those things?	手入	scene_36
おお、思い出したぞ！ 『ゼイオの実』はのぉ	Oh yeah! Zeio Nuts…	思出実	scene_36
ゴブリンの好物じゃ。ここから東の小島におるゴブリンがもっておるわ	Are the favorite of goblins. There's a small island east of here where the goblins have a bunch of them.	好物東小島	scene_36
もう、たぶん	I think…		scene_36
教えられることはないと思うのぉ	…that's all I'm gonna remember.	教思	scene_36
おお！	Oh!		scene_36
なんにもないのぉ…	That's it…		scene_36
マテリアの洞窟	Materia Cave	洞窟	scene_36
長い年月を経て魔晄エネルギーがマテリアの結晶になっている……	Over the course of many years, Mako energy will crystallize into Materia…	長年月経魔晄結晶	scene_36
『ものまね』のマテリアを手にいれた！	Received "Mime" Materia!	手	scene_36
『ＨＰＭＰいれかえ』のマテリアを手にいれた！	Received "HP<->MP"!	手	scene_36
『まほうみだれうち』のマテリアを手にいれた！	Received "Quadra Magic" Materia!	手	scene_36
『ナイツオブラウンド』のマテリアを手にいれた！	Received "Knights of the Round" Materia!	手	scene_36
ここはチョコボでも渡れないか…もっとパワーのある乗り物なら…？	Not even a Chocobo could make it across. Isn't there a more powerful vehicle?	渡乗物	scene_36
チョコボの移動	How to ride a Chocobo	移動	scene_36
バギーは、【川のあさい部分】や【サバク】を移動することができます。	Buggy's can cross shallow rivers and deserts	川部分移動	scene_36
コスタ・デル・ソルやジュノンにはバギーに乗ったまま入ることができ、【運搬船】で運ぶことができます。	You can even enter costa del sol and Junon by Buggy by hitching a ride on the cargo ship	乗入運搬船運	scene_36
タイニー・ブロンコの移動	How to fly the tiny bronco.	移動	scene_36
【決定ボタン】乗る	press the [Circle] button to get on	決定乗	scene_36
【キャンセルボタン】降りる	press the [Cancel] button to get off	降	scene_36
タイニー・ブロンコは、あさせを移動できます。	Tiny bronco can cross shallow waters and rivers	移動	scene_36
潜水艦の移動	How to drive the submarine	潜水艦移動	scene_36
【決定ボタン】乗る・前進	Press the [Circle] button to get on or move forward	決定乗前進	scene_36
【キャンセルボタン】降りる・潜行＆浮上	press the [Cancel] button to get off	降潜行浮上	scene_36
このような入りえでプレイヤーの乗り降りができます。	Players can get on and off at bays like this one	入乗降	scene_36
な、なんだ！？	What the?		scene_36
お、おい！ハイウインドを壊す気か？地上で迎え撃とうぜ！！	What're you tryin to do? Break the Highwind? Let's fight on the ground	壊気地上迎撃	scene_36
ちくしょう、なんてエネルギーだ！クソツ！あきらめてたまるかってんだ！	What energy! Damn you think I'm just gonna give up?		scene_36
な、なんだ今のは！？スゲエ勢いではしかれたぜ！	What the hell was that! That came Buzzin past here like a powerhorse	今勢	scene_36