イルカの海辺	Dolphin Shores	海辺	scene_37
ジジイ……	Old man…		scene_37
おう！！ジュノンエアポートだろ！	Yo!! Junon airport?		scene_37
助かったね！	Just in time!	助	scene_37
さ！エアポートにいきましょ！	Come on! Let's go to the airport!		scene_37
しょっぱいよう！エアポートにいこうよ！	Ugh. It's salty! Let's go to the airport!		scene_37
クソッ！ずぶぬれだぃ！	God!! I'm drenched!		scene_37
いそげぃ！エアポートだっ！	Hurry up! Let's get to the airport!		scene_37
ふぅっ～！！地上の空気はおいしいよ！	Phew… The air up here's great!	地上空気	scene_37
ほらっ！エアポートにいこう！	Hey! Let's go to the airport!		scene_37
エアポートにいきましょか！	Let's go to the airport!		scene_37
たすかったようだな。エアポートへむかうのだろ	Looks like we made it. You'll probably head for the airport, right?		scene_37
ジュノンか……	Hmm…Junon.		scene_37
なんとか、潜水監も手に入れておきたいところだな	I'd love to get my hands on a submarine right now.	潜水監手入	scene_37
おう！！　おもしれえ！ジュノン地下の【潜水監ドック】にもよってくか！	Yeah! I could go for that! Let's go to the submarine dock under Junon!	地下潜水監	scene_37
いまなら警備もうすいわ	There should only be a few guards now.	警備	scene_37
ジュノン地下の【潜水監ドック】によってくのもいいかもね	It might be safe to go to the submarine dock under Junon.	地下潜水監	scene_37
オイラ、のりたいな！ジュノン地下の【潜水監ドック】！とりにいこうよ！	I would like to ride it! Let's get one from the submarine dock beneath Junon!	地下潜水監	scene_37
ほしいならしかたねぇ！ジュノン地下の【潜水監ドック】！とれるときにとっとけ！	You want it? Then you got it! They're down at the submarine dock underneath Junon! You gotta get what you want while you can!	地下潜水監	scene_37
ええっ～！！ジュノン地下の【潜水監ドック】！ぬすむのはいいけどさ！	…Yeah!!	地下潜水監	scene_37
乗るのはえんりょしとくよ	The submarine dock underneath Junon!  I can steal a sub easy enough, but I can't pilot it!	乗	scene_37
潜水監はジュノン地下の【潜水監ドック】にありますんや！	Security's pretty light now! The submarine's at the submarine dock!	潜水監地下	scene_37
悪くなかろう	It should be alright.	悪	scene_37
いくか……	Let's go…		scene_37
ウェポンの襲撃にはビビッタよな。あんなヤツがまだあと２匹いるかと思うとゾッとするよ	I sure was scared when Weapon attacked. It gives me the creeps knowing there's still two of them left.	襲撃匹思	scene_37
そうかい？俺は人類最大の敵を目の前にして武者ぶるいしている。惑星規模の闘いなんてめったに経験できないぜ	Oh yeah? Well, I'm ready to fight mankind's worst enemy like a real warrior. It's not everyday you get to fight in an inter-planetary war.	俺人類最大敵目前武者惑星規模闘経験	scene_37
社長はこの星に存在するヒュージマテリアを全てあつめ、ロケットでメテオにぶつけるつもりだ。たいした社長だよ	The President is gathering up all the Huge Materia on the planet. He wants to shoot it at Meteor in the rocket.	社長星存在全	scene_37
ルーファウス社長は先代と違う。神羅の持つ科学力を総動員してこの星を守っている	President Rufus is different from the older generation. He'll protect the planet with all of Shinra's state of the art technology.	社長先代違神羅持科学力総動員星守	scene_37
守る？いや、違うな。そんなきれいな使命感は社長にはない。社長にとってはただの勝ち負けの間題。ゲームと同じさ……	Protect it? No, I don't think so. The President isn't the type to do anything so heroic. It's all just a game to him a question of winning or losing.	守違使命感社長勝負間題同	scene_37
とうとう、ここジュノン【海底魔晄炉】のヒュージマテリアも回収作業に入ったか	They've finally started collecting the Huge Materia from the Junon Underwater Reactor.	海底魔晄炉回収作業入	scene_37
回収後、このエアポートにヒュージマテリアが集められ、ゲルニカでロケット村へ送られるてはずになってる。気をぬくな！	After they get it, they'll take it to the airport and will transport it to Rocket Town by Gelnika. Don't let your guard down!	回収後集村送気	scene_37
ふう……無事に【ロケット村】まで到着してくれよ。これでミッションもひと段落だな	Whew…I hope everything goes all right until we get to Rocket Town. Then, our mission is nearly complete.	無事村到着段落	scene_37
まだまだ。もうひとつ大仕事が残ってるぜ。アレを運ぶミッションがな……	Not so fast. We still have one major task… we still have to transport the stuff…	大仕事残運	scene_37
アレか……	The stuff…		scene_37
しまった！ヒュージマテリアを……	Oh no! The Huge Materia…		scene_37
追いかけるぞ！	Let's go after it!	追	scene_37
後を追えないの？	Can't we go after it?	後追	scene_37
あれの目的地に先回りできるかな？	Can we get there before they do?	目的地先回	scene_37
ぐぅわぁぁ！タッチのさだ！おいかけるぞ！	Grrrrgh! Just barely! We're goin' after it!		scene_37
追いかけよう	Let's go after it.	追	scene_37
先回りして奪い返しませんか？	How 'bout us getting there beforehand and stealing it back?	先回奪返	scene_37
先回りしてとっつかまえちゃおうよ！	Let's get there before they do and catch 'em!	先回	scene_37
でもいったいどこに？	But where to?		scene_37
どこへ向かったのかな？	Where are they headed?	向	scene_37
行き先はどこかな？	Where's their destination?	行先	scene_37
あれの行き先は……	Where's that thing headed?	行先	scene_37
あれは……どこへ向かっている？	Where is their destination…?	向	scene_37
どこ飛んでくんやろ？	Where is it flying to?	飛	scene_37
ね、どこどこ？　行き先は？	Hey, where? Where? Where are they headed?	行先	scene_37
決まってるさ。ロケット村だ	Rocket Town, of course.	決村	scene_37
気のせいかもしれないけど……何かものたりなくないか？	I may be mistaken, but… doesn't it feel like we're missing something?	気何	scene_37
オレ、むかしはパイロット志望でさ！ゆうやみに浮かぶハイウィンド！いつ見てもしびれちゃうやね！	All I wanted was to become a pilot! I used to be speechless watching the Highwind in the sunset!	志望浮見	scene_37
ヒュージマテリアの積みこみは完了！後はエアポートでゆそうきのゲルニカの離陸を見送れば、任務は終わりさ	Finished loading the Huge Materia! All we have to do now is to ready the cargo ship, Gelnika', for departure and we're done!	積完了後離陸見送任務終	scene_37
ハイウインドなしのエアポートはさびしいもんやね！	It's kinda lonely at the airport without the Highwind, isn't it?		scene_37
オレ、あの機体の水着の女の子のファンだったのに	I miss that bikini girl on the side of the plane.	機体水着女子	scene_37
今、神羅軍は【コレル魔晄炉】と【コンドルフォート魔晄炉】のヒュージマテリア回収ミッションにかりだされてんだ	Right now the Shinra's using it to gather the Huge Materia from the Corel Reactor and from the Fort Condor Reactor.	今神羅軍魔晄炉回収	scene_37
ゲルニカもいそがしく飛び回ってるよ！ひまなのは、オレひとりぐらいさ！	The Gelnika's flying all over the place! The only one that's not busy, is probably me!	飛回	scene_37
今、神羅軍は、ここ、ジュノン海底魔晄炉のヒュージマテリア回収ミッション中でさ！無事回収したらこの空港に運びこまれるんだ	The Shinra's collecting Huge Materia at the Junon Underwater Reactor! When they're done, they'll bring it to this airport.	今神羅軍海底魔晄炉回収中無事空港運	scene_37
じゃまにならないうちにはやく立ちさりなよ！	Get out of here before you get in the way!	立	scene_37
えっ……オレ？オレもじゃまにならないようにここで見物ですよ！	What…me? I'm gonna be watching from here, so that I don't get in their way either!	見物	scene_37
無事ロケット村までゲルニカを送り出してほっと一安心	I'm glad we got Gelnika to Rocket Town safely.	無事村送出一安心	scene_37
でも、スケールのでかいこと考えるよな～。ヒュージマテリアの破壊力を利用してメテオを壊そうだなんて……	But they sure think big. Looks like they're going to use the Huge Materia to break up Meteor…	考破壊力利用	scene_37
神羅軍の軍事力はすべてミッドガルに集中した。もはやセフィロスでさえも死ぬのは時間の間題…	The Shinra Army's gathered at Midgar. Now it's just a matter of time Sephiroth's dead.	神羅軍事力集中死時間題	scene_37
えっ……オレ？オレはいいよぅ。ここで待機してますよ、命おしいですからねえ	What…me? I don't mind. I'll just wait here. My life is important to me.	待機命	scene_37
ついにオレにもセフィロス大作戦への参加命令がくだっちまいましたよ。あこがれのゲルニカにも乗れるんだけど……	I finally got orders to join the Great Sephiroth Plan. I even get to go on the Gelnika too…	大作戦参加命令乗	scene_37
けどね、てっていして無視してやりますよ。オレはしぶとく生き抜いて世界の最後をみとどけてやります	But, I'm just gonna ignore them. I wanna live to see the end of the world.	無視生抜世界最後	scene_37
もし運がよけりゃね……新しい世界がオレを必要としてくれるかもしれないしね	If I'm lucky… There'll be a good place for me in the New World.	運新世界必要	scene_37
いやじゃないですか？死ぬかもしれないって不安な気持ちで空を飛ぶなんて	Doesn't it bother you? Flying around knowing that you could die at any moment?	死不安気持空飛	scene_37
どうせならスカーッと生きてるよろこびに興奮しながらね。でも、その前に運転めんきょですけど	If that's the case, might as well live on the edge, I say. But before I can do that, I gotta get a license first.	生興奮前運転	scene_37
海底魔晄炉への通路	Junon Path	海底魔晄炉通路	scene_37
この先は、関係者以外立入禁止！	Only authorized personnel are allowed past this point!	先関係者以外立入禁止	scene_37
あんたも知ってるだろう？ジュノン海軍の重要機密	You know too, right? About Junon Navy's important classified information.	知海軍重要機密	scene_37
神羅技術のすいを集めた新型潜水監がもうじき完成するんだ	A new submarine has almost been completed using Shinra's top technology.	神羅技術集新型潜水監完成	scene_37
新型の潜水監。俺も乗船することになってんだ。うっ～、まちどおしいぜ！	A new version of submarine. I'll be sailing on it. Man, I can't wait!	新型潜水監俺乗船	scene_37
ふぁぁぁぁ……海底魔晄炉の見張りはたいくつだよ	Man… Keeping watch is so boring at the Underwater Reactor.	海底魔晄炉見張	scene_37
さぁっ！　お仕事っ！！お仕事っ！！	OK! Back to work!! Back to work!!	仕事	scene_37
ふぅぁ～……ねぶそく！！	Yawn…I'm sleepy!!		scene_37
ジュノン万歳～！！	For Junon!!	万歳	scene_37
神羅のイヌめ！！	Damn, Shinra dogs!!	神羅	scene_37
潜水監は俺たちがいただく！！そこをどけ！！	We'll take that submarine!! Out of our way!!	潜水監俺	scene_37
こちら、【ジュノン潜水監ドック】になっとります！	This is the Junon Submarine Dock!	潜水監	scene_37
はいりたければぼくらのワン公（ガードハウンドちゃん）に話しかけてください	If you want to enter, please talk to my dog.	公話	scene_37
道案内は終わりだ！いくぞ！！	That's all the instructions you're going to get! Let's go!!	道案内終	scene_37
ドキドキ……したへまいりま～す	…gulp… Going do---wn.		scene_37
こちらには潜水監ドックがございま～す	This floor is the Submarine Dock…	潜水監	scene_37
海底魔晄炉へおこしのお客様はここから先、連絡通路をお通りください	Those of you visiting the Underwater Reactor, please proceed through the connecting tunnel.	海底魔晄炉客様先連絡通路	scene_37
ドキドキ……うえでございま～す	…gulp… Going u---p.		scene_37
ジュノンの街にもどりま～す	Returning to Junon.	街	scene_37
ドキドキ……あの……つきましたでございま～す	…gulp…  We're here…		scene_37
ドキドキ……（キッ～～！　よくも……わたしのファンを減らしたわね！）	…gulp… (Great…there went two perfectly good men!)	減	scene_37
生き残ったほうが彼女とデートできるってのはどうだ？	How 'bout, whoever stays alive, gets to take her out?	生残彼女	scene_37
よし、のった！！	All right, you're on!!		scene_37
でもよ……二人ともやられた場合は…	But… What if both of us…	二人場合	scene_37
おっと！！そりゃいいっこなしってやつだ！	Whoa!! Don't even talk about that!		scene_37
ロックされている	Locked		scene_37
き、きさまはCLOUD！！	You, you're CLOUD!!		scene_37
ヒュージマテリアは渡さん！	You are NOT getting this Huge Materia!!	渡	scene_37
やはりヒュージマテリアをねらって来たか！	So you WERE after the Huge Materia!	来	scene_37
！？ヒュージマテリアが！	!? The Huge Materia!		scene_37
あ～！ゲーセン・キャッチャー！	Hey! A Crane Game!		scene_37
ひとあし遅かったか！	Damn, just missed it!	遅	scene_37
さっきの潜水監で運ぶつもりよ！	They're gonna take it on that submarine!	潜水監運	scene_37
そうはトンヤがおろすかってんだ！このヤロウ！	That's what you think! ^%$@#&$#!		scene_37
出遅れたな……	We were too late…	出遅	scene_37
ちょっと先に潜水監のドックがあるんですわ	There's the submarine dock just ahead.	先潜水監	scene_37
先回りすれば間に合うかも……！	If we take a short cut, we might just make it!	先回間合	scene_37
間に合ったか！？	Did we make it!?	間合	scene_37
何してる、と。お前も積みこみを……	What are you doing? Help load.	何前積	scene_37
CLOUD！？-	CLOUD!?		scene_37
ヒュージマテリアの運搬なら、オレたちがやらせてもらうぜ。レノさんよ	We're gonna help transport the Huge Materia…Reno!	運搬	scene_37
手伝えって？	Help?	手伝	scene_37
断わる……	I refuse…	断	scene_37
オレ様のギャラはち～とばかり高いぜ	You know I don't work cheap!	様高	scene_37
ギリギリ間に合ったってとこね	Looks like we barely made it.	間合	scene_37
アタシ、肉体労働なんかや～だ～	I'm SURE! You want me to do manual labor?	肉体労働	scene_37
俺たちに渡すか、ルーファウスに届けるか……	Either give it to us or else.	俺渡届	scene_37
あいにく、きさまらと遊んでいるヒマはない、と	Unfortunately, I don't have time to deal with you.	遊	scene_37
今はヒュージマテリアが最優先だ、と！	My priority is the Huge Materia!	今最優先	scene_37
し、しまった！　潜水監が！	Damn! The submarine!	潜水監	scene_37
あぁ～あ行ってしもた～……	Oh no! It left the dock…	行	scene_37
チッ！時間かせぎだったのか！？	Damn! So they was just buyin' time!?	時間	scene_37
ヒュージマテリア～！	Huge Materia…! Wait…!		scene_37
は、早く追わないと！	We have to go after it!	早追	scene_37
でも、相手はもう海の中だよ	But it's already in the water!	相手海中	scene_37
手段は……なくもないな……	There is a way…	手段	scene_37
あわてなさんなって！あいつを、ちょうだいしちまおうぜ！	Hold on to your horses! Let's take it from 'em!!		scene_37
お、おのれ……！	Y, you!		scene_37
監はわたさんぞ！	You're not taking over this ship!	監	scene_37
おいおいおい！どこ行こ～ってんだよ！	Hey, hey, hey! Where do you think you're goin'?	行	scene_37
ちょ～っと～！ヒュージマテリアはど～すんのよ～！	Wait a sec! What about the Huge Materia---?		scene_37
ちょっと、あんた！どこいくんや！？	Hey you! Where ya goin'?		scene_37
CLOUDー！ルードを追わなくちゃ！	CLOUD--! We have to go after Rude!	追	scene_37
まさか、ヒュージマテリアをやつらに、わたしちまうんじゃねーだろうな	We ain't jus' gonna let them take the Huge Materia, are we?		scene_37
ヒュージマテリアを追うんじゃないのかい？	Aren't we going after the Huge Materia?	追	scene_37
ジュノン潜水監ドック	Submarine Dock	潜水監	scene_37
神羅のイヌ……！！	Shinra dog!!	神羅	scene_37
無視する	Ignore it	無視	scene_37
イヌ質にする	Dognap it!	質	scene_37
さびしがりやさん！主人のもとにかえるんだな	Feelin' lonely!? Better get back to your master.	主人	scene_37
神羅のイヌめ！！おまえをイヌ質にしてやる！！	Shinra dog!! I'm gonna dognap you!!	神羅質	scene_37
これで戦闘員も手をだせまい…	Those attackers won't bother us now.	戦闘員手	scene_37
潜水監内部	Inside Submarine	潜水監内部	scene_37
はっ！！命だけはおたすけ！！	P…Please!! Spare me!!	命	scene_37
まとめて人質にする	Take them all hostage	人質	scene_37
バトルだな	Fight them		scene_37
感謝しろよ。ほりょにしてやる	Be grateful. I'm taking you prisoner.	感謝	scene_37
あまくみるな	Don't think we're weak.		scene_37
ここまできてもどるわけにはいかないな	We can't go back after coming this far.		scene_37
ありがとうございやす！	Thank you!		scene_37
やさしいでやんすね！	You're pretty nice!		scene_37
潜水監がほしけりゃ力ずくで奪ってみな！	You want the Sub? Just try an' take it!	潜水監力奪	scene_37
ああ……先輩！そんな強気な発言は…	Um…sir! Maybe we shouldn't piss them off…	先輩強気発言	scene_37
いくぞ、CLOUD！オレにつづけ	Come on, CLOUD! Follow me!		scene_37
ケッ！！……なんてな	Damn, man!! …What the?		scene_37
覚えてるか？最初はオレがリーダーでよ！	Hey yo! Remember I was the leader first, man!	覚最初	scene_37
なあ！　あの列車に乗ってからよずいぶん遠くにきたもんだ！	Yo! We come a long ways since we got on this train!	列車乗遠	scene_37
かわっちまったぜ！あれやこれやとよ	Lotsa things changed! This and that.		scene_37
ここから脱出だ！	We're breakin' out of here!	脱出	scene_37
でも……ここ海の底なのよ！	But how? We're at the bottom of the sea!!	海底	scene_37
どうすんだよ！！	Whatcha gonna do!?		scene_37
オイラ、およげないんだけど…	I can't swim…		scene_37
クソッ！どうすんだ！	Damn! What are we gonna do?		scene_37
はやく、でたいよっ！	I wanna get outta here, now!		scene_37
どないすんねんな？	What we gonna do?		scene_37
ここは深海だぞ	We're at the bottom of the sea.	深海	scene_37
ギョライに乗って飛びだす！	We're gonna hop on a torpedo and blast outta here!	乗飛	scene_37
心配するな！ねらいははずさない！	Don't worry! I won't miss!	心配	scene_37
標的はなにもないただの空だからな	We don't even have a target. We're just aiming at the sky.	標的空	scene_37
潜水監・ブリッジ	Submarine Bridge	潜水監	scene_37
こりゃ！！こりゃ、いかん！	NO, NO!! This is terrible!		scene_37
もうあとがないであります！自分は死にたくないであります！	We don't have much time left! I don't want to die!	自分死	scene_37
自分はくいがのこるであります！	There's still so much more I've got to do!	自分	scene_37
一度も実戦でスペシャルポーズやったことないであります！	I never even got to do my special victory dance in battle!	一度実戦	scene_37
うっっし！！この戦いに初勝利し～！！	All right!! Then make this your first victory!!	戦初勝利	scene_37
見せつけちゃれ！！	Go on, show 'em!!	見	scene_37
最後のくんれんはじめ～！！	Remember your last training. Begin!!	最後	scene_37
待たせたなっ！思い残すことはないっ！！	I'm back! An' now I got no regrets!!	待思残	scene_37
だれか、すまない……。俺、もうげんかいなんだ	Someone…please. I'm sorry I can't take it anymore.	俺	scene_37
このせまさ、ゆれ、エンジン音……	The lack of space, the shaking, the roar of the engine…	音	scene_37
ピコピコしやがって！！どうやって動かすんだ？	Stop your blubberin'!! How we gonna move this without you?	動	scene_37
クッソ～イ！オレ様は空飛ばねえとだめなんでぃ！	DAMN! I've GOT to get back in the air!	様空飛	scene_37
オイラの足じゃ動かせないよぅ～	I can't budge it.	足動	scene_37
あたしも、もぅダメ～。あきらめちゃおうよ	I…I can't… I'm history.		scene_37
どうしよう……。潜水監うばっても、動かせない	What are we going to do? We stole a submarine but can't pilot it.	潜水監動	scene_37
いそがねば。レノをとりのがすことになる	Better hurry. Reno's getting away.		scene_37
あかん！シートにすわられへん！	I can't fit in this seat..." No good!		scene_37
ほら！！	See!?		scene_37
てきとうにさわってればなんとかなるよ	Just fiddle with the controls, and we'll get somewhere!		scene_37
ねえ、CLOUD？そうじゅうしてみたら	Hey CLOUD? Why don't you try piloting it?		scene_37
ほら、運転すると酔わないっていうでしょ	They say you don't get motion sickness if you're driving.	運転酔	scene_37
がんばって、CLOUD！	You can do it, CLOUD!		scene_37
んが～！！	Arrrrrrrgh!!		scene_37
おっ！！　いけそうだぜ！このピコピコ！！	EY!! Looks likes we're almost on our way! Just keep on fiddlin' with it!!		scene_37
あとはおまえさんにまかせるぜ！	It's all up to you!		scene_37
心配すんな！	Don't worry!	心配	scene_37
止まっちまったらオレがぶったたいて直すからよ！	If it breaks down, I'll smack it one. That'll fix it!	止直	scene_37
動いたよ！	It moved!	動	scene_37
CLOUD！！やってみてよ	CLOUD!! Try it!		scene_37
こんなもんはこうすりゃ！	Hunka junk…just gotta do this!		scene_37
ほぅれ～見ろぃ！あとはたのんだぜぃ！	SEE! Now you take over!	見	scene_37
オレ様はここで見物してらい！	I'll be watchin' from here!	様見物	scene_37
あっ～！動いちゃった！！	HEY---! It's movin'!	動	scene_37
こりゃ、さいて～！CLOUDっ、なんとかして	Oh man, this sucks!! CLOUD, do something!		scene_37
息止めてるからはやくはやく～	I'll hold my breath, so HURRY!	息止	scene_37
動いたようやなぁ～！CLOUDさん、あとはたのんますわ	It's movin'--- Keep it up, CLOUD!	動	scene_37
CLOUDさん安全運転してや～	Oh please drive safely, CLOUD!	安全運転	scene_37
どうやら、動きはじめたようだな。私は機械に弱い	I'm not very mechanical, but it seems like we're starting to move.	動私機械弱	scene_37
よろしくたのんだぞ	Hang in there.		scene_37
神羅の技術はたいしたものだな	Shinra's technology is really something.	神羅技術	scene_37
そうだな……動かしてるほうが気がまぎれる	Hey, you're right… I DO feel a little better driving.	動気	scene_37
ここは俺にまかせてくれ	No sweat. Just leave everything to me.	俺	scene_37
さて、どうするか？	Well, now what?		scene_37
操作説明を見る	Read the manual	操作説明見	scene_37
席にすわる	Sit in the seat	席	scene_37
準備は完了だな……	Everything seems set…	準備完了	scene_37
ミッション開始！！	Start the mission!	開始	scene_37
このスイッチか…？	This switch?		scene_37
『メインビューアー・スクリーンオン』	Main screen: ON		scene_37
画面モードを切り替えます。	Change the screen mode.	画面切替	scene_37
『潜水監の操作マニュアル・初心者編』	Submarine Operation Manual - Beginner's Edition	潜水監操作初心者編	scene_37
『ボタン配置』	Button Placements	配置	scene_37
【ボタン】	Controls		scene_37
△：前進（シフトアップ）	[MENU]: Speed Up	前進	scene_37
□：ギョライ発射！	[SWITCH]: Fire!	発射	scene_37
×：後退（シフトダウン）	[CANCEL]: Speed Dn	後退	scene_37
【方向キー】	Directional controls	方向	scene_37
上：下降	Up: Descend	上下降	scene_37
左：左旋回　　　　右：右旋回	Left: Left rotation Right: Right rotation	左旋回右	scene_37
下：上昇	Down: Ascend	下上昇	scene_37
『ミッション指令』	Mission Orders	指令	scene_37
現在、ジュノン海底には、ヒュージマテリアを積んだ赤いボス潜水監を護衛するため神羅海軍潜水監隊が潜行している模様。	Presently on the ocean floor near Junon, a Red Leader Submarine carrying Huge Materia is being escorted by covert Shinra Submarine Units.	現在海底積赤潜水監護衛神羅軍隊行模様	scene_37
また、海底には機雷が多数配置されていることを確認。	Furthermore, it has been confirmed that several mines have been dispersed onto the ocean floor.	海底機雷多数配置確認	scene_37
海底の様子は、神羅特製ソナーレーダー画面を 通じてしか知ることはできない。	The ocean floor can only be monitored with Shinra's Sonar Radar Screen.	海底様子神羅特製画面通知	scene_37
潜行している敵潜水監は、ソナーはんい内に とらえないかぎり、認識不可能だ。	Enemy subs can only be detected within the Sonar area.	潜行敵水監内認識不可能	scene_37
発見した敵潜水監を正面にとらえ【ロックオン！】 	Get in front of the detected enemy sub and "Lock On"!!	発見敵潜水監正面	scene_37
□ボタンでギョライを撃ちこめ！ レーダー画面上、のびちぢみする光の柱の上に 表示されるのが、機雷だ。	Push [SWITCH] to fire the torpedo! The mines are found on the radar screen at the top of the indicators.	撃画面上光柱表示機雷	scene_37
機雷への接触は大きなダメージとなるので注意！	The mines inflict great damage, so be careful!	機雷接触大注意	scene_37
『クリア条件』	Objective	条件	scene_37
ヒュージマテリアを積んだ赤いボス潜水監の撃破！	Sink the Red Leader Submarine carrying the Huge Materia!	積赤潜水監撃破	scene_37
タイムリミットは、１０分！	Time Limit: 10 minutes!	分	scene_37
『ワンポイントアドバイス』	Advice		scene_37
１．敵潜水監を正面にとらえよ！	1. Get the enemy submarine in front of you!	敵潜水監正面	scene_37
２．ロックオンマークが赤く点滅したらギョライ発射！	2. When the lock-on marker flashes red, launch torpedos!	赤点滅発射	scene_37
３．赤いボス潜水監を集中攻撃せよ！	3. Concentrate attack on the Red Leader Submarine!	赤潜水監集中攻撃	scene_37
４．敵を見失ったらＲ１ボタンの全体レーダーで探索！	4. If you lose track of the enemy, push [PAGEDOWN] and use your radar!	敵見失全体探索	scene_37
『潜水監の操作マニュアル・中級者編』	Submarine Operation Manual - Intermediate Edition	潜水監操作中級者編	scene_37
『レーダー画面の見方』	Radar Screen	画面見方	scene_37
レーダー画面上、のびちぢみする光の柱は柱の上に機雷がひそんでいることをあらわしている。	The mines are found at the top of the indicators on the screen.	画面上光柱機雷	scene_37
柱をさけつつ、敵潜水監を背後からとらえ確実にロックオンするのが基本戦術となる。	The basic strategies are to 1) avoid the indicators, and 2) "Lock On" to enemies from behind.	柱敵潜水監背後確実基本戦術	scene_37
画面下のよこゲージは潜水監の耐久力をしめす。	The lower gauge shows the sub's remaining power.	画面下潜水監耐久力	scene_37
画面右のたてゲージは潜水監のスピード。	The right gauge shows the sub's speed.	画面右潜水監	scene_37
その他、各種警告の意味は以下の通り……	Other warnings are as follows…	他各種警告意味以下通	scene_37
ＷＡＲＮＩＮＧ…近くに敵潜水監発見！	WARNING…Enemy submarine detected nearby!	近敵潜水監発見	scene_37
ＡＬＥＲＴ…接近するギョライ発見！	ALERT…Approaching torpedo detected!	接近発見	scene_37
ＭＩＮＥ…近くに機雷発見！	MINE…Mine detected nearby!	近機雷発見	scene_37
ＣＯＮＦＬＩＣＴ…海底に衝突（バックまたは転回せよ）	CONFLICT…Collision with the ocean floor!	海底衝突転回	scene_37
『ギョライの装填』	Loading torpedoes	装填	scene_37
ギョライは一発撃つと次の発射までに 時間がかかる。	Preparation time is needed before the next torpedo can be fired.	一発撃次射時間	scene_37
むだ撃ちはせず、確実にねらっていけ！	Take your time, and don't waste your shots!	撃確実	scene_37
『潜水監の操作マニュアル・マスター編』	Submarine Operation Manual - Advanced Edition	潜水監操作編	scene_37
『ロックオンのはずしかた』	How to release the "Lock On" mode		scene_37
ソナーはんい内にとらえた潜水監を画面中心部からはずすとロックオンがリセットされる。	If the sub leaves the center of the sonar screen, the "Lock On" mode will reset.	内潜水監画面中心部	scene_37
『ＬＲボタン／スタートボタン』	Other Controls		scene_37
Ｌ１：水和上昇	[PAGEUP]: Climb	水和上昇	scene_37
Ｒ１：全体レーダーサイト	[PAGEDOWN]: Sight	全体	scene_37
Ｌ２：水和下降	[CAMERA]: Dive	水和下降	scene_37
Ｒ２：視点切りかえ	[TARGET]: View	視点切	scene_37
スタートボタン：キー操作ヘルプ＆ＰＡＵＳＥ	[START]: Help & Pause	操作	scene_37
『敵のギョライに追われたとき』	When Locked On by an enemy torpedo	敵追	scene_37
最高速までシフトアップし、△ボタンを押し続ければさらに限界値までスピードアップ！ギョライをかわすことが可能！	Shift up to maximum speed by pressing [MENU] repeatedly. This will enable you to speed up past the maximum speed and outrun the torpedo!	最高速押続限界値可能	scene_37
……以上。では、健闘をいのる！	…That is all.	以上健闘	scene_37
『とりあえず……』	I guess…		scene_37
ミニゲーム勝利	Victorious in Mini-game	勝利	scene_37
ミニゲーム敗北	Defeat in Mini-game	敗北	scene_37
ふぅ～！　やったな！！	Phew! We did it!!		scene_37
ヒュージマテリアは海底に沈んだはずだ。このまま、探索を続けるか…	The Huge Materia should be at the bottom of the sea by now. Let's continue the search…	海底沈探索続	scene_37
『……神羅潜水監部隊全機、応答せよ……』	…All Shinra Submarine Units, do you read…?	神羅潜水監部隊全機応答	scene_37
ん……？……神羅の通信か	Hmm…? …Must be from Shinra.	神羅通信	scene_37
『……どうした、２号機応答せよ……』	…Report, No. 2…	号機応答	scene_37
２号機……	No. 2…	号機	scene_37
……通路に書いてあった！この潜水監のことよ	…I saw that written at the dock! They must mean this sub.	通路書潜水監	scene_37
オレたちじゃねえのか？	Is it us?		scene_37
オイラたちだよ、２号機って	We're Submarine No. 2	号機	scene_37
うっせいってんだ！適当に返事しろぃ！	Make 'em shut up! Just answer somethin'!	適当返事	scene_37
ゲロゲロ……！あたしたちのことだよぉ	Oh my god! They mean us.		scene_37
応答するしかないやろ！	We need to respond!	応答	scene_37
こたえるしかあるまい	We've no choice but to respond.		scene_37
わかった、やってみる	All right, I'll do it.		scene_37
こちら神羅２号機……。異常なし	This is Shinra No. 2… Everything's normal.	神羅号機異常	scene_37
『……了解』	…Roger…	了解	scene_37
『………次のミッションを伝える……』	…Your next mission is…	次伝	scene_37
『……すみやかにジュノンドックに帰航せよ……』	…Return to Junon Dock…	帰航	scene_37
『…ヒュージマテリアをエアポートより搬出する…』	…We will transport the Huge Materia from the airport…	搬出	scene_37
『……作業のないものは警備にあたること……』	…Those without other assignments will report for guard duty…	作業警備	scene_37
『……以上、通信終了……』	That is all. Over and out…	以上通信終了	scene_37
【ジュノンエアポート】…。急げばまにあうか	Junon Airport… We should make it if we hurry.	急	scene_37
海底のヒュージマテリアはあとまわしだ	Forget about the Huge Materia for now.	海底	scene_37
浮上するぞ！	We're climbing!	浮上	scene_37
はいはい……監長さん！	Aye, aye… CAPTAIN!	監長	scene_37
チッ！　なにが浮上だっ！調子のいい野郎だぜ！	#%$@! What's all this 'Climbing!' crap? Gimme a break!	浮上調子野郎	scene_37
発進～！	Take o-ff!	発進	scene_37
エアポートだろっ！まかせときぃ！	The airport? No sweat!		scene_37
浮上……みみみみ耳がツーン…おろして～もうだめえ～	Climbing…arrrgh…my ears…! LET ME OUT--I HATE THIS!	浮上耳	scene_37
ほんな、急ぎましょ！	We gotta hurry!	急	scene_37
海から空か…いそがしいな	First the ocean, now the air… What a busy day.	海空	scene_37
『神羅の最新潜水監』を手にいれた！	Received "Shinra Sub"!	神羅最新潜水監手	scene_37
……負けてしまった。俺にはむいてないようだ	…We lost. I guess I'm just not cut out for all this.	負俺	scene_37
脱出するぞ！	We're gettin' outta here!	脱出	scene_37
聞いたか？【ジュノンエアポート】！	Hear that? Junon Airport!	聞	scene_37
ヒュージマテリアを取り返せる！急ぐぞ！	We can still get the Huge Materia back! Let's hurry!	取返急	scene_37
どこかのカギみたいだ……	It seems like a key to somewhere…		scene_37
これがそうなのか……	Do you think it's…?		scene_37
おそろしく古いな	It seems really old.	古	scene_37
『……分析結果……』	…Analysis completed…	分析結果	scene_37
『……取得物の生成年代は特定不能……』	…Exact date of origin: undetermined…	取得物生成年代特定不能	scene_37
『……数千年前のものと判別……』	…Estimated to be several thousand years old…	数千年前判別	scene_37
古代種の鍵……	Key of the Ancients…	古代種鍵	scene_37
数千年…………古代種？	Several thousand years… ……Ancients?	数千年古代種	scene_37
キーアイテム『古代種の鍵』を手にいれた！	Received Key Item "Key to Ancients"!	古代種鍵手	scene_37
これが俺たちの撃沈したボス潜水監か……	So this is the Leader Sub…	俺撃沈潜水監	scene_37
ウップ…………思い出したら気持ちが悪くなってきた	Damn…makes me sick just thinking about it…	思出気持悪	scene_37
『……ヒュージマテリア回収完了……』	…Huge Materia recovered…	回収完了	scene_37
『……損傷はない模様……』	…No damage appears to have been sustained…	損傷模様	scene_37
……ふぅ……。ひとまず、よかったな	…phew… That's good to hear.		scene_37
バトル	Fight them		scene_37
ほりょにしとく	Take them prisoner		scene_37
潜水監の操作はむずかしいでありますよ！自分はチンプンカンプンであります！	Piloting a submarine is very difficult! I am completely clueless!	潜水監操作自分	scene_37
ありがとであります！ほりょにしてくれて自分はしあわせであります！	I thank you! I am happy to be a hostage!	自分	scene_37
こりゃ！き、きやすく話かけんな！	Hey! Who am I to know?	話	scene_37
無条件こうふくというやつだな	An unconditional surrender, huh?	無条件	scene_37
人質だな	We're your prisoners	人質	scene_37
あまいな…	Don't bet on it…		scene_37
めだたない場所へうつしておくぞ	We'll hide it somewhere secluded.	場所	scene_37
神羅飛空艇・通路	Hallway	神羅飛空艇通路	scene_37
神羅飛空艇・研究室	Research Room	神羅飛空艇研究室	scene_37
神羅飛空艇・カーゴルーム	Cargo Room	神羅飛空艇	scene_37
『ハーデス』のマテリアを手にいれた！	Received "Hades" Materia!	手	scene_37
『アウトサイダー』を手にいれた！	Received "Outsider"!	手	scene_37
『エスコードガード』を手にいれた！	Received "Escort Guard"!	手	scene_37
『天の叢雲』を手にいれた！	Received "Heaven's Cloud"!	天叢雲手	scene_37
『不倶戴天』を手にいれた！	Received "Conformer"!	不倶戴天手	scene_37
『ロンギヌス』を手にいれた！	Received "Spirit Lance"!	手	scene_37
『れんぞくぎり』のマテリアを手にいれた！	Received "Double Cut" Materia!	手	scene_37
『ハイウインド』を手にいれた！	Received "Highwind"!	手	scene_37
これは、神羅のゲルニカ型飛空艇……なぜこんなところに沈んでいるんだ？	This is the Shinra's Gelnika type airplane… I wonder why it went down here?	神羅型飛空艇沈	scene_37
なんだ、ここは……魔晄ジェネレータがあるという事はなにかの研究施設なのか？	What is this place? Must be some kind of a Research Establishment because there's a Mako generator.	魔晄事研究施設	scene_37
ひどいな……メチャメチャだ	This is terrible… It's all messed up…		scene_37
ここはカーゴルームか……	This must be the Cargo Room…		scene_37
……またか	Again?		scene_37
どうも最近いろいろと縁があるな、と	We just seem to keep running into each other lately!	最近縁	scene_37
この飛空艇には、セフィロスに対抗するために開発された武器やマテリアが積んであった	There were weapons and Materia developed solely to destroy Sephiroth.	飛空艇対抗開発武器積	scene_37
……しかし、ウェポンに襲われて海の底に沈んでしまった	But, it was attacked by Weapon and sunk to the bottom of the sea.	襲海底沈	scene_37
ここにあるものは渡せない。セフィロスは、我々が倒す	I can't give you what's here. We'll take out Sephiroth.	渡我倒	scene_37
ゆえに、おまえたちとはここで永遠のお別れになる、と	I guess this is our last meeting.	永遠別	scene_37
邪魔は、させない	I won't let you get in our way.	邪魔	scene_37
この飛空艇には、神羅の新兵器が積んであったのか……	So Shinra's new, secret weapon was on this Airship…	飛空艇神羅新兵器積	scene_37
セフィロス…	Sephiroth…		scene_37
VINCENT……	VINCENT…		scene_37
！！！	!!!		scene_37
この声は！？　まさか…	That voice? It can't be…	声	scene_37
ルクレッツィア…なのか…？	Lucrecia?		scene_37
VINCENT……？	VINCENT?		scene_37
ルクレッツィア！！	Lucrecia!!		scene_37
ルクレッツィア	Lucrecia		scene_37
こないで！！！	Stay back!!		scene_37
ルクレッツィア…生きていたのか…	Lucrecia… You're alive…	生	scene_37
消えてしまいたかった…みんなのそばにいられなかった…死にたかった……	I wanted to disappear… I couldn't be with anyone… I wanted to die…	消死	scene_37
でも、私の中のジェノバが私を死なせてくれない……	But the Jenova inside me wouldn't let me die…	私中死	scene_37
最近、セフィロスの夢を見るの…私のかわいい子供……	Lately, I dream a lot of Sephiroth… My dear, dear child.	最近夢見私子供	scene_37
でも、あの子が生まれてから私は一度も抱いてない……	Ever since he was born I never got to hold him…	子生私一度抱	scene_37
子供も抱けない…、母親だと言う事もできない……それが、私の罪………	Not even once. You can't call me his mother… That…is my sin…	子供抱母親言事私罪	scene_37
ルクレッツィア…	Lucrecia…		scene_37
ダメ！！きちゃダメ！	Back!! Stay back!		scene_37
VINCENT…教えて？	VINCENT… Won't you please tell me?	教	scene_37
セフィロス…あの子は生きているの？	If Sephiroth is still alive?	子生	scene_37
５年前に死んだと聞いたわでも、最近よく夢を見るの…	I heard that he died five years ago. But I see him in my dreams so often…	年前死聞最近夢見	scene_37
それに、あの子も私と同じ簡単に死ねない体……	And I know that physically, like myself, he can't die so easily.	子私同簡単死体	scene_37
ねぇ、VINCENTあの子は……	Please, VINCENT tell me…	子	scene_37
セフィロスは……死んでしまったよルクレッツィア…	Lucrecia… Sephiroth is dead…	死	scene_37
『デスペナルティ』を手にいれた…	Received "Death Penalty"!	手	scene_37
『カオス』を手にいれた…	Received "Chaos"!	手	scene_37
ルクレッツィア……	Lucrecia…		scene_37
彼女が、幸せなら私は… かまわない……	If she is happy then… I don't mind.	彼女幸私	scene_37
しばらくした後 ルクレッツィアに赤ん坊が 生まれる…	After that, a child was born to Lucrecia… 	後赤坊生	scene_37
赤ん坊の名は… セフィロス……	That child's name was… Sephiroth…	赤坊名	scene_37
そんな人体実験をなぜ！	I'm against it!! Why experiment on humans!?	人体実験	scene_37
私も、彼女も科学者だ！！	She and I are both scientists!!	私彼女科学者	scene_37
うわああああーーーーー！！！	Urrrrrrrrgh!!		scene_37
この身体は……私に与えられた罰……	This body is… the punishment that's been given to me…	身体私与罰	scene_37
私は……ガスト博士や宝条……	I was unable… to stop Professor Gast and Hojo…	私博士宝条	scene_37
そして、ルクレッツィアを止める事が出来なかった……	And Lucrecia…I was unable to stop them…	止事出来	scene_37
見ていることしか出来なかった……それが、私の罪……	All that I was able to do was watch… That is my punishment…	見出来私罪	scene_37