お！　あったあった	Oh, here!!		scene_41
これに着替えろよ	Put this on.	着替	scene_41
ちょっとにおうけど　ま、ぜいたくは言うな	It smells a little, but don't complain.	言	scene_41
けっこう似合ってるぞ	You look pretty good with that.	似合	scene_41
おい！　おっさん！　ミッドガルはまだか？	Yo! Old guy! We at Midgar yet?		scene_41
うるさい！乗せてやっただけでもありがたく思え！	Shaddap! You're lucky I even gave you a ride!	乗思	scene_41
チッ…	Hah!		scene_41
なあ、ミッドガルに着いたらおまえ、どうする？	What're you gonna do once we get to Midgar?	着	scene_41
俺はあちこちにあてがあるんだ	I know what I'm gonna do.	俺	scene_41
みんなの世話んなって……	I got a place I can crash for a while…	世話	scene_41
あ、どの女の子も親といっしょに住んでるのか……	No wait, the mother lives there too.	女子親住	scene_41
そりゃマズいよな～あ？	Guess that's out.		scene_41
ダメだ…作戦チェンジ！	Yep…gotta change my plans!	作戦	scene_41
う～ん……New	Hmm…		scene_41
何をどうするにしてもとりあえず金だよな……	No matter what I do, I need some money first…	何金	scene_41
……商売でもはじめるか	…Hey, wanna start a business? Now what could we do?	商売	scene_41
な、Cloud。	Hey, CLOUD.		scene_41
俺にできる商売ってあると思うか？	Think there's anything I'd be good at?	俺商売思	scene_41
なあ、おっさん！	Hey old guy!		scene_41
なんか俺にできるような商売知らないか？	What do you think I'd be good at?	俺商売知	scene_41
なに言ってんだ。若いんだろ？	What're you yappin' about? You're still young ain't ya?	言若	scene_41
何でもやってみろ！若いうちは何でもやってみるもんだ	Young folks should try everything!	何若	scene_41
若いうちにいろいろ苦労してなぁ。自分の道ってやつを探すのよ	You gotta pay your dues while you're young. Go out and look for what you really want.	若苦労自分道探	scene_41
……なんでもやってみろ？	Yeah, whatever…		scene_41
……自分の道だぁ？	Find my own way?	自分道	scene_41
なんでも、だってよ。そんなこと言われたってな…	Try everything… That's easy for him to say.	言	scene_41
そうだよな！New	Of course!		scene_41
俺は他のやつらが持ってない知識や技術をたくさん持ってるんだよな！	I got more brains and skill than most other guys!	俺他持知識技術	scene_41
俺、決めたぞ！	That settles it!	俺決	scene_41
俺は『なんでも屋』を	I'm gonna become a mercenary!	俺屋	scene_41
あんた…オレの話、ちゃんと聞いてたのか？	Hey…didn't you even hear a word I said?	話聞	scene_41
おう！ありがとよ、おっさん！	Yeah! Thanks Pops!		scene_41
だから…そうじゃなくて	No, wait…you got it all wrong.		scene_41
おい、俺はなんでも屋になるぜ	Listen, I'm gonna become a mercenary and that's that.	俺屋	scene_41
面倒なこと、危険なこと報酬しだいでなんでもやるんだ	Boring stuff, dangerous stuff, anything for money.	面倒危険報酬	scene_41
こりゃ、もうかるぞ～	I'm gonna be rich!		scene_41
な、Cloud。おまえはどうする？	So, CLOUD? What are YOU gonna do?		scene_41
う…ぁぁあ…	U…uhhh…		scene_41
……冗談だよおまえを放り出したりはしないよ	Just kidding… I won't leave you hanging like that.	冗談放出	scene_41
……トモダチ、だろ？	We're friends, right?		scene_41
はははは……照れるぜ	Mercenaries. CLOUD. That's what you an' me are gonna be.	照	scene_41
なんでも屋だ、Cloud。俺たちはなんでも屋をやるんだ	Mercenaries. CLOUD. That's what you an' me are gonna be.	屋俺	scene_41
わかるか、Cloud？	Understand, CLOUD?		scene_41
こいつ、どうします？	What do you want to do with him?		scene_41
ああ……うあぁぁぁ……	…Ah…ughhhh…		scene_41
指揮官	Commander	指揮官	scene_41
……これはダメだな。放っておけ	Forget it. Just leave him.	放	scene_41
うぅ……あぁああ……ザ……ザッ……クス	uh…uhhh…Za…Zack…		scene_41