How are the preparations going?	準備のほうは？	scene_06
Heidegger	ハイデッカー	scene_06
Gya, haa, haa!!  Smoothly, very smoothly! I assigned the Turks to this.	ガハハ！！　順調順調！実行部隊はタークスです	scene_06
Reeve	リーブ	scene_06
President!! Are we really going to do this? Simply destroy a group with only a few members…	プレジデント！本当にやるのですか？たかだか数人の組織をつぶすのに……	scene_06
What's the problem, Reeve? You want out?	いまさらナニかね、リーブ君	scene_06
…No.	……いいえ	scene_06
But, as head of the Urban Development Department, I have been involved in the building and running of Midgar. That's why…	しかし、私は都市開発責任者としてミッドガルの建造、運営のすべてにかかわってきました。ですから……	scene_06
Reeve, flush your personal problems with the rest of your crap!	リーブ、そういう個人的な間題は朝のうちにトイレで流しちまうんだな！	scene_06
The Mayor's against this anyway…	市長も反対しているわけであり……	scene_06
Mayor?	市長！？	scene_06
He just sits in this building all day feeding his face! You still call that a Mayor?	このビルの中でボソボソとメシをくってるあいつか！？あいつを、まだ市長と呼ぶのか？	scene_06
Now if you'll excuse me sir!	それでは失礼します！	scene_06
You're tired. Why don't you take a couple of days off and go somewhere.	君はつかれているんだよ。休暇をとって旅行でも行ってなさい	scene_06
We'll destroy Sector 7 and report that AVALANCHE did it. Then we'll send in the rescue operation, care of Shinra, Inc…. Heh, heh, heh…this is perfect.	７番街を破壊する。アバランチの仕業として報道する。神羅カンパニーによる救助活動。フフフ……かんぺきだ	scene_06
Gya, haaa, haa!	ガハハハ！	scene_06
Sewer	地下下水道	scene_06
Man! This is terrible.	もう！サイテーね、これ	scene_06
Yeah.	うん	scene_06
Well, the worst is over…	ま、最悪の事態からはのがれられた……	scene_06
Maybe not…	……でもないみたい	scene_06
Let's try and jump down	飛び降りてみよう	scene_06
Let's not…	やめるか……	scene_06
It's too late… Marlene…BARRET …the people of the Slums.	もうダメだわ……マリン……BARRET……スラムの人たち	scene_06
Don't give up, never give up hope. It's not easy to destroy the pillar, right?	あきらめない、あきらめない。柱、壊すなんてそんなに簡単じゃない、でしょ？	scene_06
…Yeah…you're right! We still have time.	…………そうね……そうよね！まだ時間はあるわよね	scene_06
Train Graveyard	列車基場	scene_06
AERIS, I got you mixed up in this…	AERIS。すっかり巻きこんでしまって……	scene_06
Don't tell me to go home.	ここから帰れ！な～んて言わないでね	scene_06
If we can just get past the trains that are lit up, we should be able to get out of here.	え～と……明かりのついている車両を抜けて行けば出られそうね	scene_06
Received "Hi-Potion"!	『ハイポーション』を手にいれた！	scene_06
Received "Potion"!	『ポーション』を手にいれた！	scene_06
Received "Echo Screen"!	『やまびこえんまく』を手にいれた！	scene_06
We made it! The pillar's standing!	まにあった！柱が立ってる！	scene_06
Wait! You hear something above us?	まて！上から……聞こえないか？	scene_06
…gun fire?	……銃声？	scene_06
BARRET?	BARRETか！？	scene_06
I'm going up!	のぼるぞ！	scene_06
AERIS! You look after Wedge.	AERIS！ウェッジをたのむ	scene_06
AERIS, do me a favor.	AERIS、おねがい	scene_06
I have a bar called '7th Heaven' in this neighborhood.	この近くに私たちの店『セブンスヘブン』があるの	scene_06
There's a little girl named Marlene there.	そこにマリンっていう名前の小さな女の子がいるから……	scene_06
Don't worry. I'll put her somewhere safe.	わかった。安全な場所へ、ね	scene_06
It's dangerous here! Everyone get away from the pillar, quickly!	ここは危険です！みんな早く柱からはなれて！	scene_06
Everyone get out of Sector 7!	７番街から離れて！	scene_06
Wedge!! You all right!?	だいじょうぶか？……ウェッジ！！	scene_06
…CLOUD. You remembered…my name.	……CLOUDさん…。俺の名前…覚えてくれたっすね	scene_06
BARRET's up top. …Help him…	BARRETさんが…上で戦ってるっす。手をかしてやって……	scene_06
An' CLOUD… Sorry, I wasn't any help.	CLOUDさん……めいわくかけて、すいません…っす	scene_06
CLOUD… It hurts…	CLOUDさん……い、痛いです……	scene_06
CLOUD!! You've gotta go now, or BARRET's…	CLOUD！！早くしなきゃ、BARRETが…	scene_06
Hey now!! Oops!!	おっ！！おっおっと！！	scene_06
What on earth are you doing? Just butt out…geez!	ああ、なんてことを！！じゃましないでくれよ……ったく！	scene_06
Huh? You came to see it, too?	ん？あんたも見にきたのか？	scene_06
There was a bombing on top. If this pillar should come down, everyone in the slums is dust…	上で爆弾テロがあったんだってよ。この柱がぶっとんだら、このスラムも終わりだからな……	scene_06
Well, there's no point in worryin' about that.	まあ、心配するだけむだだったな	scene_06
Hey!! Check it out! It's huge, ain't it?	なぁ！！見てみろよ。いつ見ても、どでかい柱だなぁ	scene_06
Hey… This is a strange and wonderful place.	ほら……。なんだか、素敵で不思議な場所だろ	scene_06
This is my place, but you can come here when you want. See ya, bro!	オレの場所だが、たまには見にきてもいいぞ。じゃな！！　きょうだい！	scene_06
Ah…eh…uhm. Excuse me. You cannot pass without the proper clearance.	あ、あ、あの……すいません。ここから先は、立入禁止なんですが	scene_06
Did I do good this time?	こ、こんな感じでいいでしょうか？先輩	scene_06
You gotta be tougher!	もっと、どうどうとせんか！	scene_06
But, uh, I…	え、で、でも……	scene_06
W, wow! You're great!!	さ、さすが、先輩！！	scene_06
Damn right!! Don't waste time talkin's what I always say!	おう！！むだぐちたたくんじゃねえ！	scene_06
What the hell do you want? You know who I am?	きさま、何の用だ？この俺が何者か、知らんわけないだろう？	scene_06
You can't pass. I got the miserable job of keepin' scum like you from trying to sneak in here.	ここから先は立ち入り禁止だ。俺はここでおまえみたいな浮浪者をおっぱらうケチな仕事をしてるもんだ	scene_06
If you understand, then scram!	わかったら、さっさとうせろ！！	scene_06
Listen… My partner's pretty mean, I wouldn't get him mad, if I were you.	あ、あの……となりの先輩、こわいからさからわない方がいいと思いますよ	scene_06
You know, I got some tickets to 'Loveless', do you want to go?	先輩！！ＬＯＶＥＬＥＳＳのチケット取れたんですけどいっしょにいきません？	scene_06
What're you, retarded? Midgar's under martial law now!	やめとけ！ミッドガルは非常警戒体制に入ってる	scene_06
Sir, are you really concerned for me?	あっ、先輩！僕のこと、心配してくれてるんですか！	scene_06
Hell no!! But in case you forgot, we're in the middle of a slum. They could be anywhere around, so stay on your guard.	そんなんじゃねえ！！テロリストはスラムにひそんでる。俺たちだって、気をぬけねぇ	scene_06
Right. You mean the AVALANCHE?	ああ、アバランチですか？	scene_06
Don't you worry. SOLDIER has been added to the police force.	大丈夫ですよ。なんてったってソルジャーが警備に導入されたんですから	scene_06
Boy, it's been a while since SOLDIER's been mobilized, hasn't it?	ソルジャーの出動かぁ、久しぶりですよね。ねえ、先輩	scene_06
I ever tell you that I flunked the SOLDIER entrance exam?	僕、ソルジャーの試験落っこちちゃったんですよ。この話、しましたっけ？	scene_06
Damn right!! blahblahblah…	おう！！ペラペラペラペラ……	scene_06
Hey shut up for a minute and let me get back to work!	すこしはだまって、仕事できねえのか！	scene_06
…sigh.	……しゅん	scene_06
What are you more scared of AVALANCHE or me?	アバランチと先輩……どっちがこわいんだろ？	scene_06
Oh, you, of course.	きっと、先輩だな	scene_06
HALT!! No one is allowed to pass!!	おう！！ここから先は立入禁止だ！！	scene_06
Don't worry. You let me handle this.	だいじょうぶ。ここはまかせて	scene_06
Uh oh… There goes the pillar.	オロオロ…柱壊れちゃうんですか	scene_06
I'm scared, but it's for your own good.	こわいんですけどあんたたちのためにね	scene_06
If things get too hairy, we'll escape. It's not something you'll see happen too often.	ほんとにやばくなったら逃げだしますから。めったに見れるもんじゃないですし	scene_06
Uhh…Help! My strange and wonderful little place.	ウウッ……守ってくれよ。俺の素敵で不思議な場所	scene_06
L, look… This is my job, so I have to be here until the absolute last minute.	あ、あの……これが、僕の仕事だから…ギリギリまでここにいないとならないんだ	scene_06
Umm… I just LOVE men with a sense of duty. Let me stay here with you.	うん…責任感の強いあなた、好きよ。私、そばについてるわ	scene_06
B, but… What happens if AVALANCHE shows up?	あ、あの……アバランチの人たちだいじょうぶかな？	scene_06
Umm…you're shaking. You're so gentle…I think I'm in love.	うん…あなた、ふるえてるのね？やさしい人…好きよ	scene_06
Doh! And this was supposed to be my last job! Do something!!	おう！　これが俺の最後の仕事だ！登ってけ！！	scene_06
I never thought this would ever happen to me! Great… I'm quitting tomorrow!	こんなことになるなんてな！いい気分じゃねえ！明日、じひょうだ！	scene_06
…CLOUD… I'm glad……I could talk with you…one last time.	あ……CLOUD……最後に……話せて良かった……	scene_06
Don't say 'last'……	最後だなんて……	scene_06
That's…all right…	もう、いい……いいの……	scene_06
Because…of our actions…many……people died…… this probably……is our punishment…	私たち……私たちの作戦でたくさん……人、死んじゃったし……きっと……そのむくい……ね	scene_06
…Is…that so……?	……そうか……ですって……？	scene_06
Ha……cool……as usual… ex-…SOLDIER. …always…I liked that…in you…	フフ…………相変わらず……クールな……元ソルジャーさん。……そこが……いいんだけどね……	scene_06
CLOUD… so you don't care…what happens… to the…Planet?	CLOUD ……やっぱり……星の命なんて……どうなろうと……興味ないか？	scene_06
Nope, not interested	悪いけど興味ない	scene_06
You're wounded……	それよりケガが……	scene_06
Hmph…you haven't changed. Oh, forget it.	へっ……変わんええな。まあ……いいや。	scene_06
Thanks, CLOUD. …don't worry 'bout me…… BARRET's…fighting up there. Go help him…	ありがとよ、CLOUDでも……おれわいいから……BARRETが……上で戦っている。手をかしてやってくれ……	scene_06
TIFA! CLOUD! You came!	TIFA！　CLOUD！ 来てくれたか！	scene_06
Be careful! They're attacking from the helicopter.	気をつけろ！　やつら ヘリで襲ってきやがる	scene_06
Better equip ourselves before they attack in full force!	本格的にくる敵に 装備を整えておいたほうがいいわ！さっそく来たわ！	scene_06
Press the (MENU) button to access the Menu.	【メニューボタン】でメニューをひらく	scene_06
Press the (OK)button when finished.	【決定ボタン】で終了	scene_06
Press the (CANCEL) button for Change Party.	【カンセルボタン】Change Partyをはずす	scene_06
Here they come!	さっそく来だわ！	scene_06
You're too late. Once I push this button…	おそかった、とこのスイッチを押すと……	scene_06
That's all, folks! Mission accomplished.	はい、おしまい！　作業終了	scene_06
DAMN! It's a time bomb!	“くっ！時間爆弾か！	scene_06
We have to disarm it! CLOUD! BARRET! Please!	解除しなくちゃ！ CLOUD！　BARRET！　おねがい！	scene_06
I can't have you do that. No one get in the way of Reno and the Turks…	そういうわけにはいかないぞ、と タークスのレノさまの邪魔は 誰にもさせないぞっ……と	scene_06
CLOUD! I don't know how to stop this. Try it!	CLOUD！ 止めかたがわからないの。やってみて！	scene_06
…It's not a normal time bomb.	……ただの時限爆弾じゃない	scene_06
Tseng	ツォン	scene_06
That's right. You'll have a hard time disarming that one.	そのとおり。それを操作するのは難しい	scene_06
It'll blow the second some stupid jerk touches it.	どこかのバカ者が勝手にふれると困るからな”	scene_06
Please, stop it!	おねがい、とめて！	scene_06
Ha ha ha……	クックックッ……	scene_06
Only a Shinra Executive can set up or disarm the Emergency Plate Release System.	緊急用プレート解除システムの設定と解除は神羅役員会の決定なしではできないのだ	scene_06
Shut yer hole!	ゴチャゴチャうるせえ！	scene_06
I wouldn't try that…… You just might make me injure our special guest.	そんなことされると大切なゲストがケガするじゃないか	scene_06
Oh, you know each other?	おや、知り合いなのか？	scene_06
How nice you could see each other one last time. You should thank me.	最後に会えて良かったな。私に感謝してくれ	scene_06
What are you gonna do with AERIS!?	AERISをどうする気だ	scene_06
I haven't decided.	さあな	scene_06
Our orders were to find and catch the last remaining Ancient.	われわれタークスにあたえられた命令は『古代種』の生き残りをつかまえろ、ということだけだ	scene_06
It's taken us a long time, but now I can finally report this to the President.	ずいぶんと長い時間がかかったがやっとプレジデントに報告できる	scene_06
TIFA, don't worry! She's all right!	TIFA、だいじょうぶだから！あの子、だいじょうぶだから！	scene_06
Hurry and get out!	だからはやく逃げて！	scene_06
Ha, ha, ha… Well, it should be starting right about now. Think you can escape in time?	クックックッ！そろそろ始まるぞ。逃げきれるかな？	scene_06
We're not going to make it!	???	scene_06
Yo, we can use this wire to get out!	おい、このワイヤーを使って 脱出できるぜ！	scene_06
Once that Plate starts coming down it'll be too late. We gotta hurry!	上のプレートが落ちてきたら ひとたまりもないわ.いそがなくちゃ！	scene_06
Marlene! MARLENE!!	マリン！マリン！！	scene_06
MAR---LE---NE!!	マリーーーン！！	scene_06
Biggs!	ビッグス！	scene_06
Wedge!!	ウェッジ！！	scene_06
Jessie!!	ジェシー！！	scene_06
Goddamn it!!!	こんちくしょう！	scene_06
Dammit!	こんちくしょう！！	scene_06
DAMMIT ALL!!!!	こんちくしょうーー！！！！	scene_06
What the hell's it all for!?	なんだ、こんなもの！	scene_06
ARGGHHHH!!!	うおぉぉーー！！	scene_06
Hey, BARRET!	おい、BARRET！	scene_06
BARRET!	BARRET！	scene_06
Hey!	おい！	scene_06
BARRET, stop… Please stop, BARRET.	BARRET、もうやめて……おねがい、BARRET	scene_06
URGHHHH!!!	うわぁぁぁーー！！！	scene_06
God damn…	クッ！ちくしょう……	scene_06
Marlene…	マリン……	scene_06
… BARRET?	………ねぇ、BARRET……	scene_06
Marlene is… I think Marlene is safe.	マリンは、マリンはだいじょうぶだと思うの	scene_06
…huh?	……え？	scene_06
Right before they took AERIS, she said, 'Don't worry, she's all right.' She was probably talking about Marlene.	AERISが言ってたわ。『あの子、だいじょうぶだから』って、マリンのことよ、きっと	scene_06
Rrr, really!?	ほ、本当か！！	scene_06
Biggs… Wedge… Jessie…	ビッグス……ウェッジ……ジェシー……	scene_06
All three of them were in the pillar.	……あの３人は柱の中にいた	scene_06
Think I don't know that?	わかってる……	scene_06
But…we, all of us fought together.	でもよ、でもよ！いっしょに戦ってきた仲間だ！	scene_06
I don't wanna think of them as dead!	死んじまったなんて……思いたくねえ！	scene_06
…And the other people in Sector 7.	……７番街の人たちも	scene_06
This is all screwed up!	ああ、ヒドイもんだぜ	scene_06
They destroyed an entire village just to get to us! They killed so many people…	オレたちを倒すために街ひとつつぶしちまうんだからな。いったい何人死んだんだ……	scene_06
…Are you saying it's our fault? Because AVALANCHE was here? Innocent people lost their lives because of us?	……私たちのせい？アバランチがいたから？関係ない人たちまで……	scene_06
No, TIFA! That ain't it! Hell no!!	ちがう！　ちがうぜ！　TIFA！！	scene_06
It ain't us! It's the damn Shinra! It's never been nobody but the Shinra!	なにもかも神羅のやつらがやったことじゃねえか！	scene_06
They're evil and destroyin' our planet just to…	自分たちの金や権力のために星の命を吸い取る悪堂ども！	scene_06
build their power and line their own damn pockets with gold!	その神羅をつぶさない限りこの星は死んじまうんだ！	scene_06
Our fight ain't never gonna be over until we get rid of them!!	神羅を倒すまでオレたちの戦いはおわらねえ！！	scene_06
…I don't know.	……わからない	scene_06
What don't you know!? You don't believe me?	オレが言ってることわからねえのか！？	scene_06
It's not that. I'm not sure about…me. My feelings.	ちがう……わからないのは自分の……気持ち	scene_06
An' what about you?	おまえはどうなんだ？	scene_06
Where's he think he's goin'?	あいつ、どこへ？	scene_06
Oh! AERIS!	あっ！　AERISのこと！	scene_06
Oh yeah, that girl. What's up with her?	ああ、あの姉ちゃんか。何者なんだ？	scene_06
…I don't really know… but she's the one I left Marlene with.	……私もよく知らない。でも、マリンのことをAERISに頼んだの	scene_06
Damn! Marlene!!	そうだ！　マリン！！	scene_06
AERIS said that Marlene was safe.	マリンはだいじょうぶってAERISは言ってたけど……	scene_06
TIFA. There ain't no turnin' back now.	TIFA。もう、あともどりはできねえんだ	scene_06
Sector 6 park	６番街公園	scene_06
Received "Sense" Materia!	『みやぶる』のマテリアを手にいれた！	scene_06
CLOUD!	CLOUD！	scene_06
Take me to Marlene!	マリンのところへ連れてってくれ！	scene_06
You're going to help AERIS?	AERISを助けにいくのね？	scene_06
Yeah… But before that, there's something I want to know.	ああ……でも、その前に確かめたいことがあるんだ	scene_06
What's that?	なに？	scene_06
…It's about the Ancients.	……古代種	scene_06
Now listen good! The Ancients are the rightful rulers of this Planet!	よく聞け！古代種こそがこの星の正当なる支配者！	scene_06
"Sephiroth…?"	セフィロス……？	scene_06
Pull it together, man!	しっかりしてくれよ！	scene_06
Sector 6	６番街	scene_06
In my veins courses the blood of the Ancients. I am one of the rightful heirs to this planet!	われこそ古代種の血をひきし者。この星の正統なる後継者！	scene_06