The hell are you? What're you doin' around here?	なんだお前は？こんなところで何をしている？	scene_08
Where's AERIS?	AERISはどこだ！	scene_08
AERIS? How did you know that name? You must be…	AERIS？その名を知っているとはお前まさか！？	scene_08
AERIS, you mean that kid. The receptionist? I was startin' to worry about her, too.	AERISってあのコだろ。受付の。じつはオレもあのコ気になってるんだよね	scene_08
And so another rival appears on the scene, eh?	ウーン、はやくもライバル出現……	scene_08
You mean, she's not? It's someone else?	え、そうじゃない？なんだ、人違いか	scene_08
Oh, I see. So you must be that whatcha call it…	ハハーン……わかったぞ。さてはお前、アレだな？いまウワサの……	scene_08
Shinra, Inc. Repair Division!!	神羅カンパニー修理課　！！	scene_08
You know, this building looks like it's starting to fall apart.	いや～、このビルもそろそろあちこちにガタがきててなあ	scene_08
This door was just pushed open. You ought to fix this right away.	この階のドア開きっぱなしなんだ。早く直してくれよな	scene_08
Oh yeah, and take a look on the other floors, too. Here, take this.	あ、そうそういちおう他の階も見回ってくれよ。これ、やるから	scene_08
Received Key Item "Keycard 62"!	キーアイテム『カードキー６２』を手にいれた！	scene_08
This is the lounge floor. Above us are the special floors for the company big wigs.	ここはリフレッシュ・フロア。この上は、おえらがたがいる特別なフロアが多いからね	scene_08
It's tough working under someone. It wears you out.	その下ではたらく我々もいろいろとつかれるんだよ。いろいろとね……	scene_08
I thought I heard a ruckus downstairs a minute ago. Do you know what that was all about?	さっき下の方がさわがしかったけど何かあったのかしら？	scene_08
No idea. But no need to worry because everything above the 60th floor is safe.	さあな。ま、６０階から上は何があっても安全だ。気にすることもないって	scene_08
What's keeping her? Did she forget her keycard?	あいつ、遅いな……カードキー忘れたかな？	scene_08
Even employees can't access floors above the 60th without a keycard.	社員といえど６０階から上はカードキーがないと自由に歩けないからな……	scene_08
I don't remember seeing your face before… You new here?	あら、見かけない顔……新しく配属されたのね？	scene_08
Say, you're cute. Let me teach you some…things.	いいわ、私がいろいろおしえてあげる♥	scene_08
Things?	い、いろいろ？	scene_08
Um, I'm kinda in a hurry…	急いでいるもので……	scene_08
Oh? That's too bad…	あら、そう。ざんねんだわ……	scene_08
Wipe that stupid look off your face. I was only going to teach you how to get to the next floor.	なーに、ヘンな顔して。教えてあげるのは、ここから上のフロアのことよ	scene_08
The higher ups in the company use the floors above the 60th floor. But you can't get there without a keycard.	６０階から上は、役員クラスの社員の多い特別フロア。カードキーがないと入ることも許可されないの	scene_08
Get a keycard and you can use the elevators freely.	カードキーがあれば階段もエレベーターも自由に使えるわ	scene_08
…voila! Hear that sound and the door will open.	エレベーターはホラ、私の横にあるこのドアの前で【決定ボタン】　を押すの。そうすると……	scene_08
Just remember there are different types of cards. One keycard alone won't let you go everywhere.	……っていう音がしてドアが開くから	scene_08
For example,	でもね、カードキーにも何種類かあって、１枚でどこでも、ってわけにはいかないのよ	scene_08
'Keycard 60' only takes you to the 60th floor. Keycard 65' only takes you to the 65th floor.	そうね、たとえば『カードキー６０』なら６０階まで。『カードキー６５』なら６５階まで。そういうことよ	scene_08
It's a security system worthy of Shinra. After all, they control everything in Midgar and in the world for that matter.	まあミッドガル、いえ、今や世界のエネルギー流通を一手にひきうける神羅カンパニーの本社としては、当然のセキュリティよね	scene_08
Oh, I have to go. Gotta get back to work!	あらやだ、長くなっちゃったわ。それじゃおたがい、お仕事がんばりましょうね♥	scene_08
Shinra, Inc.	神羅カンパニー	scene_08
Urban Dev. Research Library	都市開発部門資料室	scene_08
Space Dev. Research Library	宇宙開発部門資料室	scene_08
Peace Preservation/ Weapon Dev. Research Library	治安維持部門・兵器開発部門資料室	scene_08
Scientific Research Library	科学部門資料室	scene_08
Hart	ハット	scene_08
How do you do?	あ、これはどうも	scene_08
This is the Midgar Mayor's Office. Mayor Domino is in his office.	こちらはこのミッドガルの市長室でございます。この中にはドミノ市長がいらっしゃいます	scene_08
I am the Deputy Mayor. If you should have any questions feel free to ask me…	ちなみにわたくしはミッドガルの助役です。困ったことがありましたらぜひわたくしに……	scene_08
Domino	ドミノ	scene_08
Hmm? Oh, and who might you be?	あ～？なんだねキミたちは？	scene_08
You all must be those…ahem… Me? I'm Domino, the Mayor of Midgar.	ああ、キミらが例の……私？　私はこの魔晄都市ミッドガルの市長、ドミノだ	scene_08
Actually, I'm Mayor in name only. The city and everything in it is really run by Shinra, Inc.	とは言っても名前だけ。ホントのところ、ミッドガルのすべては神羅のものだ	scene_08
My only real job is watching over Shinra's documents…	今の私の仕事といったら神羅カンパニーの資料管理……	scene_08
Me! The Mayor! A librarian! Ohh…	ミッドガルの市長が！神羅の資料を！ハア……	scene_08
You want to get upstairs? I tell you what, if you can guess the password, I'll give you my keycard.	キミら、上へ行きたいんだろ？いいとも、私のカードキーをやろう。合言葉を言えたらな	scene_08
Yes, that's it. Guess the password and I'll give you my keycard!	そう、合言葉だ。それを言えたら、カードをやろう	scene_08
Get it on the first try and I'll even throw in a special item!	おまけに１回で当てたらナイスなおみやげもつけてやるぞ？	scene_08
Got it? Then tell me.	合言葉がわかったのか？では言ってみたまえ	scene_08
So, what's the password?	合言葉は？	scene_08
BEST	市長最高！！	scene_08
KING	神羅最低！！	scene_08
ORBS	魔晄最高！！	scene_08
BOMB	市長爆発！！	scene_08
MAKO	魔晄爆発！！	scene_08
HOJO	神羅爆発！！	scene_08
Wait a second	ちょっと待ってくれ	scene_08
Nope! You're ALL wrong! It's a much better word than that! Try again!	ぜんぜん違う！もっとすばらしい言葉だ！やり直し！	scene_08
BEST!!	市　　長　　最　　高　　！！	scene_08
God, I love the sound of that! BEST!! I AM the best…ME!! No matter what anyone else says, you'd better believe it.	なんとすばらしいひびき！そのとおり！ミッドガルの市長は最高！誰が何と言おうと最高！	scene_08
…hmm. Well, OK. Here, take it.	……フン、まあいいだろう。ホラ、持っていけ	scene_08
KING!!	神　　羅　　最　　低　　！！	scene_08
God, I love the sound of that! KING!! President Shinra sucks! I should be King of Midgar!	なんとすばらしいひびき！そのとおり！プレジデント神羅は最低！私こそミッドガルの主！	scene_08
BOMB!!	市　　長　　爆　　発　　！！	scene_08
God, I love the sound of that! BOMB!! I'm so angry, I'm like a walking time bomb waiting to explode!	なんとすばらしいひびき！そのとおり！私の怒りは最高レベルに！もう爆発しそうだ！	scene_08
MAKO!!	魔　　晄　　爆　　発　　！！	scene_08
God, I love the sound of that! MAKO! If I had a lot more of it, I would be a real Mayor!	なんとすばらしいひびき！そのとおり！魔晄エネルギーを爆発させろ！そして私を真の市長に！	scene_08
Received "Keycard 65"!	キーアイテム『カードキー６５』を手に入れた！	scene_08
Why would I do something like this, you ask?	なんでこんなコトするか？	scene_08
Revenge, of course!	きまってるじゃないか。イヤガラセだよ。イヤガラセ	scene_08
Shinra's been torturing me forever.	いいか、神羅はずっと私を苦しめてきたんだぞ	scene_08
That's why I was a little rough on you all just now. Now go up there and really make them suffer.	だから私はここでキミたちをなやませ今度はキミたちが上へ行って神羅のやつらを困らせる	scene_08
This ought to teach them! Heh heh heh…	どうだ、これでおあいこだろ。ヒ、ヒヒ、ヒヒヒ……	scene_08
But my card will only get you to the 65th floor.	言っておくが、私のカードでは６５階までしかのぼれんよ	scene_08
Can you believe how they treat me? …ME! Like some common employee…	神羅め、この私を……この私を一般社員とおなじあつかいに……	scene_08
Did you speak with the Mayor?	市長の話はお聞きになりました？	scene_08
What? A password? Oh, I get it…	は？合言葉？ははあ、なるほど……	scene_08
He's got way too much time on his hands. But you can't really blame him, Everything in Midgar is controlled by President Shinra.	あの人もヒマなんですよ。なんせミッドガルの全権はほとんどプレジデント神羅のものですからね	scene_08
Maybe I can help you.	そういうことならわたくしがお手伝いしましょう	scene_08
What do you want to know?	なんでもお答えしますよ？	scene_08
The password…duh!	合言葉を教えて	scene_08
How about a hint?	ヒントをくれ	scene_08
Get out of my face	助けなどいらない	scene_08
…I see. Then, I guess that's that.	ハア、そうですか。ではしかたありませんね	scene_08
Good luck finding it on your own.	がんばってご自分で見つけてください	scene_08
If you decide you want help. I'll just be right over here. Ready to tell you anytime…	どうしてもわからなかったらまたどうぞ。いつでもお教えしますよ……	scene_08
What can I do for you?	ハイハイ。何がお望みで？	scene_08
Give me the hint again	さっきのヒントをもう１度	scene_08
Give me the next hint	次のヒントを	scene_08
Uh, nothing	なんでもない	scene_08
Sure, sure. All right.	ええ、いいですとも。いいですとも	scene_08
As a public servant, it's my job to serve the needs of the people.	市民のみなさんにサービスすることこそわたくしたち役人のよろこび	scene_08
So here's a hint…	こころよくヒントを お教えしましょう！	scene_08
…for 500 gil.	……５００ギルで	scene_08
Give him the money	金をだそう	scene_08
Forget it!	ふざけるな！	scene_08
…for 1000 gil.	……１０００ギルで	scene_08
…for 2000 gil.	……２０００ギルで	scene_08
…for 5000 gil.	……５０００ギルで	scene_08
…for 15000 gil.	……１５０００ギルで	scene_08
HELP	助けてくれ	scene_08
Hey now! You're a bit short.	おやおや。お金がたりないようですが？	scene_08
No one works on credit nowadays… not even stores in the slums.	今どきスラムの道具屋だってツケはききませんよ……	scene_08
I can't believe it! I gave you all these hints, and you STILL don't get it?	しかし、これだけのヒントでもわからないとは……	scene_08
You guys are amazing! Really, amazing…	あなたがた、やっぱりスゴイ人だ。いろんなイミで	scene_08
Well, seeing as things have come to this, I might as well just tell you.	こうなったらもうズバリ合言葉をお教えします！	scene_08
Oh, my…well, Thank you very much.	これはこれは…… ありがとうございます。	scene_08
Now listen. On this floor are four research libraries for four different sections of Shinra, Inc….	いいですか。このフロアには神羅カンパニーの４つの部門の資料室があります	scene_08
Parts of the password are hidden in each of the libraries.	合言葉はその４つの資料室にかくされています	scene_08
Pay careful attention to the files in each room.	各部屋の資料をよ～く調べてみてください	scene_08
The name of each library is written on the plaque outside the door.	資料室の名前はドアの横のプレートに書いてあります	scene_08
Now, in each library will be one file mixed in from another library.	いいですか。どの資料室にも１つだけ他の部の資料がまぎれこんでいるはずです	scene_08
Look carefully at the numbers on each file.	その資料の数字とファイル名をよく見ると……	scene_08
There is a number at the beginning of each file name.	いいですか。すべての資料には数字がついています	scene_08
Look at the number on the files that don't belong in that library. Match the number with the letters in the title of the file.	各部屋にまぎれこんでいる資料の名前を、その数字と見くらべてください	scene_08
If the file starts with a 4, then check the fourth letter and… well, you get the idea.	『４』と書いてある資料なら名前の４文字目を……もう、おわかりでしょ？	scene_08
What do you mean the next hint? I've practically told you, didn't I?	次のヒントって……もう、ズバリ答えを言っちゃったじゃないですか！	scene_08
…all right. Since this seems like a special case, I'll give you MY key card!	……わかりました。特別にわたくしのカードキーをさしあげましょう！	scene_08
If you run into President Shinra, please don't tell him about this.	もしプレジデント神羅に会っても、わたくしのことは言わないでくださいよ	scene_08
I can't be a partner to anymore trouble for Shinra.	これ以上神羅にイジメられるのはゴメンですからね……	scene_08
I never thought you'd get it on the first try…	なんと、１回でズバリあてるとは……	scene_08
Just goes to show you can't judge a book by its cover. Oh well, a promise is a promise. Take this, too.	ひとは見かけによらないものだ。まあいい、約束は約束だ。これもやろう	scene_08
Received "Elemental" Materia!	『ぞくせい』のマテリアを手にいれた！	scene_08
What…full already? Come back again when it's empty.	……なんだ、アレはいっぱいか。アレに空きができたら、またきたまえ	scene_08
Received "Potion"!	『ポーション』を手にいれた！-	scene_08
Hmm. It appears you're not completely stupid.	フン、そこそこ頭ははたらくようだ	scene_08
Fine then, take this.	いいだろう、これをうけとりたまえ	scene_08
I see… For you…this might be best.	なるほど……ま、キミらならこんなものかな	scene_08
Then, this is for all of you.	それでは、キミたちにあげるのもこんなものだ	scene_08
Hoo boy! You finally got it?	やれやれ、やっとあてたか……	scene_08
You all really don't use your heads much, do you?	やはり頭を使うのは苦手かね？	scene_08
……What the hey. Here, just take it anyway.	……まあいい。とっておきたまえ	scene_08
This is the Scientific Research Library.	ここは科学部門の資料室です。	scene_08
Materials for the…	他の３つの資料室にはそれぞれ……	scene_08
Urban Dev. Library	都市開発部門	scene_08
Peace/Weapon Dev. Library	治安維持・兵器開発部門	scene_08
Space Dev. Library	宇宙開発部門	scene_08
are held in their respective libraries…	の資料が保管されています。	scene_08
Materials are non-circulating!	持ちだし禁止！	scene_08
Please do not remove any Materials from this floor.	このフロアの資料はすべて外部に持ちだすことを禁じられています。	scene_08
2 Problems with Plate construction in Midgar	２　神羅プレート都市の 設計とその間題点	scene_08
5 Reactor Construction Chart	２　魔晄炉建造工事 都市部着工予定表	scene_08
6 Reactor Construction Chart	８　魔晄炉建造工事 都市部着工予定表	scene_08
4 Ranks and extended use of Mako weaponry	６　魔晄兵器の長期使用に 関する特別規定	scene_08
24 Ranks and extended use of Mako weaponry	１　魔晄兵器の長期使用に 関する特別規定	scene_08
4 Midgar City map: Sectors 0-4	４　ミッドガル区分地図 ０番街～４番街	scene_08
9 Midgar City map: Sectors 5-8	５　ミッドガル区分地図 ５番街～８番街	scene_08
3 An illustrated guide to City Planning	６　　図説　カトー式都市空間工法 	scene_08
4 The Jenova Project	１　　ジェノバプロジェクト 経過報告書 神羅カンパニー科学部門	scene_08
6 Data on experimental animals living near Midgar	２　ミッドガル周辺に生息する 突然変異生物実験データ	scene_08
3 File on Dr. Gast, Biologist	３　　　　ガストファイル 生物博士ガスト・ファレミス	scene_08
14 The Ancients in History	７　　　歴史の中の古代種生物博士ガスト・ファレミス	scene_08
8 New plans for Urban Planning	３　新都市建設計画書	scene_08
10 New plans for Urban Planning	１　新都市建設計画書	scene_08
4 Report on high Mako levels in living beings	５　生物体の高レベル魔晄による	scene_08
2 Mako energy and the rise in life forms	影響に対する調査	scene_08
8 Final evolutionary stages in land dwelling life	４　生物の爆発的進化と 魔晄エネルギー ６　地上生物の最終進化論 	scene_08
1 Biological characteristics of the Ancients	８　伝承における古代種の生物学的特性	scene_08
10 Biological characteristics of the Ancients	[COULDN'T FIND IT]	scene_08
16 Modern history of Midgar space program vol. 1	２　　宇宙開発部門 栄光の歴史　上巻	scene_08
19 Modern history of the Midgar Space Dev Program Vol. 2	４　　宇宙開発部門 栄光の歴史　下巻	scene_08
7 Diminishing Mako energy and Planet movements	９　魔晄エネルギーの低下と 惑星運動	scene_08
1 Results of failed space mission "YA-79"	５　大型飛行機械「ヨナイ７９式	scene_08
6 Shinra rocket space travel	宇宙進出計画の失敗	scene_08
7 Economic report: Space Dev Program	６　神羅ロケットエンジンと 大陸間航行機	scene_08
10 Materia production and its military uses	１　　最終予算報告書 神羅宇宙開発部門	scene_08
3 Special peace keeping law	１　　マテリアの製造および その軍事的利用に関する権利	scene_08
1 Heidegger's Shinra peace keeping law	２　特別治安維持法 ハイデッカー私案	scene_08
1 Breakdown of SOLDIER members by class	１　神羅特別治安維持法 ハイデッカー私案	scene_08
3 Plan for new land weapons	３　クラス別ソルジャー配備データ ４　新式地上兵器開発プラン	scene_08
4 Midgar crime white paper	６　ミッドガル治安白書 反神羅勢力の現状	scene_08
2 Problems with Plate construction in Midgar	７　神羅プレート都市の 設計とその間題点	scene_08
This is the Space Dev Research Library. Click on the plate in front of each library to see which it is.	ここは宇宙開発部門資料室です。 各資料室の場所については 部屋の前にあるプレートを ごらんください。	scene_08
This is the Public Order/Weapon Development Library.	ここは治安維持部門および 兵器開発部門の資料室です。	scene_08
Return materials where you found them. Do not mix materials from other libraries.	せいりせいとんを忘れずに！ 他の部門の資料と 間違えないようにしましょう。	scene_08
2Economic report: Space Dev Program	６　地上生物の最終進化論 	scene_08
3Special peace keeping law	５　　マテリアの製造および その軍事的利用に関する権利	scene_08
7Economic report: anti-Shinra activities	７　ミッドガル治安白書 反神羅勢力の現状	scene_08
3An illustrated guide to city planning	６　　図説　カトー式都市空間工法	scene_08
4File on Dr. Gast, biologist	３　　　ガストファイルα 生物博士ガスト・ファレミス	scene_08
4File on Dr. Gast, biologist	４　　　ガストファイルβ 生物博士ガスト・ファレミス	scene_08
4Report of high Mako levels in life forms	５　生物体の高レベル魔晄による 影響に対する調査	scene_08
2Mako energy and the rise in life forms	４　生物の爆発的進化と 魔晄エネルギー	scene_08
6Biological Characteristics of the Ancients	６　伝承における古代種の 生物学的特性	scene_08
…beep…beep… Open the door?	ピピッ……このドアをあけまスか？	scene_08
Yes	あける	scene_08
No	やめておく	scene_08
…beep…beep… …verifying keycard… ………	ピピッ…… カードキー照合…… ………………	scene_08
Level B employee: verified. You are permitted to open doors on this floor up to three times.	Ｂランク社員ト確認。アナタは、このフロアのドアを３回まで開けルことが許可されましタ	scene_08
blip… If you receive an item coupon, remember to exchange it for an item.	チュウイ。アイテムクーポンをもラったらわすれズに、アイテムと交換しまショう	scene_08
…Warning…do not enter the air conditioning ducts, they are very dangerous...	ケイコク。キケンですからむやみに通気ダクトをのぞクのはやめまショウ	scene_08
…ga… …gaga…ga...	……ガ…………ガガ……ガ……	scene_08
…bing…bing… Enter command	ピピッ……コマンドを入力してくだサい	scene_08
All Clear	オールクリア	scene_08
Coupon Change	クーポンチェンジ	scene_08
You can exchange your coupons for items. Here are the items you can have...	クーポンをアイテムにかえることができまス。もラえるアイテムは……	scene_08
A coupon…'Star Pendant' B coupon….'Four Slots' C coupon….'All' Materia	Ａクーポン……『星のペンダント』Ｂクーポン……『フォウスロット』Ｃクーポン……マテリア『ぜんたいか』	scene_08
Please use caution…once you have exchanged coupons for items you may not select 'All Clear'.	ただし、クーポンチェンジ後のオールクリアはでキません。ゴちゅういくださイ	scene_08
Exchange coupon?	クーポンチェンジしまスか？	scene_08
……… Coupon exchange complete.	………………クーポンチェンジ完了	scene_08
…bing…bing… Start again from the beginning?	ピピッ……もう一度ハジメからやりなおしまスか？	scene_08
The information and materials you received on this floor will all be cleared.	ただしこのフロアで手にいれタ記録、資料などもすべてクリアされまス	scene_08
Clear them?	クリアしまスか？	scene_08
……… Cleared.	………………クリア完了	scene_08
You are permitted to open any door on this floor up to three times.	アナタは、このフロアのドアを３回まで開けルことが許可されましタ	scene_08
Bi, bing… You have opened three doors.	ピピッ……アナタはすでに３回ドアをあけていまス	scene_08
If you access the computer, You can begin this process one more time.	コンピュータにアクセスすればもう１度ハジメからやりなおすことができまス	scene_08
Received "Star Pendant"!	『星のペンダント』を手にいれた！	scene_08
Received "Hourglass"!	『きんのすなどけい』を手にいれた！	scene_08
Received "Four Slot"!	『フォウスロット』を手にいれた！	scene_08
Received "Glow Lance"!	『グローランス』を手にいれた！	scene_08
An air-duct… It doesn't look like I can climb in here.	通気ダクトか……こちらからはもぐりこめそうにないな	scene_08
An air-duct…	通気ダクトか……	scene_08
Climb in and look around	もぐりこんでみるか	scene_08
Leave it alone	ほうっておこう	scene_08
Received Key Item "A Coupon "!	キーアイテム『Ａクーポン』を手にいれた！	scene_08
Received Key Item "B Coupon "!	キーアイテム『Ｂクーポン』を手にいれた！	scene_08
Received Key Item "C Coupon "!	キーアイテム『Ｃクーポン』を手にいれた！	scene_08
…beep…beep… You do not have any coupons.	ピピッ……あなタはクーポンをもっていまセん	scene_08
…beep…beep… After you have exchanged coupons you may no longer use 'All Clear'.	ピピッ……クーポンチェンジ後のオールクリアはでキません	scene_08
Your 'All' Materia was returned for a C Coupon.	マテリア『ぜんたいか』をＣクーポンにもどしましタ	scene_08
…huff…wheeze… I'm trying to get rid of my love-handles…	ハーハー……最近おなかのあたりが気になりだして……	scene_08
…huff…puff… If you get tired, you can rest up in the next room.	フーフー……つかれたらとなりの部屋でやすむといいわよ	scene_08
Hmph, hmph… I'm head of building security so stamina's very important to me.	フンッ、フンッ……このビルの警備をあずかる者として、体力には気をつかっているのだ	scene_08
You must be a visitor. Feel free to use any open machine.	ビジターの方でございますね。あいているマシンはご自由にご利用ください	scene_08
A nap room…	仮眠室か……	scene_08
Let's get some rest	休んでいこう	scene_08
Let's move on	先を急ごう	scene_08
…zzz… Please…let me… get some…rest…	グーゴー……たのむ……からゆっくりねかせてくれ……	scene_08
Received "HP Shout"!	『マーベラスチアー』を手にいれた！	scene_08
What is this…a Megaphone?	何だこれ……メガホン？	scene_08
Hanging on to this won't do any good…	こんなもの持っていってもしょうがないな	scene_08
Locked…	カギがかかっている……	scene_08
There's nothing inside…	中にはなにもない……	scene_08
Out of Order	故障中です	scene_08
Please use a different floor	他の階をご利用下さい	scene_08
Shinra Company Repair Management Department	神羅カンパニー修理課	scene_08
Take one to restore your energy!! Shinra Gym Health Drink'	体力回復にこの１本！！『神羅ジム特製ドリンク』	scene_08
Only 250 gil!!	２５０ギルにて発売中！！	scene_08
Try it out	買ってみるか	scene_08
…Nothing…	……何もでてこないな	scene_08
…Is it broken?'	……こわれているのか？	scene_08
BANG on it	ガンガンたたく	scene_08
Give up	あきらめよう	scene_08
Sir, what are you doing!? No violence here, please!	ちょっと、なにするんですか！乱暴はやめてください！	scene_08
Received "Mind Source"!	『マインドアップ』を手にいれた！	scene_08
Received "Speed Source"!	『スピードアップ』を手にいれた！	scene_08
Should I try it?	やってみようか？	scene_08
This is so stupid	バカバカしい	scene_08
Whew…	フウ……	scene_08
Better quit	そろそろやめよう	scene_08
Just a bit longer	もうすこしつづけよう	scene_08
I think I feel a little lighter… Maybe just a bit…	ほんのすこし身が軽くなったような……気がするな	scene_08
A model of Midgar…a city born from the earth's Mako.	ミッドガル……魔晄エネルギーを吸い出し生きつづける都市の模型か……	scene_08
Some parts are missing…	模型が価けている……	scene_08
Insert the Midgar parts	ミッドガルパーツをはめよう	scene_08
…Sounds like something opened up…	……なにかが開いたような音がしたな……	scene_08
Received Key Item "Keycard 66"!	キーアイテム『カードキー６６』を手にいれた！	scene_08
When construction of Sector 6 finishes, Shinra's plan will be complete.	この建設中の６番街が完成したとき、神羅の野望も完全なものとなる	scene_08
That must be why he took	その野望のために	scene_08
Is it just me or does the Conference Room smell? There's some sort of stench coming from somewhere…	関係ないけどよ。 あの会議室って、何か臭くないか？ どこかから臭ってくるんだよな…… 	scene_08
It gives me the feeling that I AM alive. The feeling of moving this world, just with my hands.	なんかこう、生きがいってものを感じるよな。世界をこの手で動かしているっていうこの感じ	scene_08
Whew, I'm so sick of carrying all these files…	はぁ～もうファイル運びはうんざり……	scene_08
But I get to meet lots of guys. I guess that's the benefit of being a secretary!	でもいろんな男の人との出会いがある。それがOLの特権ね！	scene_08
Come on, we're building the future of Mako!	さあ、私たちで魔晄の未来をつくるのよ！	scene_08
…………………… Phew!	……………………………………ふう	scene_08
Geez--! That's a lotta suits!	ヒュ～！そうそうたる顔ぶれだぜ	scene_08
We have the damage estimates for Sector 7.	７番街の被害報告が出ました	scene_08
Considering those factories we already set up and all the investments, the damage is estimated at approximately 10 Billion gil…	すでに稼動していた工場部分と現在までの投資額を考えると我が社の損害は100億ギルはくだらないかと……	scene_08
The estimated cost to rebuild Sector 7 is…	また７番プレートの再建にかかる費用は……	scene_08
We're not rebuilding.	再建はしない”	scene_08
What?	は？	scene_08
We're leaving Sector 7 as it is.	７番プレートはこのまま放っておく	scene_08
And restarting the Neo-Midgar plan.	そのかわりにネオ・ミッドガル計画を再開する	scene_08
…then the Ancients?	……では、古代種が？	scene_08
The Promised Land will soon be ours.	約束の地はまもなく我々のものになるだろう	scene_08
I want you to raise the Mako rates 15% in every area.	それから各地の魔晄料金を15％値上げしたまえ	scene_08
Palmer	パルマー	scene_08
Rate hike! Rate hike! Tra, la, la! And please include our Space Program in the budget!	値上げ値上げ！うひょひょひょひょ！ぜひ我が宇宙開発部にも予算を！	scene_08
Reeve and Scarlet will divide the extra income from the rate increase.	魔晄料金値上げによる差益はリーブくんとスカーレットくんで分配したまえ	scene_08
Oh man!	いいないいな！	scene_08
Sir. If you raise the rates, the people will lose confidence…	プレジデント。これ以上の魔晄料金の値上げは住民の不満をまねき……	scene_08
It'll be all right.	だいじょうぶだ	scene_08
The ignorant citizens won't lose confidence, they'll trust Shinra, Inc. even more.	おろかな住民たちは不満をどころかますます神羅カンパニーに信頼をよせることになる	scene_08
Ha ha ha!	ガハハハハ！	scene_08
After all, we're the ones who saved Sector 7 from AVALANCHE!	テロリストどもから７番街の市民を救ったのは神羅カンパニーですからな！	scene_08
That dirty #$*$^	汚ねえ……	scene_08
Hojo. How's the girl?	おお、宝条くん。あの娘はどうかね	scene_08
Hojo	宝条	scene_08
As a specimen, she is inferior to her mother. I'm still in the process of comparing her to her mother, Ifalna, but for now the difference is 18 %.	サンプルとしては母親におとる。母親イファルナとの比較中だが初期段階で相違が18％	scene_08
How long will the research take?	その検査にはどれくらいかかる？	scene_08
Probably 120 years. It's probably impossible to finish in our lifetime. Or in the lifetime of the specimen too, for that matter.	ざっと、120年。我々が生きてるあいだは無理だろう。もちろんあのサンプルもな	scene_08
That's why we're thinking of breeding her. Then we could create one that could withstand our research for a long time.	だから古代種を繁殖させようと思うのだ。しかも、長命で実験に耐えうる強さを持たせることができる	scene_08
What about the Promised Land? Won't it hinder our plans?	約束はどうなる？計画に支障はでないのか？	scene_08
That's what I need to plan. The mother is strong… and yet has her weaknesses.	……そのつもりだ。母は強く……そして弱みを持つ	scene_08
They were talking about AERIS…right?	いまのはAERISの話……だよな	scene_08
I dunno.	わかんねえ	scene_08
Probably.	たぶん、ね	scene_08
Let's follow 'em.	あとをつけよう	scene_08
Scarlet	スカーレット	scene_08
Something stinks…	臭うわね……	scene_08
President Shinra	神羅	scene_08
That concludes our meeting.	では、会議を終わる	scene_08
Flush?	汚いから長そうか？	scene_08
Climb up?	登ってみようか？	scene_08
Get out of here	やっぱり出よう	scene_08
Hojo…huh…?	宝条……ってやつか……	scene_08
I remember him.	思い出したぜ	scene_08
That Hojo guy. He's in charge of the Shinra's Science Department. CLOUD, don't you know him?	あの宝条ってやつ。神羅の科学部門の責任者だ。CLOUD、知らねえのか？	scene_08
This is the first time I've actually ever seen him. So…that's what he looks like…	じっさい見るのは初めてだ。そうか……あいつが……	scene_08
Is this today's specimen?	今日の実験サンプルはそいつですか？	scene_08
Yes. We're starting right away. Raise it to the upper level.	そうだ。すぐ実験にとりかかる。上の階をあげてくれ	scene_08
My precious specimen…	かわいいサンプルよ……	scene_08
Precious specimen…?	かわいいサンプルよ…か	scene_08
Is it going to be used for a biological experiment?	生物実験に使われるのかな？	scene_08
Jenova…	ジェノバ……	scene_08
Jenova… Sephiroth's… So…they've brought it here.	ジェノバ…… セフィロスの…… そうか……ここに運んだのか	scene_08
CLOUD, be strong!	CLOUD、しっかりして！	scene_08
Did you see it?	見たか？	scene_08
See what?	何を？	scene_08
It's moving……still alive?	動いてる……生きてる？	scene_08
Where's its $#&*&@ head? This whole thing's stupid. Let's keep goin'.	何だい、この首なしは？ けっ、バカバカしい。さっさと行こうぜ	scene_08
Let's see… The specimen Hojo asked me for is…	さて……と 宝条さんに頼まれた サンプルわ……と	scene_08
That elevator back there is only to transport Specimens. You can't use it. It would be a lot easier if it led to the 68 Floor Research Lab.	奥のサンプル運搬用エレベーターは使用禁止だよ。６８階の研究室に直結しているから便利なんだけどね	scene_08
AERIS? Oh, is that her name? What do you want?	AERIS？ ああ、この娘の名前だったな。何か用か？	scene_08
We're taking AERIS back.	AERISを返してもらおう	scene_08
Outsiders……	…………部外者だな	scene_08
Shoulda noticed it earlier, you…	最初に気づけよ	scene_08
There's so many frivolous things in this world.	世の中にはどうでもいいことが多いのでな	scene_08
Are you going to kill me? I don't think you should.	私を殺そうというのか？ それはやめた方がいいな	scene_08
The equipment here is extremely delicate. Without me, who could operate it? Hmm?	ここの装置はデリケートだ。私がいなくなったら操作できまい？　ん？	scene_08
Ugh.	くっ	scene_08
That's right. I recommend you think things out logically before you make any rash moves.	そうそう。こういう時こそ論理的思考によって 行動することをおすすめするよ	scene_08
Now, bring in the Specimen!	さあ、サンプルを投入しろ！	scene_08
What do you think you're doin'?	何をする気だ！	scene_08
Lending a helping hand to an endangered species… Both of them are on the brink of extinction…	滅びゆく種族に愛の手を…… どちらも絶滅まぢかだ	scene_08
If I don't help, all these animals will disappear.	私が手を貸さないと この種の生物は滅んでしまうからな	scene_08
…animal? That's terrible! AERIS is a human being!	……生物？　ひどいわ！ AERISは人間なのよ！	scene_08
You're gonna pay!	許せねえ！	scene_08
BARRET! Can't you do anything?	BARRET！ 何とかならないのか？	scene_08
Awright!! Step back!	ええい！！ さがってろ！	scene_08
Stop!!	やめろ！！	scene_08
Wh…what are you do-- Oh! My precious specimens…	な、なんていうことだ。大事なサンプルが……	scene_08
This is no ordinary specimen. This is a very ferocious specimen!	今度はこんなハンパな奴ではないぞ。もっと凶暴なサンプルだ！	scene_08
Now's our chance to get AERIS!	今のうちにAERISを！	scene_08
Thanks, CLOUD.	ありがと、CLOUD	scene_08
CLOUD…what's wrong?	どうしたの？　CLOUD……	scene_08
…The elevator is moving.	……エレベーターが動いてる	scene_08
Oh shit… We're surrounded.	[NO LINE FOUND]	scene_08
He's rather strong. I'll help you all out.	あいつは少々手強い。私の力を貸してやる	scene_08
It talked!?	しゃべった！？	scene_08
I'll talk as much as you want later, Miss.	あとでいくらでもしゃべってやるよ、おじょうさん	scene_08
We'll take care of that monster.	あの化け物は俺たちがかたづける	scene_08
What's your name?	おまえの名前は？	scene_08
Hojo has named me, Red XIII. A name with no meaning whatsoever to me. Call me whatever you wish.	宝条は私をRED XIIIと名づけた。私にとって無意味な名前だ。好きなように呼んでくれ	scene_08
Come on!	さあ、かかってこい！	scene_08
AERIS, you all right?	AERIS、だいじょうぶか？	scene_08
She seems all right, …in many ways.	だいじょうぶみたいよ。……いろんな意味でね	scene_08
I have a right to choose, too. I don't like two-legged things.	……私にも選ぶ権利がある。二本足は好みじゃない	scene_08
What are you?	おまえ、なんだ？	scene_08
An informed question. But difficult to answer. I am what you see.	興味深い問いだ。しかし、その問いは答え難いな。私は見てのとおり、こういう存在だ	scene_08
…You must have many questions, but first, let's get out of here. I'll lead the way.	……いろいろ質問もあるだろうが とりあえずここから出ようか。道案内くらいなら付きあってやる	scene_08
CLOUD… so you did come for me.	CLOUD…… やっぱり、来てくれたのね	scene_08
I apologize for what happened back there. I was merely acting to throw Hojo off guard……	さっきは失礼したな。宝条を油断させるために演技をしたつもりだったが……	scene_08
Now we've saved AERIS, ain't no need to be in this buildin'! So let's get the hell outta here!	さあ、AERISを助ければもうこんなビルには用はない！ さっさと出ちまおうぜ	scene_08
If all five of us go together, we'll be noticed. Let's break up in two groups.	５人で行動していたら目立つ。二手に別れよう	scene_08
I'll see you later!! We'll be waiting at the 66th Floor Elevator.	あとでね！【66階エレベーター】で待ってるから	scene_08
We'll be going first! Meet at the 66th Floor Elevator.	先に行くわよ！集合は【66階エレベーター】よ	scene_08
Later! Meet up at the 66th Floor Elevator!	あとでな！　【66階エレベーター】で合流だ！	scene_08
Don't be late. Do you know where the Elevator is? The 66th Floor!	遅れるなよ。【エレベーター】の場所はわかっているな？ 【66階】だぞ	scene_08
No! Please don't kill me. I only did what Hojo told me to do.	ひゃっ！殺さないで宝条博士に言われてやっただけなんだ	scene_08
To prove it to you…here, this is the key card to the 68th Floor. Would I be doing this if I was the enemy?	そのしょうこに……ほら６８階までのドアロックキーを君たちにあげるよ。敵だったらこんな事するはずないだろ？……ねっ？	scene_08
Where you goin'? Everyone's waitin' at the 66th Floor Elevator.	どこ行くんだい？【６６階エレベーター】でみんな待ってるぜ	scene_08
Where are you going? Everyone's waiting for us at the 66th Floor Elevator.	どこ行くの？【６６階のエレベータ】でみんな待っているわよ	scene_08
Not that way! Everyone's on the 66th Floor Elevator.	そっちじゃない！みんなは【６６階エレベータ】で待っているわ	scene_08
You don't have a Card Key	カードキーを手にいれてません	scene_08
H, hey! What is it?	お、おい！　何だ？	scene_08
Rude	ルード	scene_08
Would you press 'Up' please?	上を押してもらおうか？	scene_08
Turks! Must be a trap…	タークス？ワナ……か	scene_08
This must've been a real thrill for you… Did you enjoy it?	スリリングな気分をあじわえたと思うが……楽しんでもらえたかな？	scene_08
Ggh…	くっ……	scene_08
They got you, too?	みんなもつかまったのか………………？	scene_08
In a safe place.	安全な場所にいる	scene_08
She's the last surviving Ancient…	あれは貴重な古代種の生き残りだからな	scene_08
Don't you know? They called themselves the Cetra, and lived thousands of years ago. Now they are just a forgotten page in history.	知らんのか？自らをセトラと呼び、数千年の昔に生き今は歴史の中に埋もれてしまった種族	scene_08
Cetra…that girl is a survivor of the Cetra?	セトラ……あの娘がセトラの生き残り？	scene_08
Cetra, or the Ancients, will show us the way to the 'Promised Land'. I'm expecting a lot out of her.	セトラ、すなわち古代種は我らに『約束の地』を教えてくれる。彼女には期待しているのだ	scene_08
The Promised Land? Isn't that just a legend?	約束の地？それは言い伝えではないか？	scene_08
Even so, it's far too appealing not to pursue.	だからといって放っておくにはあまりにも魅力的だ	scene_08
It's been said the Promised Land is very fertile.	約束の地は途方もなく豊かな土地と言われているからな	scene_08
…If the land is fertile…	……土地が豊かだということは	scene_08
then there's gotta be Mako!	魔晄エネルギーだな！	scene_08
Exactly. That is why our money making Mako Reactor is necessary.	そのとおり。そこでは金喰い虫の魔晄炉など必要ないのだ	scene_08
The abundant Mako will flow out on its own.	豊富な魔晄エネルギーが勝手に吹き出してくる	scene_08
That is where Neo-Midgar will be built. Shinra's new glory…	そこに建設されるネオ・ミッドガル。我が神羅カンパニーのさらなる栄光……	scene_08
@$#*^%! Quit dreamin'!	ケッ！夢みてんじゃねえよ！	scene_08
Oh really, don't you know? These days all it takes for your dreams to come true is money and power.	おやおや、知らないのか？最近では金と力さえあれば夢はかなうのだ	scene_08
Well, that is all for our meeting.	さて、会見はこれで終わりだ	scene_08
Hold it! I got a lot to say to you!	待ちやがれ！テメエには言いたいことが山ほどあるんだ！	scene_08
If there's anything else… talk to my secretary.	何かあるなら……秘書をとおしてくれたまえ	scene_08
Come on! Outta his way!	さあ！　さがれ！	scene_08
I wonder how BARRET is doing	BARRETはどうしてるかな	scene_08
I wonder how RED XIII is doing	RED XIIIはどうしてるかな	scene_08
I wonder how AERIS is doing	AERISはどうしてるかな	scene_08
Let's just get some sleep	とりあえず眠っておこう	scene_08
Psst (Can we get out?)	ヒソヒソ（逃げられるかな？）	scene_08
Psst (CLOUD, you're so brave!)	ヒソヒソ（CLOUD、たのもしい！）	scene_08
Psst (Don't give up!)	“ヒソヒソ(弱気にならないでよ！	scene_08
Hey!	おい	scene_08
AERIS is an Ancient and the real name of the Ancients is Cetra.	AERISは古代種で 古代種の本当の呼び名はセトラ	scene_08
The Ancients know where the Promised Land is and the Shinra is searching for that Promised Land.	それで古代種は約束の地って場所を知っていて、神羅はその約束の地が欲しい、と	scene_08
I only heard stories 'bout the Promised Land. I don't know if it really exists.	でも、約束の地ってのは 言い伝えに出てくるだけで 本当にあるのかどうかはわからねえ	scene_08
Is that right?	これでいいのか？	scene_08
The Shinra believe that the Promised Land is full of Mako energy.	約束の地には豊富な魔晄エネルギーがあると 神羅の連中は考えてる	scene_08
Which means, if the Shinra get there, they'll suck up all the Mako energy.	ってえことは、神羅はそこに行ったら また魔晄エネルギーをガンガン吸い上げちまうってことだ.”	scene_08
…and the land'll wither away. The Planet's gonna get weaker.	……そこも土地が枯れちまうな。星が……病んでいくわけだ	scene_08
I can't just leave 'em be. I'm recruitin'new members!!	放っちゃおけねえ！ アバランチ、メンバー募集だ	scene_08
Me, TIFA, CLOUD… and AERIS too.	オレ、TIFA、CLOUD…… それにAERISもだな	scene_08
How 'bout you?	おめえ、どうだ？	scene_08
You're so damn boring.	つまんねえやろうだぜ	scene_08
…………Grandpa.	……………………じっちゃん	scene_08
Grandpa!?  Ha, ha, ha…… Grandpa, hmm……ha, ha, ha……	じっちゃん！？　へへへへ じっちゃん、ねえ……へへへへ	scene_08
What's so funny?	なにがおかしい	scene_08
Nothin'……ha, ha	いや、べつに……へへへ	scene_08
CLOUD, are you there?	CLOUD、そこにいるの？	scene_08
AERIS!? You safe?	AERIS！？　無事か？	scene_08
Yeah, I'm all right.	うん、だいじょぶ	scene_08
I knew that CLOUD would come for me.	きっと、CLOUDが来てくれるって思ってた	scene_08
Hey, I'm your bodyguard, right?	ボディーガード、依頼しただろ？	scene_08
The deal was for one date, right?	報酬はデート１回、だったよね？	scene_08
…………oh, I get it.	…………………なるほど	scene_08
…!? TIFA! TIFA, you're there too!	……！？　TIFA！ TIFAもそこにいるの！	scene_08
EXCUSE me.	すいませんねえ	scene_08
You know, AERIS. I have a question.	あのね、AERIS。質問があるんだけど	scene_08
What?	な～に？	scene_08
Does the Promised Land really exist?	約束の地って本当にあるの？	scene_08
All I know is…	わたし、知ってるのは……	scene_08
The Cetra were born from the Planet, speak with the Planet, and unlock the Planet.	『セトラの民、星より生まれ 星と語り、星を開く』	scene_08
And……then…	えっと……それから……	scene_08
The Cetra will return to the Promised Land. A land that promises supreme happiness.	『セトラの民、約束の地へ帰る。至上の幸福、星が与えし定めの地』	scene_08
…What does that mean?	……どういう意味？	scene_08
More than words……I don't know.	言葉以上の意味、知らないの	scene_08
…Speak with the Planet?	……星と語り？	scene_08
Just what does the Planet say?	星が何か言うの？	scene_08
It's full of people and noisy. That's why I can't make out what they are saying.	人が大勢いて、ざわざわしてるかんじ。だから何を言ってるのか よくわからないの	scene_08
You hear it now?	今も聞こえるのか？	scene_08
I, I only heard it at the Church in the Slums. Mother said that Midgar was no longer safe. That is…my real mother.	わたし、聞こえたのはスラムの教会だけ。ミッドガルはもうダメだって 母さん……本当の母さんが言ってた	scene_08
Someday I'll get out of Midgar… Speak with the Planet and find my Promised Land.	いつかミッドガルから逃げなさい。星と話して、AERISの約束の地 見つけなさい	scene_08
…That's what mom said.	……母さんが言ってた	scene_08
I thought I would stop hearing her voice as I grew up, but…	大人になったら聞こえなくなるんだと思ってたけど……	scene_08
What's happened?	どうしたんだ？	scene_08
The door's open… When did it open?	ドアが開いている…… いつの間に？	scene_08
TIFA… Wake up!	TIFA……起きろ！	scene_08
Something's wrong. Look outside.	ようすがおかしい。外を見てみろ	scene_08
This's kinda eerie…	一体何があったのかしら……	scene_08
I wonder what happened…	なんだか恐いわ……	scene_08
He should have the key on him…	きっとここのカギを持っているはずだ……	scene_08
Come on, TIFA, get AERIS. I'll go help BARRET and the others.	ほら、TIFAはAERISを。俺はBARRETたちを助ける	scene_08
…What happened?	何かに襲われた……？	scene_08
BARRET, RED XIII …come with me. Something's wrong.	BARRET、RED XIII……来てくれ。ようすが変なんだ	scene_08
How'd you get in? Why's the door open!?	どうやって入ってきた？ どうして扉が開いているんだ！？	scene_08
The hell's goin' on!?	どうしちまったんだよ？	scene_08
No human could've done this.	人間の仕業ではないな	scene_08
I'll go on ahead.	私がこの先の様子を見てくる	scene_08
I'll clean up back here, so you guys go ahead. And don't get caught by Shinra!	こいつの後始末はオレにまかせて おまえらは先に行け。神羅に見つからねえうちによ！	scene_08
Come on, let's follow RED XIII!	さ、RED XIIIの後を追いましょう	scene_08
Jenova Specimen… Looks like it went to the upper floor using that elevator for the specimens.	ジェノバ・サンプル…… 察するに上の階に向かったようだ。奥のサンプル用エレベーターを使ってな	scene_08
It looks like it leads up…	何か目的に向かっているような…… 上に……？	scene_08
He's dead… The head of Shinra is dead…	死んでる……神羅カンパニーのボスが死んだ……	scene_08
Then this sword must be…	この刀は？！	scene_08
Sephiroth's!!	セフィロスのものだ！！	scene_08
…Sephiroth is alive?	……セフィロスは生きているのね？	scene_08
…Looks like it. Only Sephiroth can use that sword.	……そうみたいだな。この刀を使えるのはセフィロスしかいないはずだ	scene_08
Who cares who did it!? This is the end of the Shinra!	誰がやったっていいじゃねえか！これで神羅も終わりだぜ！	scene_08
Uh!	うひょ！	scene_08
P, p, p, please, don't kill me!	こここここころさないでくれ！	scene_08
What happened?	何があったんだ？	scene_08
Se…Sephiroth. Sephiroth came.	セ、セフィロス。セフィロスが来た	scene_08
Did you see him? Did you see Sephiroth?	見たのか？　セフィロスを見たのか？	scene_08
Yeah, I saw him! With my own eyes!	ああ、見た！　この目で見た！	scene_08
You really saw him?	本当に見たんだな？	scene_08
Uh! Would I lie at a time like this!? I heard his voice, too!	うひょっ！こんな時にウソなんか言わない！それに声も聞いたんだ、うひょっ！	scene_08
Um, he said something about not letting us have the Promised Land.	えっと『約束の地は渡さない』ってブツブツ言ってた	scene_08
Then does that mean	それじゃあ、なに？	scene_08
the Promised Land really does exist and that Sephiroth's here to save it from Shinra?	約束の地っていうのは本当にあってセフィロスは約束の地を神羅から守るためにこんなことを？	scene_08
So he's a good guy then?	いいやつじゃねえのか？	scene_08
Save the Promised Land? A good guy? No way!!	約束の地を守る？いいやつ？　ちがう！！	scene_08
It's not that simple! I know him! Sephiroth's mission is different!	そんな単純な話じゃない！俺は知ってるんだ！セフィロスの目的はちがう！	scene_08
Rufus! &*%$! I forgot about him!	ルーファウス！しまった！　アイツがいたか！	scene_08
Who's that?	誰なの？	scene_08
Vice President Rufus. The President's son.	副社長ルーファウス。プレジデントの息子だ	scene_08
I only know his name.	名前だけなら、私も知っている	scene_08
I heard that he'd been assigned somewhere else for a long time…	長期出張中だって聞いてたぜ……	scene_08
I wonder what sort of person he is?	どんな人なのかしら……	scene_08
I've heard that no one's ever seen him bleed or cry.	血も涙もない、そう聞いたこと、あるけど	scene_08
Rufus	ルーファウス	scene_08
So… So Sephiroth was actually here. …By the way,	そうか……やはりセフィロスは生きていたか。……ところで	scene_08
just who are you?	おまえたちはなんだ？	scene_08
I'm CLOUD, ex-SOLDIER, First Class!	元ソルジャー・クラス１ＳＴ。CLOUDだ！	scene_08
I'm from AVALANCHE!	アバランチだ！	scene_08
Me too!	同じく！	scene_08
A flower girl from the slums.	……スラムの花売り	scene_08
A Research Specimen.	……実験サンプル	scene_08
What a crew.	おかしな組み合わせだ	scene_08
Well, I'm Rufus. The President of Shinra, Inc.	さて、私はルーファウス。この神羅カンパニーの社長だ	scene_08
You're only President 'cause yer old man died!	オヤジが死んだらさっそく社長か！	scene_08
Correct. I'll let you hear my inauguration speech.	そうだ、社長就任のあいさつでも聞かせてやろうか	scene_08
…Father tried to control the world with money and that worked for him.	……オヤジは金の力で世界を支配しようとした。なるほどうまくいっていたようだ	scene_08
The people believed that Shinra would protect them.	民衆は神羅に保護されていると思っているからな	scene_08
Work at Shinra, get your pay. If terrorists attack, the Shinra army will help you.	神羅で働き、給料をもらいテロリストがあらわれれば神羅の軍隊が助けてくれる	scene_08
It looked perfect on the outside.	一見完璧だ	scene_08
But, I do things differently.	だが私のやりかたはちがう	scene_08
I'll control the world with fear. It's too much to do it like my old man.	私は世界を恐怖で支配する。オヤジのやりかたでは金がかかりすぎるからな	scene_08
A little fear will control the minds of the common people. There's no reason to waste good money on them.	恐怖はほんの少しで人の心を支配する。おろかな民衆のために金を使う必要はない	scene_08
He likes to make speeches just like his father.	私はオヤジとはちがうのだ	scene_08
Get AERIS outta the building!	演説好きなところはそっくりね	scene_08
What?	AERISを連れてビルから出てくれ！	scene_08
The hell's that supposed to mean?	説明はあとだ！BARRET！　本当の星の危機だ！	scene_08
I'll explain later! Just take my word for now! I'll go after I take care of him!	なんだそりゃ？	scene_08
Alright, CLOUD!	あとで話す！いまは俺を信じてくれ！俺はこいつを倒してから行く！	scene_08
Rufus	わかったぜ、CLOUD！	scene_08
You want the Promised Land and Sephiroth.	なぜ私と戦うのだ？	scene_08
Rufus	おまえは約束の地を求めてセフィロスを追う	scene_08
Rufus	ふむ、その通り	scene_08
…Whatever, I can't let either you or Sephiroth have the Promised Land!	ん？　おまえ、セフィロスが古代種だと知っているのか？	scene_08
Rufus	……いろいろあってな。とにかく、おまえにもセフィロスにも約束の地はわたせない！	scene_08
Access Menu with [MENU]	なるほど。友だちにはなれないようだな	scene_08
Remove Materia from members with [SWITCH]	【△ボタン】でメニューをひらく	scene_08
End with [START].	【□ボタン】で他のメンバーのマテリアをはずす	scene_08
Access Menu with [MENU]	【スタートボタン】で終了	scene_08
I couldn't finish 'em. This is gonna get complicated.	ルーファウスは？	scene_08
CLOUD… I just thought of something.	とどめはさせなかった。面倒なことになりそうだ	scene_08
…I'll wait for CLOUD! Everyone, get to the elevator!	CLOUD、なんか、思いつめてた	scene_08
Hmm, it's going to get pretty ugly from here on. We should check on our equipment.	……私、CLOUDを待つわ！みんなはエレベーターで先に！	scene_08
CLOUD and	さあ、この先きっとガードがきびしくなるわ。装備をととのえておいたほうがいいわね	scene_08
TIFA's Materia…	CLOUD、TIFAのマテリアを……	scene_08
(Remove)	【はずす】	scene_08
(Leave it)	【そのまま】	scene_08
Shinra Bldg. 3f. Lobby	神羅ビル・３階ロビー	scene_08
Hardy Datona	ハーディ＝デイトナ	scene_08
Quickly, we have to get out of here…	はやく、ここから逃げなくちゃ……	scene_08
Shinra Bldg. 2f. Lobby	神羅ビル・２階ロビー	scene_08
I'll go on ahead!	オレが先に行くぜ！	scene_08
*&^%(*… We're surrounded!	チッ……！すっかりかこまれてやがる	scene_08
If I was alone this wouldn't be a thing, but I gotta reputation to protect.	オレひとりならともかくこのメンツじゃ……	scene_08
You all get out while you can.	……やっぱり、あなたたちだけ逃げて	scene_08
It's not you they're after… it's me.	あの人たちがねらっているのはわたし。あなたたちだけなら……	scene_08
Yeah, well that ain't happenin'.	ヘッ、そうはいかねえな	scene_08
You got caught up in this over Marlene. Now, it's my turn to help you!	アンタはマリンを守るためにヤツらに捕まった。今度は、オレがアンタを守る番だ	scene_08
OK, playtime's over jackasses…	これ以上ヤツらの……神羅の好き勝手にはさせねえ	scene_08
…Thank you, Mr. BARRET!	……ありがと、BARRETさん	scene_08
Who you callin' Mr. BARRET? That don't sound right!	へヘッ、よしてくれよ。『BARRETさん』なんてオレのガラじゃねえや	scene_08
Well then…	……さて	scene_08
If you are through talking, may I suggest that we think of a way to get out of here.	キミたちの話が終わったならそろそろここから逃げ出す方法を考えてみないか？	scene_08
Huh? Oh, oh yeah… You're cold, man. Just like someone else 'round here I know.	ん？あ、ああ……チェッ、いやに冷静なやつだな。どこかの誰かさんみたいだぜ	scene_08
Did you say something?	なにか？	scene_08
Notta thing. So what're we gonna do?	いや、なんでもねえよ。さて、どうするか……	scene_08
TIFA! Where's CLOUD?	TIFA！CLOUDは！？	scene_08
Everyone! Over here!	みんな、こっち！	scene_08
Huh? What's up? Where's CLOUD?	ええ！？どうしたんだよ？CLOUDは？	scene_08
He's coming! Hurry, Hurry!!	話は後！いいから早く！！	scene_08
Nope. Have to find another way up, I guess…	反応がない……他のルートを探さなければ……	scene_08
[the movie continues]	ムービーへ続くのだ！	scene_08
[Shinra S-27]	『　神羅　　Ｓー２７式　』	scene_08
[Shinra PA-86]	『　神羅　　ＰＡー８６式　』	scene_08
[Shinra S-510]	『　神羅　　Ｓー５１０式　』	scene_08
[Shinra SA-37]	『　神羅　　ＳＡー３７式　』	scene_08
Turtle's Paradise Newsletter No. 2 The end of another hard day. Wouldn't you like to sit back with a tall cool one? You can at the Turtle's Paradise!! Stop in today! There's nothing like a smooth one after work!	【かめ道楽　通信】ナンバー２きびしい仕事でおつかれのアナタ……ぜひいちど居酒屋『かめ道楽』へ！！仕事の後の一杯は最高ですよ！	scene_08
Our slogan is: Shinra's Future Is The World's Future!! Mako Energy For A Brighter World!!	今週の標語神羅の未来は世界の未来！！魔晄の光で明るい世の中！！	scene_08
Until instructed, please don't open the disc holder.	指示があるまで、ディスクホルダーを開けないで下さい	scene_08
Control the bike with the [Directional buttons] and save your friends in the truck from the Shinra pursuit troops.	バイクを【方向キー】で操作して神羅の追撃隊から仲間の乗るトラックを守って下さい	scene_08
[OK]	○ボタン	scene_08
Attack on right	右の敵を攻撃する	scene_08
[SWITCH]	□ボタン	scene_08
Attack on left	左の敵を攻撃する	scene_08
[MENU]Menu	△ボタン　　　メニュー	scene_08
[CANCEL]Form Party	×ボタン　　　パーティ編成	scene_08
[START]Start Game	スタートボタン　　ゲーム開始	scene_08
Well, what do we do now?	さて、どうするよ？	scene_08
Sephiroth is alive. …I have to settle the score.	セフィロスは生きている。俺は……あのときの決着をつけなくてはならない	scene_08
Will that save the Planet?	それが星を救うことになるんだな？	scene_08
…It seems so.	……おそらく、な	scene_08
Then, I'm going!	おっし、オレは行くぜ！	scene_08
I'll go, too. There are things I need to know.	わたしも、行く。……知りたいこと、あるから	scene_08
About the Ancients?	古代種のことか？	scene_08
…Many things.	……いろいろ、たくさん	scene_08
I guess it's good bye, Midgar.	さらばミッドガル、ね	scene_08
We told AERIS's mom to go somewhere safe, so Marlene should be safe, too.	AERISのおふくろさんには安全な場所に移るようにって言っといたからマリンも安全だな	scene_08
Hmm, I don't know	さ～て、どうかな	scene_08
She said she didn't want to stay in Midgar anymore. …Maybe it's for the best.	もう、ミッドガルはイヤだって言ってた……ちょうど良かったかな	scene_08
Stop it, CLOUD! I'm worried, too.	やめてよ、CLOUD！わたしだって心配なんだから	scene_08
You know what? This is the first time I've ever left Midgar…	そういえば、わたしミッドガル出るの、初めて……	scene_08
Really? Are you worried?	そうか……不安か？	scene_08
It's dangerous. Are you sure you want to go?	危険だぞ、いいのか？	scene_08
A little…no, maybe a lot. But I have a bodyguard, right?	ちょっと、う～ん、かなり、かな。でも、なんでも屋さんがいっしょだし、ね？	scene_08
I thought you'd say that!	言うと思った！	scene_08
…I guess this is the start of our journey…	……旅がはじまるのね	scene_08
You hate traveling?	旅はきらいか？	scene_08
…I don't know. But, I don't have anywhere else to go. So I guess it doesn't really matter whether I like to travel or not.	……どうかな。でも、もう帰るところないもの。旅が好きとかキライとか関係ないわ	scene_08
…Hmm. But you know, it should be all right if you keep your promise.	……う～ん。でもほら、CLOUDが約束守ってくれればだいじょうぶよね、きっと	scene_08
I'm going back to my hometown. I'll go with you as far as that.	私は故郷に帰るつもりだ。それまではいっしょに行ってやる	scene_08
Let's stay here for a while	もう少しここにいよう	scene_08
Let's go!	行こうか！	scene_08
To the Northeast, there's a town called Kalm.	ここから北東に行くとカームって町があるんだ	scene_08
The food at the Inn's good. Why don't we head there first?	宿屋のメシがうまくてなあ。とりあえずそこに行かねえか？	scene_08
You're right. I've heard about that town before. CLOUD?	そうね。聞きたいこと、いろいろあるしね。CLOUD？	scene_08
About Sephiroth, and about the crisis of the Planet…	セフィロスのこと、そして星の危機……	scene_08
You're right. We need to know where Sephiroth went.	そうだな。セフィロスの行方の情報も必要だからな	scene_08
We need a leader for our journey. Course that could only be me.	ここから先団体行動にはリーダーが必要だ。リーダーといえばオレしかいねえ	scene_08
You think so?	そうかしら……	scene_08
I think it should be CLOUD.	どう考えてもCLOUD、よね	scene_08
^#$^%…alright. Go Northeast to a town called Kalm. If something happens, we'll meet up there.	チッ…………わかったよ。ここから【北東にカームって町】があるんだ。何かあったらそこを集合場所にしよう	scene_08
'Sides, we can't have five people strolling around out there. It's too dangerous. Let's split into two parties…	それにしたって野っ原を５人でゾロゾロ歩くなんて危なくてしょうがねえ。おまえ、パーティーを２組に分けてみろ	scene_08
Change with [CANCEL],	【キャンセルボタン】でパーティチェンジ	scene_08
…That's an unexpected	……予想外の	scene_08
…combination.	……組み合わせ	scene_08
Well, have fun…boys.	まあ、男同士、楽しくやりなさい	scene_08
We'll see you at Kalm!	それじゃあ、カームで！	scene_08
…Thought you'd do that.	……やると思ったぜ	scene_08
Later, at Kalm!	じゃあ、カームでな！	scene_08
That's funny…I dropped the key to this gate…somewhere. Must've been on that excavation tour.	おっかしいな？このゲートのカギ……どこかに落としたかな？この前のハックツ・ツアーの最中かな？	scene_08