Kalm	カーム	scene_09
Rear Tower (Pagoda)	裏の塔	scene_09
Inn: 1f	宿屋１階	scene_09
Inn: 2f	宿屋２階	scene_09
CLOUD's Past	CLOUDの過去	scene_09
Received "Peacemaker"!	『ピースメーカー』を手にいれた！	scene_09
Received "Guard Source"!	『ガードアップ』を手にいれた！	scene_09
…Dropped "Megalixir"!	……『ラストエリクサー』が落ちてきた！	scene_09
Received "Underwater" Materia!	『せんすい』のマテリアを手にいれた！	scene_09
Received "Master Magic" Materia!	『マスターまほう』のマテリアを手にいれた！	scene_09
Received "Master Command" Materia!	『マスターコマンド』のマテリアを手にいれた！	scene_09
Received "Master Summon" Materia!	『マスターしょうかん』のマテリアを手にいれた！	scene_09
Empty…	からっぽだ……	scene_09
Can't reach it…	手がとどかない……	scene_09
This is Kalm.	ここが、カームだ	scene_09
We've reached Kalm.	カームに着いたね	scene_09
So this is Kalm?	ここが、カームね	scene_09
…this must be Kalm.	……カームに着いたな	scene_09
Yo, I'll be waitin' at the inn… Hurry and get your butt over there!	おい、先に宿屋で待ってるぜ。チンタラせずに、早くこいよ！	scene_09
I wonder if everyone's there already? Let's hurry over to the inn!	みんな、もう着いてるかな。はやく宿屋に行きましょ！	scene_09
Everyone's waiting at the inn. Let's go CLOUD.	宿屋でみんなが待ってるわ。行きましょう、CLOUD	scene_09
We're supposed to meet at the inn. …Shall we go?	宿屋でおちあう手はずだったな。……行くか	scene_09
Get over here!	とっとと来いよ	scene_09
Well then, I'll go on ahead.	じゃあ、先、行ってるね	scene_09
Let's go CLOUD.	行きましょう、CLOUD	scene_09
Let's go CLOUD.	行こう、CLOUD	scene_09
Thanks to the Mako energy Shinra, Inc. develops for us, everything's more convenient now.	神羅カンパニーが魔晄エネルギーを実用化してくれたおかげでわしらの生活も便利になったもんじゃ	scene_09
Maybe a little too convenient.	ちと、便利になりすぎたかもしれんがの	scene_09
I hear that the natural resources near the reactors are being sucked dry.	魔晄炉のある場所の土地はどんどんやせていってしまうという話だ	scene_09
We're better off with the Mako energy.	この町みたいに魔晄エネルギーは供給してもらうだけってのが一番いい方法なのさ	scene_09
The famous floating city, Midgar… Just once I'd love to see it in person.	空中に浮かぶ都市と言われるミッドガル。一度、この目で見てみたいものだわ	scene_09
What does it do? It checks the pressure of the Mako energy sent from Midgar.	何をしているのかって？ミッドガルから送られてくる魔晄エネルギーの圧力をチェックしてるのさ	scene_09
This is the Item Store.	ここは、アイテム屋だよ	scene_09
This is the Weapons Store.	ここは、武器屋だよ	scene_09
This is the Materia Store.	ここは、マテリア屋だよ	scene_09
I heard terrorists bombed a Midgar reactor…	ミッドガルじゃ、テロリストが魔晄炉を爆破したらしいぜ	scene_09
There have been a lot of dangerous accidents recently. I hate it, just hate it.	最近、ぶっそうな事が多いよな。やだ、やだ	scene_09
It seems there was this group called AVALANCHE runnin' around, but I guess SOLDIER finally wiped them out.	ミッドガルでは、アバランチという反神羅組織が活動していたらしいがついに神羅のソルジャーによって全滅させられたそうだな	scene_09
Shinra is trying to eliminate anyone, who stands up to them.	神羅カンパニーは、自分たちに逆らう者たちを、どんどん排除しようとしている	scene_09
It don't matter if we like it or not. Shinra's taken over, and we gotta live with it!	我々は、好むと好まざるに関わらず神羅カンパニーの支配を受け入れなければならないのさ	scene_09
Stay out of the kitchen.	ちゅうぼうに入ってこないでおくれ	scene_09
I heard President Shinra was killed. And his son Rufus, the new president, was badly hurt.	プレジデント神羅が殺されたそうだな。それに息子のルーファウス新社長も大ケガしたっていうじゃないか	scene_09
Hey, I bet that's news to you?	どうだ、初耳だろ？	scene_09
You're pretty smart!	おっ、事情通！	scene_09
Heh, heh…Just between us… I heard it was them Ava-whaddya call-ums that got President Shinra and his son.	ふふふ……ここだけの話だが神羅親子を襲ったのはアバラなんとかいう組織だって話だぜ	scene_09
Don't care? If you're going to travel, you'd best keep an eye on what Shinra's doing.	関心なしか？旅をするなら神羅カンパニーの動きには注目したほうがいいぜ	scene_09
When I grow up I'm gonna be in SOLDIER. That's why I'm training hard now!!	ぼく、大きくなったら神羅のソルジャーになるんだ！そのために、いまからモウクンレンしてるんだ！！	scene_09
My older brother's so stupid. He's so embarrassing I could just puke!	……お兄ちゃん、子供っぽくてわたし、はずかしい	scene_09
Hyah, hayah, eagghh!	うりゃー、アシコシのタンレン～	scene_09
Hyah, hayah, eagghh!	うりゃー、コンジョウのトックン～	scene_09
Hyah, hayah, eagghh!	うりゃー、うりゃ、うりゃ～	scene_09
Thanks to Mako energy, life's pretty darn convenient. Thanks to Shinra.	魔晄エネルギーのおかげで生活が色々と便利になったわ。神羅さまさまよね	scene_09
Don't you think?	あなたも、そう思うでしょ？	scene_09
Yeah, maybe	そうかもしれない	scene_09
You're full of it	そんなことはない	scene_09
See!? How would we get by without Mako energy?	そうでしょ！もう、魔晄エネルギーのない生活なんて考えられないわね	scene_09
Hmm. But I'd hate to think of what life'd be like without Mako energy.	ふ～ん。でも、魔晄エネルギーのない生活なんて、私は考えられないわね	scene_09
Mako energy's made things a lot more convenient…	魔晄エネルギーのおかげでいろいろと便利になったけど……	scene_09
But a lot of plants and animals have been disappearing at a rapid pace.	でも、そのかわりに動物や植物がどんどんへっているような気がするわ	scene_09
I think the old life was better.	わたしは、むかしの方がよかったんじゃないかと思うの	scene_09
Don't you think so?	ね、そうよね？	scene_09
Yeah, sure I'm right! You think so, don't you?	そうでしょ？　そう思うわよね	scene_09
That's just what my mom said.	お母さんとおなじことを言うのね	scene_09
Things were better when you could play with animals…	私は、動物とあそべたころの方がよかったと思うわ……	scene_09
Listen to me! Something really big's happening in Midgar.	あっ、聞いてくれよ！なんかミッドガルにでっかい大砲がついちゃって、すごい事になっているよ	scene_09
They were just saying on TV it was Rufus' second strategy and…	テレビによると、ルーファウスの２つめの作戦だとか……	scene_09
That big cannon's pointed due north… Do you think the target is Sephiroth?	あの大砲は真北に向いてるけど……目標は……セフィロス？？	scene_09
Everyone at Shinra's in an uproar because they heard Weapon's coming.	ウェポンがやってくるって神羅カンパニーの人間は大騒ぎしとるよ	scene_09
I heard a big hydroplane carrying secret weapons, was attacked by Weapon and was sunk at sea…	秘密兵器を運んでいた飛空艇が空を飛ぶウェポンに襲われて海に沈んでしまったとか何やら……	scene_09
If something ever happened to President Rufus, That'd be the end of Shinra, Inc. and the rest of the world, too.	ルーファウス社長がいなくなってはもう、神羅カンパニーもおしまいじゃな。……そして、この世界も	scene_09
Did you say you came from Midgar?	おまえたち、ミッドガルから来たんじゃと？	scene_09
I used to live there, too. But I heard they got lots of troubles lately.	わしも以前ミッドガルに住んでいたんじゃが近頃はあそこも色々あるようじゃな	scene_09
Is it true that Shinra makes monsters?	モンスターってのは神羅がつくったってウワサがあるがホントかねえ？	scene_09
It's true	そのとおり	scene_09
Just a rumor	たんなるウワサ	scene_09
Yeah, well either way, as long as we use reactors, we can't stand up to Shinra.	どっちにしたって魔晄炉の世話になってるかぎり神羅にゃさからえないんだけどね	scene_09
There was a suspicious-looking man in a black cloak! He was carrying a mean-looking sword.	怪しい黒マントの男がこの町にいたんだ！ぶっそうな刀なんか持ち歩いてさ	scene_09
They say Midgar's in the middle of a war between the Shinra and some terrorists called AVALANCHE.	ミッドガルじゃ、神羅とアバランチとかいうヤツらが戦争しているそうじゃないか	scene_09
20 gil a night. What's it gonna be?	一泊、２０ギルです。とまっていかれますか？	scene_09
Mr…CLOUD? Your party is waiting for you on the 2nd floor.	CLOUDさまですね。お連れさまが２階でお待ちです	scene_09
Shinra's leading the world around by the nose, and you guys are just gonna sit back and take it?	この世界は、神羅カンパニーの動きにふりまわされているのさ。あんたたちも、それを受け入れる事だな	scene_09
Me? I used to work in a mine down south called Mythril Mine	オレはよぉ、この町の南にある鉱山【ミスリルマイン】で働いていたんだ	scene_09
But, awhile back, monsters started appearing.	しかしよぉ、その鉱山にモンスターがわんさか出るようになっちまってな	scene_09
After that, business went to pot and now I spend the days here drinking.	おかげで、商売あがったり。ここで日がな１日飲んだくれてるのさ	scene_09
Urrrp!…hic… I'm stinking drunk!!	ウィ～、ひっく。オレはヨってるぞォ～！！	scene_09
Seems like you're a little short. Why don't you drop by again… when you have money.	お金が足りないようですね。またのおこしを、お待ちしています	scene_09
Why doesn't anyone believe me? I'm so lonely…	なんで、誰も信じてくれないんだ～！……こどくなボク	scene_09
Listen to me! Just now, some guy in a black cloak walked east towards that grassy field.	あっ、聞いてくれよ！たった今、黒マントの男が東の草原に向かって歩いていったんだ	scene_09
He's got this killer sword, and looks REAL scary…	ぶっそうな刀なんか持ち歩いてさ。なんか、おっかないヤツだったよ……	scene_09
Aw, c'mon! Listen to me! Got anything interesting to say?	あっ、聞いてくれよ！	scene_09
Locked. Can't open it…	何か、おもしろいことでもないかなぁ……？	scene_09
I gotta hurry up and get strong so I can crush Meteor to bits! But I gotta train real hard to do it.	カギがかかっていて、開かない……	scene_09
Oh man, oh man!	ぼく、はやく強くなってメテオをぶっこわしてやるんだ！そのために、いまからモウクンレンするんだ！！	scene_09
Meteor's gonna fall on us, and now some huge monster like I've never seen is wandering around out there!	見たことも聞いたこともないようなでっかいモンスターはうろつきまわるしメテオは落っこってくるし……	scene_09
What's going to happen to all of us?	あ～、ボクたちはどーなってしまうんだ～～～～～！！	scene_09
I want you to stop that talk about Meteor falling on us!	メテオが落ちてくるだって！？やめてほしいぜ、そーゆーことはよ	scene_09
Listen, I work hard…and now you're tellin' me Meteor's gonna smash everything to bits?	今までいっしょうけんめい働いてきたのによぉ メテオでみんな、パーになっちまうってか！？ 	scene_09
Well, I ain't standin' around listenin' to fool talk like this. Makes a person lose the will to work, that's what it does!	ケッ、ばからしくて、やってられっかよ。まじめに働く気なんか失せちまったぜ	scene_09
What're ya, dense? Something like that'll never happen! It's ridiculous!	ケッ、やってらんねーよ。ばからしいったら、ありゃしねぇ	scene_09
And all of Midgar's gonna be destroyed by a falling meteor? Oh, don't make me laugh!	ミッドガルじゃ、メテオを破壊しようとおおわらわらしいぜ	scene_09
I heard the remaining members of AVALANCHE smashed the Shinra troops at Midgar.	ミッドガルじゃ、アバランチの残堂が神羅カンパニーを叩きつぶしたらしいぜ	scene_09
They say the remaining members of AVALANCHE broke Shinra's resistance and destroyed the Mako cannon at Midgar.	ミッドガルでは、アバランチの残堂が神羅カンパニーの抵抗をはねのけて魔晄キャノンを破壊したという話だ	scene_09
What's going to happen to the world?	これから、この世界はどうなってしまうのだろう……	scene_09
I heard Shinra's taking it's biggest artillery from Junon and other facilities and gathering it in Midgar to fight Meteor and Weapon.	神羅カンパニーは、メテオやウェポンに対抗するため、各地の施設から役にたちそうなものを、ジュノンやミッドガルに集めているという話だ	scene_09
Even if Meteor falls, you ought to be safe as long as you're in Midgar.	ミッドガルに行けば、あのメテオが落ちても大丈夫なんじゃないかしら？	scene_09
They say it's a "Mako Metropolis" so it will survive.	『魔晄都市』って言うくらいだからなんとかなりそうな気がするんだけど……	scene_09
Ah, youth… You really believe that big meteor filling up the sky is going to fall?	お若いの、空いっぱいに見えとるあのメテオが落ちてくるなんて信じられるかの？	scene_09
If that's the case then all we can do is put our hope in Shinra, Inc.	こうなってしもうては神羅カンパニーだけがわしらの頼りじゃて	scene_09
If Shinra, Inc. was our last hope, and they've been beaten by terrorists… Are we all going to die?	最後の頼みの神羅カンパニーもテロリストにやられてしもうて……わしらはこのまま死ぬのかのぉ？	scene_09
Meteor's going to fall, isn't it? Then we're all history unless Shinra does something about it!	メテオが落ちてくるんだろ？神羅カンパニーがなんとかしてくれないとみんな死んでしまうことになるな	scene_09
Why're you checking the Mako energy pressure at a time like this? It's probably already too late.	いまさら魔晄エネルギーの圧力をチェックなんてしてもしかたがないのだろうけど……	scene_09
You can't go into a tail spin at a time like this. You've got to keep living just like before. At least that's what I think…	こんな時だからこそ、ヤケにならずに今までどおりキチンと生活していかなきゃいけない、そう思うんだ	scene_09
They say Meteor's going to fall, but that's okay! I'm sure Shinra'll come through for us in the end!	メテオが落ちてくると言うけど大丈夫！そんなもの、神羅カンパニーがきっとなんとかしてくれるわよ	scene_09
Dear, can you believe it? They say that Shinra's gone under!!	あなた、信じられる！？あの神羅カンパニーがつぶれちゃったんですって！！	scene_09
This world is coming to an end all because some terrorists called AVALANCHE stuck their noses in the wrong place!	アバランチなんていうテロリストが余計なことしてくれたおかげでもう、この世はおしまいよ	scene_09
I can't believe Meteor's really falling this way… What's going to happen to us?	メテオが落ちてくるなんて……わたしたちは、どうなってしまうのかしら？	scene_09
Meteor's coming, right? Where will I stash my money? Wait, maybe I'd better take it with me and get out of here!	メテオが落ちてくるんでしょ？ヘソクリ、どこにかくそうかしら……いや、それよりもヘソクリを持ってどこかへ逃げ出した方がいいのかしら？	scene_09
One night, 300 gil. Wanna check in?	一泊、３００ギルです。とまっていかれますか？	scene_09
Tourists, huh? Here are a few things you should know that will come in handy when you travel around the world…	ん？　あんた、旅行者だね。世界を旅する時に知っておくと役立つことがあるのだけれど……	scene_09
Want to hear what they are?	教えて欲しいかい？	scene_09
Then let me explain how to use the world map.	それじゃ、ワールドマップでのコントローラ操作について説明してあげるとしよう	scene_09
Well then, what do you want to know?	さて、何を教えてあげようか？	scene_09
Changing camera angles	視点の切替について	scene_09
Map indicators	地図の表示について	scene_09
Operating the buttons	ボタン操作について	scene_09
Anything else you'd like to know?	他に何か、ききたいことがあるかい？	scene_09
Nope, I got it	もう、いいです	scene_09
First press [CAMERA] to change the camera angle.	まず、ワールドマップではコントローラの【Ｌ２ボタン】を押すと視点を変えることができる	scene_09
There are 2 angles to choose from, select the one you like.	選べる視点は２種類あるから自分の好きな方を選ぶといいね	scene_09
Then rotate the camera either way by pressing [PAGEUP] or [PAGEDOWN].	そして【Ｌ１ボタン】や【Ｒ１ボタン】を押してやれば、視点を左右に回してやることができるんだ	scene_09
Try different angles until you find the one you like best. It makes the journey a lot more fun!	いろいろ試してみて自分にあった視点をさがしてやれば旅は、もっと楽しくなると思うよ	scene_09
Press [START] once to view the World Map.	この世界の地図は【スタートボタン】を押してやると、見ることができる	scene_09
There is a large and small map. Learn when to use which and you won't get lost.	地図には、大きいものと小さいものがあるから場合によって使い分けてやれば道に迷うことも少なくなると思うよ	scene_09
Push [START] twice to change the size of the map, and once more to turn it off.	【スタートボタン】を何回か押してやれば地図を切り替えたり、消すことができるんだ。便利だろ？	scene_09
Pretty easy, huh?	[COULDN'T FIND]	scene_09
Ride things by pressing [ASSIST] and get off by pressing [CANCEL]. This isn't so hard, either!	【決定ボタン】を押せば、乗り物に乗り【キャンセルボタン】を押せば乗りものから下りる。このへんは、そんなに難しくないね	scene_09
Oh, right. You can't dash on the World Map, so make sure not to press [CANCEL] unless you want to get off.	あ、そうそう。ワールドマップではダッシュができないから【キャンセルボタン】は、乗り物から下りるときにしか押さない方がいいね	scene_09
Remember this because Chocobos will run away as soon as you get off them, so be careful.	特にチョコボは下りると逃げちゃうからね。気をつけた方がいいよ	scene_09
Once on the World Map you can access the menu to save your game anywhere. It's a good idea to save frequently!	ワールドマップではメニューを開けばどこでもセーブできるからセーブはこまめにとったほうがいいよ	scene_09
Well then, bon voyage!	それじゃ、よい旅を	scene_09
Is that so? Well, that's that. Have a nice trip.	そうかい？　それは残念。それじゃ、よい旅を	scene_09
Damn!!	……いいかげんに、しろっ！！	scene_09
Oh! You!!	ん、もうっ！！	scene_09
…don't mess with me!!	……なめてんじゃねぇっ！！	scene_09
Huh? You're looking for your friend? You want to know where the Lifestream is?	え？　友人をさがしてる？ライフストリームはどこかって？	scene_09
Hmm, I can't help you find your friend, but I've heard about the Lifestream.	ん～、君の友人の事はしらないけどライフストリームについては聞いたことあるよ	scene_09
When I traveled to the Southern islands, a doctor was very kind to me. I seem to recall him telling me something about the Lifestream…	【南の島】に旅行に言った時ある医者に世話になったんだけどその時に医者からそんな言葉を聞いたような覚えがあるけど……	scene_09
Hey, listen to me! The Shinra troops are on the move.	あっ、聞いてくれよ！神羅軍の動きが活発になってきたんだ	scene_09
The TV news said Rufus came up with two plans. One, is to launch a rocket into space containing Huge Materia…	テレビによると、ルーファスは２つの作戦を打ち立てたらしいね。なんでもその１つはヒュージマテリアを集めて、ロケットで宇宙に飛ばすとか……	scene_09
Is Huge Materia really that destructive?	ヒュージマテリアの破壊力ってのはそんなにすごいのかなぁ？	scene_09
Sephiroth put up a huge barrier around the North Crater.	北のクレーターにセフィロスは巨大なバリアをはったんだ	scene_09
Rufus wants to use a mammoth cannon to smash the barrier.	ルーファスは、あの大砲でそれをぶち壊す計画なんだ	scene_09
He plans to have Shinra troops rush in and attack Sephiroth after the barrier falls.	バリアがなくなったスキに神羅軍でセフィロスを直接攻撃するつもりなのさ	scene_09
The North Crater barrier's been demolished?	北のクレーターのバリアがブッこわれたんだって！？	scene_09
So now's the time to defeat Sephiroth.	じゃあ今こそが、セフィロスを倒す好機なわけだ	scene_09
Hey, listen to me! I heard the barrier protecting Sephiroth is gone!	あっ、聞いてくれよ！セフィロスを守っていたバリアはなくなったんだって！	scene_09
But with Rufus dead, the Shinra troops don't know what to do. Heidegger and Scarlet don't have what it takes to lead the troops.	でも、ルーファスが死んでしまったから神羅軍は右往左往するばかり。ハイデッカーやスカーレットじゃ神羅をまとめるには力不足だし……	scene_09
I really thought something was finally going to happen, but everything's the same… Not a damn thing changes around here!	せっかくなんとかなると思ったのにこれじゃ、何も変わってないのと同じじゃないか～！	scene_09
My old man was a miner, but he couldn't go to work after monsters started appearing in the Mythril Mines.	ボクのお父さん、炭鉱夫なんだけどミスリルの鉱山にモンスターがでてきて仕事ができなくなっちゃったんだ	scene_09
Now all he does is sit around getting drunk in the bar…	今じゃ、この奥の酒場でお酒ばっかり飲んで酔っぱらっているよ	scene_09
My dad still just sits at the bar drinking, even though he knows Meteor's coming!	ボクのお父さん、もうすぐメテオが落ちてくるというのにこの奥の酒場でお酒ばっかり……	scene_09
It's sad. Even though he's an adult, he just doesn't want to see the world as it really is. I dunno what to do.	いい大人のクセに、現実見えていないってのは、情けないよね。まいっちゃうなぁ、もう	scene_09
South of this town past the Mythril Mine and far to the west is a Shinra harbor called Junon.	この町の南にある【ミスリルマイン】を抜けてさらに西へ行くと【ジュノン】という神羅カンパニーの港があるの	scene_09
They say there's a reactor and many tall buildings there. I hope to see it someday.	そこにも魔晄炉があって大きな建物がたくさん建っているそうよ。ああ、行ってみたいわぁ	scene_09
The world's at peace… all's well.	すべて、世は事もなし……、っと。和平じゃのう	scene_09
Tomorrow's another day… all's well.	明日は明日の風がふく……、っと。和平じゃのう	scene_09
I got my health, and enough to eat… all's well.	今日も元気だ、ごはんがうまい……、っと。和平じゃのう	scene_09
The world's changed a lot in the past few days…	この数日で、この世界は大きく様変わりしてしまった……	scene_09
That huge Meteor is covering up the sky and acting like it owned it.	天空をおおうメテオ……我が物顔でかっぽする巨大なモンスター……	scene_09
A lot of my friends have died…	……ワシの友人も、おおぜい死んでしまった	scene_09
I'm goin' on a journey to pray for their souls.	ワシは、死んでしまった友人たちのめいふくをいのる旅に出ようと思う	scene_09
A map that was sunk along with the ship. ..."Guidebook" A rose that blooms once every 1000 years in the desert. ..."Desert Rose" A harp that soothes those who hear it. ..."Earth Harp"	沈ぼつ船とともに沈んだというめい界の地図。……【ガイドブック】千年に一度、砂ばくにさくという花。……【デザートローズ】きく者の心をおだやかにするたてごと。……【アースハープ】	scene_09
I wonder if there's anyone who'll bring it to me?	誰かワシのもとに持ってきてくれる人はおらんかのう……	scene_09
Now if I can just get the "Guidebook", I can start my journey…	あとは【ガイドブック】さえあれば旅に出られるのじゃが……	scene_09
Now if I can just get "Desert Rose", I can stary my journey…	あとは【デザートローズ】さえあれば旅に出られるのじゃが……	scene_09
Now if I can just get "Earth Harp", I can start my journey…	あとは【アースハープ】さえあれば旅に出られるのじゃが……	scene_09
"Guidebook" and "Desert Rose"… Will you guys look for them for me?	【ガイドブック】と【デザートローズ】……おぬしたち、探してきてくれんか？	scene_09
"Guidebook" and "Earth Harp"… Will you guys look for them for me?	【ガイドブック】と【アースハープ】……おぬしたち、探してきてくれんか？	scene_09
"Desert Rose" and "Earth Harp"… Will you guys look for them for me?	【デザートローズ】と【アースハープ】……おぬしたち、探してきてくれんか？	scene_09
OH! It's "Guidebook"! Wanna trade it for this Underwater Materia?	おお、それは【ガイドブック】！ワシの持っている【水中呼吸マテリア】と交換せぬか？	scene_09
How about it?	どうじゃ？	scene_09
Trade	交換する	scene_09
Don't trade	交換しない	scene_09
OH! It's "Desert Rose"! Wanna trade it for that Chocobo over there?	おお、それは【デザートローズ】！ワシのペットの【チョコボ】と交換せぬか？	scene_09
OH! It's the Earth Harp! Wanna trade it for some Master Materia?	おお、それは【アースハープ】！ワシの持っている【マスターマテリア】と交換せぬか？	scene_09
I'm not bein' stingy either! I'll give you all three of 'em!	１個なんてケチな事は言わん！３個セットにして渡すぞ	scene_09
Ok then, it's a done deal!	よし、交換成立じゃな	scene_09
I dunno…	何が不満なんじゃ……	scene_09
it's Underwater Materia. Go on, it's yours!	【潜水マテリア】じゃ。持っていってくれ	scene_09
It's a Chocobo. Take it, it's yours!	【ウルトラチョコボ】じゃ。連れてゆくがええ	scene_09
It's a 3-piece Master Materia set, …and it's all yours!	【マスターマテリア３点セット】じゃ。持っていってくれ	scene_09
I guess it's time to go on a journey for the souls of my departed friends…	では、ワシはとむらいの旅に行くとするか……	scene_09
Looks like my Stable's full. I'll come back when I have room.	『チョコぼう』がいっぱいだな。空きをつくってから連れていくことにしよう	scene_09