Haa--ah! Gotcha! And you deserve it, too!	ヘヘーん！やーい、だまされただろ！ザマーミロ！	scene_13
Hey, we been had! And…my money!	あっ、やられた！アイツ、オレの金を！	scene_13
Hey! My money!	アッ！私のお金、少なくなってる！	scene_13
Hmm…Hey, don't we have less money than before?	あれ……ね、お金、へってない？	scene_13
… Some money is missing.	…………金が減っているな	scene_13
Hey! My emergency money!	アッ！オイラのヘソクリが！	scene_13
Gil, gil, gil, where's my gil!?	ギ、ギルが～ボクのギルがあらへん～！	scene_13
What the--!? Gone! My money's gone!	あああッ！？ねえ！　ねえぞ！　金がねえー！	scene_13
Hmm? Pretty fast.	おや……？なるほど……すばやいな	scene_13
200 Gil Stolen!	２００ギル盗まれた！	scene_13
500 Gil Stolen!	５００ギル盗まれた！	scene_13
700 Gil Stolen!	７００ギル盗まれた！	scene_13
1000 Gil Stolen!	１０００ギル盗まれた！	scene_13
&^%$!! Gimme back my money!!	チクショ～！！オレの金、かえせ～！！	scene_13
Wait a second! Where's my money!?	ちょっと待ちなさい！私のお金は！？	scene_13
Geez! You shouldn't have done that!!	も～う！！だめじゃない、こんなコトしちゃ！！	scene_13
Greed…A perfect example of human nature.	金に目がくらむ……じつに人間らしい行動だな	scene_13
Give…give back what is rightfully mine!	か、返せよ～！オイラのなんだぞ～！	scene_13
Hey, you can't! My gil, give it back!	ちょっと、アカンて！ボクのギル、返して～な～！	scene_13
Steal MY money, will ya? You got a lot of #&^%$ nerve!!	オレ様から金をくすねるたあいい度胸じゃねえか！！	scene_13
Just remember who you're dealin' with, punk!!	覚えてやがれ、このガキ！！	scene_13
The gil doesn't seem be her real objective…	ギルが目的、というわけでもなさそうだがな……	scene_13
Wassup with that broad?	なんなんだ、アイツ？	scene_13
CLOUD, do you know her?	CLOUD、あのコ知ってるの？	scene_13
Who is that girl?	だ～れ？あのコ……	scene_13
You don't see one like that everyday…	……みなれない格好をしているな……	scene_13
Who is that girl? She's still a child.	何なんだい、あいつ。まだコドモじゃないか	scene_13
Who do you think she is? I don't recognize her face.	なんやろ、アレ。知らん顔ですなぁ	scene_13
Who is that kid?	なんだ、あいつはよう？まだガキじゃねえか！	scene_13
She has a mysterious weapon. I've seen her somewhere before…	不思議な武器を持っているな……どこかで見た記憶がある	scene_13
Man… I can't believe I lost.	チクショ～……このアタシが負けるなんて……	scene_13
You spikey-headed jerk! One more time, let's go one more time!	やい、このツンツン頭！もう１回、もう１回勝負だ！	scene_13
Hey, boobs! Try that again! Just one more time!	やい、このオッパイ女！もう１回、もう１回勝負しろ！	scene_13
What did you say!?	言ったわね！	scene_13
Don't fight	やめておくわ	scene_13
Hey, you bow-legged ol' man! Give me another chance! I'll fight ya!	やい、このガニマタオヤジ！もう１回、もう１回勝負だ！	scene_13
Give her a lickin'	ボコボコにしてやる！	scene_13
Forget it!	やなこった	scene_13
I won't lose this time! Take your time and get ready. Holler when you're ready!	今度は負けないからね！時間をやるから、用意しなよ。カクゴができたらかかってきな！	scene_13
No way I'm going to fight with a punk like you more than once!	フーンだ、誰がアンタらみたいなザコと何度もたたかうもんか！	scene_13
I'll save enough for the doctor bill! Next time, you won't be as lucky!	ケガの治療費はいただいとくよ！次はようしゃしないからなー！	scene_13
Thinkin' of running away? Stay and fight! FIGHT, I said!	ム、逃げる気？ちゃんと勝負しろ！しろったらしろ！	scene_13
C'mon… What's the matter?	シュッシュッ……どうしたどうした！	scene_13
You're pretty scared of me, huh!?	アタシの強さにビビッてんだろ！！	scene_13
Petrified…	……まあな	scene_13
You're gonna lose again	何度やっても同じだ	scene_13
Petrified…	……まあね	scene_13
You're outta your league!	あなたにはムリよ	scene_13
Something like that	そういうこった	scene_13
You're wasting your time	やるだけムダだぜ	scene_13
Wh…what!?	な、な、なんだと！？	scene_13
Uuuuugh! Now I'm really mad!	キー！　ムキキー！！アッタマきたあ！	scene_13
Make fun of me, will ya! Just watch!!	バカにしやがって……おぼえてろォ！！	scene_13
Hmm, just as I thought. What do you expect with my skills?	ヘヘ、や～っぱりそうか。ま、アタシの実力からいえばそれも当然だネ	scene_13
Good luck to you guys, too. If you feel up to it, we can go another around. Later!	アンタらもがんばれよ。また気が向いたら相手してやるからさ、んじゃね！	scene_13
She's gone… What's with her?	行っちゃった……なんなの、あのコ……	scene_13
Gone… Wassup with that?	行っちまった……なんだったんだ、アイツ……？	scene_13
She's gone… So what was that all about?	行っちゃった……けっきょく、何だったのかな？	scene_13
She's gone… So what did that prove?	行ってしまった……いったい何がしたかったんだ？	scene_13
Huh? She's gone… What is she doing?	アレレ、行っちゃったよ……あいつ、何やってんだろ？	scene_13
…She disappeared… I have no clue what happened.	……消えよった。なんや、サッパリわかりませんわ	scene_13
She's gone, hey… What's with that kid!?	行っちまったよ、オイ……何なんだ、あのガキは！？	scene_13
… What could her motivation have been?	…………理解に苦しむ行動だな	scene_13
What is it, you still have somethin' for me?	なんだよ、アタシにまだなんか用？	scene_13
…Hmmm. So is that it?	……ハハーン。さてはアレかな？	scene_13
I know you want my help because I'm so good!	アタシがあんまり強いんでぜひ助けてほしいと！	scene_13
You want me to go with you?	このアタシにいっしょに来てくれと！そういうこと？	scene_13
That's right	……そういうこと	scene_13
You kiddin'?	じょうだんじゃない	scene_13
No way!	そんなわけない！	scene_13
That's right	……そういうこった	scene_13
What're you sayin'?”	何言ってやがんでえ！	scene_13
I'm gonna leave! I mean it!	ホントに行っちゃうからね！ホントのホントだよ！	scene_13
Go ahead	ご自由に……	scene_13
Wait a second!	ちょっと待った	scene_13
Yeah, so?	ええ、どうぞ	scene_13
Wait a second!	ちょっと待って！	scene_13
GO, then!	とっとと消えろ！	scene_13
Hold on!	……待ちやがれ！	scene_13
Oh yeah? Then do whatever you want!	あっそ！フーンだ、勝手にしろ！	scene_13
Heh heh…thought so. You put me in a spot. Hmm, what should I do?	へへへ、やっぱりねえ。いや、まいったなあ。ウーン、どうしようかなあ	scene_13
But, if you want me that bad, I can't refuse…	でも、そこまで言われちゃこのアタシもことわれないし……	scene_13
All right! I'll go with you!	よし、わかった！アンタらについてってやるよ！	scene_13
What's your name?	……名前は？	scene_13
Let's hurry	……先を急ごう	scene_13
What's your name?	あなた、名前は？	scene_13
Come on, let's hurry!”	さ、急ぎましょ	scene_13
What's your name?	おめえ、名前は？	scene_13
Come on, or we'll leave you!	早くしねえとおいてくぞ！	scene_13
Me? The name's…	アタシ？アタシの名前はね……	scene_13
What are you talking about!? You're the one who should go first!	ヘン、何言ってんだい！そっちが先になのるのがマナーってもんだろ！	scene_13
Okay forget it! I'm not going with you!	やめやめやめ！いっしょに行くのやーめた！	scene_13
Remember, if you piss me off it'll cost you!!	アタシを怒らせると高くつくの！おぼえときな！！	scene_13
Huh? Hey…HEY!	あれ、ちょ、ちょっと……	scene_13
Wait! I haven't even told you my name…	ちょっと！アタシまだ名前……	scene_13
I'm YUFFIE! Good to meetcha!	アタシ、YUFFIE！ひとつヨロシク！	scene_13
Heh, heh…just as I planned.	へへへ……うまくいったよ	scene_13
Now all I have to do is… a little this and a little that… nyuk, nyuk, nyuk…	あとはアレをナニして……クックック……	scene_13
Hey, wait up! Wait for me!!	オ～イ、待ってよ！待ってってば～！！	scene_13
Here, I'll give you back the money I've stolen from you!	盗んだお金ならホラ！ちゃんと返すからさァ！	scene_13
…Or, uh, what's left of it.	……まだ使ってないぶんは	scene_13