Costa del Sol Harbor	コスタ・デル・ソル港	scene_16
Damn! Sure is hot here!	カッ～！！あついな、ここは！	scene_16
But I sure feel better now that I can say good-bye to this sailor suit.	だがよ、せいせいしたぜ！これで、ちっこいセーラー服とおさらばだからな	scene_16
Yo listen up!! Y'all be sure to mingle like regular folks here!	いいか！！こっからは一般人として行動しろ！	scene_16
Oh, too bad. I liked BARRET's sailor suit. He looked so cute.	あら残念、BARRETの水兵姿。かわいかったのに、けっこう	scene_16
…What'ya mean 'cute'?	……かわいいだと	scene_16
Right…well, uh…	うんうん	scene_16
BARRET, why don't you use that sailor suit for pajamas?	BARRET、あのセーラー服パジャマにしなさい	scene_16
Right, CLOUD?	ね、CLOUDもそう思うでしょ？	scene_16
Keep your mind on Sephiroth	そんなことよりセフィロスを	scene_16
Remember, this isn't a vacation. We're here after Sephiroth.	俺たちはバカンスで来たんじゃない。セフィロスを追うんだ	scene_16
I'm going on ahead.	先を急ぐぞ	scene_16
Hmmph, CLOUD. You're the one who's always hangin' around wastin' time.	ケッ！！　CLOUDさんよ。道草が好きなのは、おまえさんだろ	scene_16
I'm going to skip this resort!	こんな場ちがいなリゾート地はすっ飛ばしていくぜ！！	scene_16
Ahhh… You look like a bear wearing a marshmallow.	ああ…マシュマロかぶったクマみたいでぴったりだったな	scene_16
The hell's that supposed to mean!? This happens to be the most comfortable, so shu'up!	なにっ！！　よけいな世話だ！オレはこの一張羅がいちばん落ちつくんだ	scene_16
…puff…puff…	ゼェゼェ……	scene_16
Would you kindly hurry? The heat here is drying my nose.	すまないが、少し急いでくれないか。ここは暑い、私のアカハナがかわいてしまう	scene_16
Yeah, mine, too!!	あたしもっ！！	scene_16
All right. We'll take a break and then head off.	わかった。小休止の後、出発する	scene_16
Don't wander too far off.	あまり、遠くへは行くな	scene_16
I'll wander wherever I damn well want! Who made him the leader?	チッ！すっかりリーダー気取りだな	scene_16
It looks like my mane got messed up.	じまんのけなみがみだれてきたようだ	scene_16
I'm going to rest somewhere cool.	すずしいところで休んでいるよ	scene_16
I think I'll go swimming.	およぎにいっちゃおうかな	scene_16
Sounds good to me!	そうしよっか？	scene_16
Hmm? CLOUD, are you thinking of anything in particular?	んん……？　CLOUD君いまなんか想像しちゃったかな？	scene_16
Your cool exterior's cracking…	クールな顔がくずれてますよ～	scene_16
Well then, let's go!	さ、いこいこ！	scene_16
Maybe I should get a tan for a change.	たまには日焼けでもしちゃおっかな	scene_16
Which do you like, CLOUD?	CLOUDはどっちが好み？	scene_16
I like fair complexions	はだは白いほうが好きだ	scene_16
Maybe a healthy tan is nice	元気に焼けてるほうがいいかな	scene_16
Got it. I'll remember that.	ハイっ、参考にしとくね	scene_16
Don't bother looking for me!	さがさないでくれよっ！	scene_16
What a long boat ride that was!!	長時間の船旅おつかれさまです！！	scene_16
Hmmm… Good work everyone…	ウム……ごくろう……	scene_16
Gya, Haa, haa…ha!! Hurry up with that!	ガハハハハ！！スキッフの準備を急げ！	scene_16
Yes, sir!!	ハッ！！	scene_16
I heard Sephiroth was on board.	セフィロスが乗っていたらしいな	scene_16
Yes.	……はっ	scene_16
And it seems CLOUD and the others were on board, too.	CLOUDたちも乗っていたらしいな	scene_16
They all slipped through… You messed up big this time, Heidegger.	どちらも取り逃がした……。大失態だな、ハイデッカーくん	scene_16
I'm ashamed of myself.	めんぼくない……です	scene_16
Is that all you can do? Give one word answers and apologize for everything?	いつから返事とあやまることしかできなくなったのだ…きみは	scene_16
Do something. I'll be expecting results.	……なんとかしたまえ。期待している	scene_16
Ready for departure, sir!!	スキッフ発進準備完了いたしました！！	scene_16
Very well then. That was fast.	わかった。早かったな	scene_16
You're outstanding. I'll remember you.	ウム…君は優秀だ。覚えておこう	scene_16
YES, SIR!! Thank you, sir.	ハッ！！ありがとうございます	scene_16
Remember Heidegger, You're allowed only one mistake.	いいかね？　ハイデッカーくん。失敗は１度までだ	scene_16
I'm the boss!	オレ、わかだいしょう！	scene_16
But a bunch of hardworking deckhands like you wouldn't understand.	あなたたち、アクセク働く運搬船の労働者にはわからないでしょうねえ	scene_16
On the marine blue sea, Gazing at the eternal skies that seem to go on forever… Gives you the feeling like you're taking a nap on the wing of a Cessna.	マリンブルーの海の上、どこまでも続くイターナルな空をながめながらセスナのつばさの上でおひるねする気分	scene_16
It's the ultimate high!	そりゃあ、もう最高なのよ	scene_16
He's quite handsome, isn't he?	なかなか、いい男ね……	scene_16
Oh, don't worry, I'm not talking about you.	あっ！　あなたのことじゃないから安心して	scene_16
I'm talking about President Rufus. Charming, rich, blond… He even looks good in a double-breasted suit.	ルーファウス社長のことよ。魅力的よね、お金もってるし金髪だし、ダブルのスーツだし	scene_16
Heh, heh… I hear the Shinra brass are arriving soon.	ヘラヘラ……もうじき、神羅のお偉方がつくんだってよ	scene_16
Heh, heh! Got nothing to do with us, does it?	ヘラヘラ……俺たちにはぜんぜん関係ねえよな	scene_16
Hey! Spread out, all of you, out!!	おっと！！離れて離れて！！	scene_16
Put any fingerprints, scratches, or dents on that plane and I'll put one in your head!	しもんつけたり、傷つけたりへこませたりしたらただじゃおかないぞ	scene_16
Da plane, da plane!! This's something you'll never be able to do in your lifetime.	飛・行・機！！君たちには、一生手のとどかないしろもの	scene_16
So you just watch from a distance… and wish.	ま、せいぜい遠くからながめるだけにしてくれよ	scene_16
Costa del Sol…a harbor paradise where the sun always shines and it's summer all year round!	ここは太陽ふりそそぐ常夏の楽園。コスタデルソルの港！	scene_16
Hmm…Things aren't going well… You can go sightseeing in the city.	う～ん、うまくいきません…。観光案内は、街のほうでどうぞ	scene_16
You're stowaways, right?	君たち密航者なんでしょ	scene_16
It's okay. I'm used to them.	いやあ、いいですよ。もう、なれっこですから	scene_16
The truth is, before I worked here, I was one of the best.	じつは、僕もここに就職する前ね。密航の常習者だったりなんかしちゃって	scene_16
Don't bug me. This is Rufus's first official visit since becoming President.	じゃましないでくれよ。ルーファウスさんが社長就任以来初の到着なんだ	scene_16
It seems like he's here on business this time.	今回はめずらしく仕事の用事みたいなんだけどね	scene_16
I'm so jealous of him I could spit. We're both about the same age but he's President.	でも、うらやましいよなあ。ボクとそんなに年もかわらないのに社長だもんなあ	scene_16
Oh crap… The manager of Shinra won't come down.	まいったなあ…。神羅の課長さん、おりてこないんですよ	scene_16
Even though the President's here on business. All he does is play, forgetting everything to do with work.	出張で来てるのにねえ。仕事忘れちゃって、遊んでばっかり	scene_16
Rufus complimented me on my job!	ルーファウスさんにほめられちゃいましたよ！	scene_16
Wow!! I guess it pays to do good work.	いやあ～～仕事のしがいがあるってもんです	scene_16
Damn. I'm soaking wet down to my underwear.	まいったなあ。パンツまでびしょびしょ	scene_16
Oops! You must be those AVALANCHE guys!	あ！　あんたたち、もしかしてちまたで噂のアバランチの残堂！！	scene_16
Quick! Let's get outta here! Heidegger's in charge of the transport ship.	さ！　早く逃げて逃げて。運搬船はハイデッカーの管理下に置かれちゃいましたよ	scene_16
That's tough for both of us.	たいへんですね、おたがい	scene_16
Ride the Shinra ship?	神羅のスキッフ、乗ってみたいかい？	scene_16
Yeah, I could go for that	そうだな、悪くないな	scene_16
Don't think I could steer it	そうじゅう、難しそうだな	scene_16
Oh…is that so?	そうか……そうなのか	scene_16
Yep! Actually, we do have an old junker we're gonna get rid of, And I was thinking about going into the tourist business.	う～ん！中古の払い下げスキッフがあるんだけど観光客相手の商売でもはじめようかと思ってね	scene_16
But it's probably tougher than it looks I better think this through a little more…	でも、いざやるとなると大変だから…。もすこし、考えさせてよ	scene_16
Yeah. It's too much for an amateur!	そうだよな！素人には無理だよな！	scene_16
Oh, oh, oh!!! I'm gonna quit this company!!	ウォォォ！！！こんな会社、やめてやるぅ！！	scene_16
I mean it, I'm really gonna quit!!	やめてやるっぞう！！	scene_16
Heidegger's such an idiot!!	ハイデッカーのバカヤロウッー！！	scene_16
And Rufus, acting all big!!	ルーファウスのかっこつけやろうー！！	scene_16
God, that sure felt good…	ああ、きもちいい……	scene_16
The transport ship won't be sailing for quite awhile. Heidegger's orders.	運搬船は、当分の間、出航しませんよ。ハイデッカーの指示なしにはね	scene_16
Thinking of being stowaways?	ただし！！　僕にも家ではらすかせて待ってる家族がいる。ただってわけにはいかない	scene_16
It's 100 gil to Junon. Give it to me, and I'll put in a good word with the captain.	ジュノンまで１００ギル。そんだけもらえれば船長に口聞いてあげてもいいぜ	scene_16
What'll we do?	どうする？	scene_16
Pay up	１００ギル払う	scene_16
Thank you. Come back any time you want to stowaway on our ship.	そうかい、密航したくなったらいつでもおいでよ	scene_16
Hey! No money? And you're trying to stowaway? Don't make me laugh!	お～い、金もないのに密航だなんて笑わせんなよ	scene_16
Okay. Come on. This way.	おっけ～。ほら、こっちだ	scene_16
It's not the most pleasant ride but make the best of it.	快適な船旅とはいえないだろけどがまんしてくれよな	scene_16
Ever since Rufus complimented him, he strutted around for awhile, and haven't heard a peep from him since…	ルーファウスさんにほめられて以来ひとしきり走り回って来ましたがなんの音さたもなし……	scene_16
Today's a great day for a nap in the sun. It always puts me in a good mood!	今日も最高のおひるね日平。もうそれだけでごっきげんなのよね～！	scene_16
Hey, who're you? You look like you've been around the world twice.	あれ、君たち？世界を飛びまわってるって顔してるね。なんだか知らないけど、がんばってくれよ	scene_16
I don't know what your story is, but hang in there.	メテオだなんだと、みなさん大あわてで最後のヴァカンスをとりにやってくるもんだからボクら、かえっていそがしいですよ	scene_16
Everyone's in a rush to get one last vacation in before the Meteor strikes. That's why it's so busy here.	はぁ……ボク、最後まで走りまわっているんだなあ	scene_16
There's no ship to Junon. Recently, there's been a hoard on materials. Everything's topsy-turvy.	ジュノン行きはでてないんだ。最近、物資の買い占めが多くてもうてんてこまいさ	scene_16
Not gonna be able to nap like this for much longer.	こうしておひるねしていられるのもあとわずかな時間なのね	scene_16
When you put it that way, I feel kind of sad.	そう思うとなんだかさみしい気分になっちゃうのよ	scene_16
Well, I'm not worried. When it all comes down, I'm heading for the skies.	ま、俺は気楽なもんだよ。いざとなれば空に逃げちゃうからねえ	scene_16
The only problem is… will there be anywhere left to land?	一番の間題は……おりる場所が残っているかどうかだよな	scene_16
Damn! Sure is hot here!	カッー！！あついな、ここは！	scene_16
Oh‚too bad. I liked BARRET's sailor suit. He looked so cute.	あら、BARRETの水兵姿。かわいかったよ、けっこう	scene_16
Right…well, uh…	うんうん。	scene_16
Concentrate on Sephiroth	そんなことより黒マント男を	scene_16
Would you kindly hurry? The heat here is drying my nose.	すまないが、少し急いでくれないか。ここは暑い、私のしたがかわいてしまう	scene_16
You'll never know what it's like to toil away on the ship.	あなたたち、アクセク働く運搬船の労働者には わからないでしょうねえ。	scene_16
Sailing over the blue sea, gazing up at a sky that seems to drift on forever. Feels like you're taking a nap on birds wings.	マリンブルーの海の上、どこまでも続く イターナルな空をながめながら セスナのつばさの上でおひるねする気分。	scene_16
Don't worry‚I'm not talking about you.	あっ！　あなたのことじゃないから 安心して。	scene_16
Heh‚heh… I hear the Shinra brass are arriving soon.	ヘラヘラ…… もうじき、神羅のお偉方がつくんだってよ。	scene_16
Hey! Spread out‚all of you‚out!!	おっと！！ 離れて離れて！！	scene_16
Any of you put a scratch or a dent in that plane and I'll put one in your head!	しもんつけたり、傷つけたり へこませたりしたら ただじゃおかないぞ。	scene_16
Da plane‚da plane!! Here's something you'll probably never get to do in your lifetime.	飛・行・機！！ 君たちには、一生 手のとどかないしろもの。	scene_16
Costa del Sol…a harbor paradise where the sun always shines and it's summer all year round!	ここは太陽ふりそそぐ常夏の楽園。 コスタデルソルの港！	scene_16
Stowaways‚right?	君たち密航者なんでしょ。	scene_16
It's okay. I'm used to them.	いやあ、いいですよ。 もう、なれっこですから。	scene_16
Don't bug me. This is Rufus's first official visit since becoming President.	じゃましないでくれよ。 ルーファウスさんが社長就任以来 初の到着なんだ。	scene_16
It seems like he's here on business this time.	今回はめずらしく仕事の用事みたい なんだけどね。	scene_16
Oh crap… The Shinra Manager won't come down.	まいったなあ…。 神羅の課長さん、おりてこないんですよ。	scene_16
Rufus complimented me on my job!	ルーファウスさんに ほめられちゃいましたよ！	scene_16
Damn. I'm soaked down to my underwear.	まいったなあ。 パンツまでびしょびしょ。	scene_16
Oops! You must be those AVALANCHE guys!	あ！　あんたたち、もしかして ちまたで噂のアバランチの残堂！！	scene_16
Quick! Let's get outta here! Heidegger's in charge of the transport ship.	さ！　早く逃げて逃げて。 運搬船はハイデッカーの管理下に 置かれちゃいましたよ。	scene_16
Oh…is that so?	そうか……そうなのか。	scene_16
Yep! Actually‚we do have an old junker we're gonna get rid of, And I was thinking about going into the tourist business.	う～ん！ 中古の払い下げスキッフがあるんだけど 観光客相手の商売でもはじめようかと 思ってね。	scene_16
Heidegger's such an idiot!!	ハイデッカーの バカヤロウッー！！	scene_16
House for Sale	売り家（旧神羅べっそう）	scene_16
CLOUD's Villa	CLOUDべっそう	scene_16
What a fluffy bed! It feels so great	ふかふかベッド……ん～　きもちいい…	scene_16
Mmm… five more minutes…	ん～もうちょっとだけ…	scene_16
Oh, I'm sorry. I didn't know you were here. This is so embarrassing.	いやはや……お客さんとは気がつきませんではずかしいところをお見せしました	scene_16
Take your time and look around.	どうぞごゆっくりごらんください	scene_16
So are you seriously considering buying?	ところで、お客さん。ほんとに買う気あるんですかい？	scene_16
The heck do ya mean?	なんのことだ	scene_16
I'm out of here	失礼する	scene_16
Yes, you're right. I'm sorry, please continue.	まあ、そうでしょう。ひきとめはしませんよ	scene_16
What are you selling?	ここは何を売ってるんだ	scene_16
That's pretty low. Are you pulling my leg?	いやですねえ。やっぱりひやかしですか？	scene_16
I'm talking about this house. This villa used to belong to President Shinra. It only recently came back on the market.	このお家ですよ。お家。もとプレジデント神羅所有のべっそう。最近、売りにでましてねえ	scene_16
How do you like it?	どうですか？	scene_16
It has a large lot, comes fully furnished with this goose-down bed, and there's even a basement to boot.	広い敷地にごうか家具＆ふかふかベッド。おまけに地下室までついちゃう	scene_16
The villagers call it the Shinra Villa.	土地のみんなには神羅べっそうと呼ばれてますよ	scene_16
Of course, we're not giving it away…	もっちろん、値ははりますがね	scene_16
How much is it?	いくらだ？	scene_16
Wha? How do you plan to buy it without a dime on you?	おろっ？買う気ある、ビンボー人のくせに？	scene_16
Well, the price, for your information, is a steal at 300,000 gil.	ま、社会勉強のため値段だけは教えときましょはい、ポッキリ３０万ギルね。	scene_16
Out of your range? Out! Go on, out!	手がでないでしょ。帰った！帰った！	scene_16
All items in the basement are included in the sale.	地下室の品は、ほんのサービスですよ。	scene_16
Well, please come by again if you should strike it rich.	まあ、お金でもたまったらまたおいでください	scene_16
I wouldn't hold my breath waiting for that to happen unless you win big at Gold Saucer.	もっとも、ゴールドソーサーでひとやま当てたりでもしなけりゃむりでしょうけどねえ	scene_16
Well, what do you think? Isn't it a fabulous villa?	どうです。りっぱなもんでしょう	scene_16
The feeling you get with owning a villa is simply… indescribable.	べっそうをもつ……その心地とステータス。いいもんですよ	scene_16
Well, let's wait for the captain.	ま、気長にまつことにしますよ	scene_16
Hmm Is this some kind of joke?	ん～ひやかしはやめてください	scene_16
'Praise the Lord,' it's a miracle!! Who'd ever think someone with some real money would ever come here?	ん～　きせきだ！！まさか、ほんとにお金をもってるお客がたずねてくるとは……	scene_16
I probably shouldn't even ask, but are you really going to buy it?	なにもいいことないと思いますけどほんとに買いますかい？	scene_16
Yep, 300,000 gil	３０万ギル支払う	scene_16
I changed my mind	気が変わった	scene_16
Hmm, good-bye!! Good-bye fluffy bed!!	ん～　さようなら！！ボクのふかふかベッド！！	scene_16
Oh well, I'm kind of glad!	ん～よかった～！	scene_16
Bought "Villa CLOUD"!	『CLOUDべっそう』を手にいれた！	scene_16
This is MY villa. Rest up in your new villa?	俺のべっそうだ。休んでいくかな	scene_16
With pleasure	休む	scene_16
Cellar	地下室	scene_16
Geez my lower back's killing me!	ん～こしがいたい～	scene_16
How do you do? I'm the manager.	ども！わし、管理人です	scene_16
Nice to meet you.	どぞ、よろしく	scene_16
Well, if you'll pardon me, I'll be leaving. Good-night.	では、失礼して…おやすみなさい	scene_16
Oh, those items are free, so please help yourself.	あっ、そのへんの品はサービスですからご自由におもちください	scene_16
Received "Motor Drive"!	『モータードライブ』を手にいれた！	scene_16
Received "Fire Ring"!	『炎の指輪』を手にいれた！	scene_16
Costa del Sol	コスタ・デル・ソル	scene_16
Say, aren't you bored?	ねえ、たいくつしてない？	scene_16
Not that much	それほどでもない	scene_16
Yeah, we fight a lot	バトルがおおくてね	scene_16
Isn't that good? You're just expecting too much.	あら、いいじゃない。そりゃあ、ぜいたくってもんよ	scene_16
Oh, really? I'm a little bored.	あら、そ～う。わたしは、ちょっ～とたいくつな気分なのよ	scene_16
Come on, back to work now!	さっ、お仕事ね！	scene_16
Here you are! The Costa del Sol tourist information guide.	はい、こちら！コスタ・デル・ソル観光案内で～す	scene_16
What do you want to know?	なにが知りたいのかしら？	scene_16
Where's the inn?	宿を探してる	scene_16
Where're the stores?	店を探してる	scene_16
Show me around town	観光案内してくれ	scene_16
Let's see. I recommend a resort located on the outskirts of the city.	そうねえ、街はずれのリゾートインがおすすめよ	scene_16
If you're looking for souvenirs, we recommend Butch's.	あら？　もしかして、アッチ関係のお店？それなら、ＢＡＲで話してみるといいわ	scene_16
Wait a minute. I'm going to look at my guidebook.	ちょっと、まってね。いま、マニュアル見るから	scene_16
It says, Costa del Sol is the gateway to the West, and is a prominent world renown resort, which has been around for ages.	ここ、コスタ・デル・ソルは西の大陸のげんかんとしてまた、世界有数のリゾート地として古くから発展してきました……	scene_16
Come on! I don't care about that!	あ～ん、もう！どうでもいいわね。そんなこと	scene_16
If you want a good time, go to the beach! There are lots of beautiful women.	遊ぶんだったら、ビーチへどうぞ。かわいい女の子もたくさんいるわよ	scene_16
You wouldn't happen to be…rich?	あなたたち、もしかしてお金持ち？	scene_16
Well, not so	そうでもない	scene_16
You're kidding! You can't tell just by looking.	うそ～！身なりを見れば、わかっちゃうわよ	scene_16
But I'll tell you just in case.	でも、いちおう、教えとくね	scene_16
After relaxing at Costa del Sol, stop by the Gold Saucer. It's a rich and exciting place to play!	コスタ・デル・ソルで休んだ後はゴールドソーサーへぬけるのがリッチでメジャーな観光コースなの	scene_16
I thought so.	やっぱりね～	scene_16
Are you interested? This is the road to Gold Saucer.	でも、もしかして興味あるかしら？ゴールドソーサーへの道	scene_16
Head south to the Gold Saucer, and you'll find casinos and an amusement park.	ここから、ずっ～と南のゴールドソーサーにはカジノや遊園地があるのよ	scene_16
But if you're planning to walk, you'll have to cross mountains and valleys. I wouldn't recommend it.	でもね～　歩いていくのは山こえ谷こえ、そりゃもうたいへんらしいの	scene_16
But if you're on a vacation, you should go there at least once.	ま、旅してるなら一度は行ってみるといいんじゃない	scene_16
Yo! Wassup! We jus' hangin' out!!	よぅ！　元気！！オイラ、のんき！！	scene_16
Oh, the sun's so bright! Looks like another wonderful day!	あ～ん！　まぶしい太陽！今日もいい天気！	scene_16
1, 2, 3, here we go!	１、２、３！！キッキン！	scene_16
I heard. That big dog talks like a human.	わたし、聞いちゃった。あの大きなイヌ、人の言葉話すの	scene_16
That's cool …but weird.	じっちゃん、あついよぅ……だって、へんなの！	scene_16
It's the ocean. A creepy man was signaling for us to come.	海でね。気持ちの悪いおじさんがてまねきしてたの	scene_16
I was scared to come here!	こわかったからね。ここで遊んでるの！	scene_16
Hm, that's interesting.	フム、興味深い	scene_16
It's not as if I'm doing this because I want to.	この行動だが、私はやりたくてやってるわけではないのだ	scene_16
You see, this tail of mine, moves quite independently of my will.	このシッポめが私の意志とは無関係に動いてしまうのだよ	scene_16
Grrr…	ガルルル……	scene_16
Shall we play our hand around here?	ね、このへんで手をうっちゃおうか	scene_16
Not yet. Remember, no compromises.	だめ、だきょうしちゃいけない	scene_16
You're right. After all, this trip was expensive.	そうね。旅費だって高かったんだし	scene_16
But only your average Joes are trying to pick us up.	でも、なんだってこのくらいのしか声をかけてこないの	scene_16
Well, that's because we're just too beautiful and hard to approach.	それはきっとあれ。あたしたちがうつくしすぎるってやつ	scene_16
I guess so. Well, I envy the plain Janes.	そうね。あ～ん、ふつうの子がうらやましい	scene_16
Why don't we compromise? We'll make do with what we have.	ね、もういいんじゃない？コレで、がまんしちゃおう	scene_16
How about some 'Soft' as a memento of this wonderful trip? Made especially in Costa del Sol!	あなたの楽しい旅の記念にコスタ・デル・ソル特製『金の針』はいかがですか？	scene_16
Butch	ブッチ	scene_16
Yeah, I'd like to find a gorgeous chick and have a great time.	いやあ、ピチピチした女の子でもやとって楽がしたいですなあ	scene_16
Well, we're lucky to have that cutie working for us part-time.	いやあ、バイトでかわいい子がはいってくれたんで大助かりです	scene_16
You got me there… We just hired her part-time.	やられました……。やとったばかりのバイトの女の子	scene_16
She ran off with our money and Materia.	店の売り上げと商品のマテリアもってとんずらしちゃいましたよ	scene_16
I guess any situation that seems too good to be true, usually is.	世の中、うまい話はないもんですなあ。 	scene_16
Well, please feel free to browse around. Just don't mind looking at leftovers.	ま、あまりもんでよかったら、見てってください	scene_16
Ah, CLOUD! Let me make a buck why don't you?	あ、CLOUD！ちょっとだけ、かせがせてよ	scene_16
I'm sellin' Materia. Why don't you buy some?	ここはマテリアも売ってんだ。ね、なんか買ってってよ！	scene_16
Orders are taken at the counter.	お客さん、注文はカウンターでおねがいします	scene_16
It hurts when you kick me with your bare feet!	はだしでけるのいた～い！	scene_16
Why's that!?	どうして！！	scene_16
Not yet!!	まだ！！	scene_16
Eaghhh!	キッ～～！！	scene_16
It's your fault!	あなたのせい！！	scene_16
What's wrong with you!?	なによっ！	scene_16
You wanna go!?	やるのっ！！	scene_16
Whew!!!	フッーーーー！！！	scene_16
A man…	男……	scene_16
A good-looking man…	いい男……	scene_16
Where?	どこ……	scene_16
Ho! Ho! Ho…	オホホホホ……	scene_16
I don't feel like sightseeing around town. What I really want to do is have fun…  …too bad Gold Saucer is temporarily closed.	もう観光案内どころじゃないのよ。……ほんとはね。ゴールドソーサーも休業続きらしいし	scene_16
Butch	でも、メテオ好きのお客さんがけっこう多くて…いやだわ	scene_16
Wanna buy a souvenir to remember participating in the Meteor tour?	もうだしおしみなし！世界の終わり大セールだよん！！	scene_16
Oh wow!! Man, that's huge!!	メテオかんしょうツアー参加しるしの入ったアイテムはいかが？	scene_16
The stars!! They're in flames!!	うひゃ～！！でっけ～！！	scene_16
They're burning. Someday they'll burn out.	お星さま～！！メラメラ～！！	scene_16
The stars are just like our youth.	燃えてるわ。でも、いつか燃えつきるの	scene_16
Ho! Ho! Ho! It's the end of the world.	わたしたちの青春とおなじよ	scene_16
Bar	オホホホ……終わりなのよ	scene_16
Mukki	おキャクさん、ノむか、サケ？ソだな、ウン、ゆっくりしてケ	scene_16
You could walk around here naked, and no one'd look twice.	僕、この街、気にちゃった	scene_16
…huff…puff… I can't stand hot places…	はだかで歩いてても白い目で見られないもんね	scene_16
…HIC… Mm? Wanna order? We're outta that now.	ゼェゼェ……あついとこ、苦手……	scene_16
Hey! I thought you'd drop by.	ヒッッック…ん？　注文かい？いまはないよぅ	scene_16
(That's 1, 2…4 fishes all together…not bad.)	あらっ！　いらしてくれるとおもってたわ♥	scene_16
Come on…please. If you don't buy from me… I won't be able to pay the rent.	（つったさかなが１匹２匹…これで、４匹め。まあまあね）	scene_16
Yeah, snowboarding's what's happening this year.	たのむよ、買ってくれないと俺の生活が…	scene_16
I'm sick of surfing.	やっぱ、今年はスノボかな。もうサーフィンはあきちゃったよ	scene_16
We're all headin' over to Gold Saucer now.	オレたち、これからゴールドソーサーへむかうんだ	scene_16
We're gonna make a ton of money at the Chocobo races.	噂のチョコボレースで旅費をかせいで	scene_16
Then we're gonna take a trip to Icicle Inn and snowboard.	スノボやりにアイシクルロッジへ長い旅するのさ	scene_16
Welcome to Bar del Sol! Here's to tropical nights!	バールデルソルへようこそ！トロピカルな夜にかんぱい！	scene_16
We look like great surfers…	オレたちには、やっぱサーフィンがおにあいさ	scene_16
But the only clothes we have are these swim trunks.	なんてたって、水着しか着る服もってないんだから	scene_16
I traveled around a long time… And this town has the most beautiful ocean I've ever seen.	長い旅してわかったよ。この街の海が最高だったてことがさ	scene_16
Sometimes you can't recognize things when they're right in front of you.	見なれちゃったり、近すぎたりしてさ 	scene_16
I guess I took it for granted because it's so close, and I was so used to seeing it all the time.	そこにあるのがあたりまえみたいになるとわからなくなることってあるよな	scene_16
That's why I came back here.	ま、そんなわけでまいもどってきたわけよ	scene_16
I don't care whether Meteor comes or not, I'm not giving up yet!	メテオだかなんだか知らないがオレはまだあきらめない！	scene_16
I still haven't surfed the best waves of Costa del Sol!	コスタデルソルの海の最高の波にのってないんだからな！	scene_16
I hope the Meteor doesn't strike before I do.	それまでは、ふってくるんじゃねえ	scene_16
It's weird seeing Meteor's reflection on the sea in the evening! It gives you the creeps.	夜の海にうつるメテオの姿は不気味だぜ～。さすがにふるえちまったよ	scene_16
But the sun has risen! ???	でもなあ、それでも太陽はのぼってきたぜ！な、すてちゃいけないよな、アレをさ	scene_16
Well, for that reason, I'm at the store today too.	ま、そんなわけで今日もこの店にいるわけよ	scene_16
I wan' learn how speak beddah.	おキャクさん、ワタシ、コトバできるよにもっとおボえたい	scene_16
But don' wan' have stars fall down. You think…same?	ホシ、ふってくるのこまル。おキャクさんも、そだな、ウン！	scene_16
I just want to sit here with my drink.	僕は静かにお酒を飲むです	scene_16
My boss is a total arrogant ass!	ボクチンは先輩の考え方がわからない！	scene_16
I'm gonna tell him off! I'm gonna scream my head off!	ボクチンはさけぶぞ！みにくいくらいのたうちまわるぞ！	scene_16
Isn't that what life's all about? What do you think?	生きるってのはそういうことじゃないのかい！どですかね？	scene_16
…huff…wheeze… Heat and cold are just memories of the Planet…	ゼェハァ……暑さも寒さも星の思い出…	scene_16
Come on…please. If you don't buy from me… I can't pay the rent. No one else will either.	たのむよ、買ってくれないと俺の生活どころか…みんなの生活が……	scene_16
While you're here, forget all those awful things going on outside, and just enjoy yourself.	お店のなかではや～なことなんてわすれてたのしんでいってね♥	scene_16
Costa del Sol Inn	コスタデルソル・イン	scene_16
Uggh!  I feel God awful! Oh!! You!	チェッ！　調子わるっ！あっ！！　あんたさ！	scene_16
Weren't you with that big sailor?	あの大きな水兵さんの連れの方だろ？	scene_16
Wasn't me	俺には関係ないな	scene_16
Wrong guy? This is bad for us. That guy's taken over the john.	……人ちがいか。こまるんだよね。あの人、トイレ占拠しちまって	scene_16
And he hasn't even paid his hotel bill yet.	宿代の支払いもまだだし	scene_16
Listen to this…	聞いてくれます？	scene_16
A big sailor just busted in here all of a sudden, and took over the restroom.	いきなり！　大きな水兵さんがドカドカとやってきてトイレ占領しちまって	scene_16
He's been in there moaning ever since.	それっきりずっ～と、うなってるんだ	scene_16
I don't know what I'm gonna do.	まいっちゃうよ	scene_16
Ah…if you're checking in, would you please pay his bill, too?	はぁ……あっ、お泊まりなら悪いけど、あの人の分もたのむね	scene_16
Come now, we know he's a friend of yours…(fibber)	やだなあ、やっぱり知り合いじゃないの…うそつき	scene_16
What now? Call it a night?	どうすんの？　もう休むかい？	scene_16
200 gil a night.	一泊２００ギルだよ	scene_16
What now? Call it a night?	どうすんだい？もうお休みにするかい？	scene_16
Stay	休んでいくか	scene_16
Cradled by the sound of the ocean… sweet dreams…	波音に抱かれて……いい夢を	scene_16
Are you sure? Please come again.	そうですかい。またおいでくださいね	scene_16
Shucks!!  Too bad!	チェッ！！　おしいっ！	scene_16
Hey! Hey you! Does your friend have a cute lady?	あっ！　あんたさ！連れに、かわいい女の子がいるでしょ	scene_16
She came in here looking for him a while ago. You better find her.	さっき、探しにきてたけど。いいのかい？ほっといても	scene_16
What are you going to do? Just forget about her and go to bed?	どうすんだい？ほっといて、もう休みます？	scene_16
Changed my mind	気がかわった	scene_16
You look like you can handle it. Well then…	ほ～う、よゆうだね。では……	scene_16
That's right. Don't worry. Please come by again.	そりゃそうだよね。どうぞ、どうぞ。またあとで、おこしください	scene_16
Welcome!! What's it going to be?	毎度どうも！！どうします？	scene_16
200 gil a night.	一泊２００ギルになりますけど	scene_16
You sure? I'll just be playing around here so drop by whenever you feel like it.	そうですかい。私、ここで遊んでますから気がむいたら、またおこしください	scene_16
You must be tired.	はい、おつかれさまでした	scene_16
The weather for Costa del Sol tomorrow is going to be…sunny, again.	コスタデルソル地方の明日の天気はいつもの通り、晴れとなっております	scene_16
Good morning. Be careful traveling.	おはようございます。道中お気をつけて	scene_16
Your party has departed.	お連れのみなさんは先立たれましたよ	scene_16
Oops…	あっ……	scene_16
That's bad luck…	これは縁起でもないことを…	scene_16
I mean, they have already left.	正しくは…一足先に出発しましたという意味です	scene_16
Wait a minute! There's not enough money here.	おっっと！お金がたりないようですぜ	scene_16
Good morning!!	おはようさんっ！！	scene_16
Uh uh!	う～ん！	scene_16
Hmmm!?	んんっ～！	scene_16
Marlene! You OK?	マリ～ン！元気かぁ…？	scene_16
I'll wear this when I go to see you.	とうちゃんこれ着て会いにいくからなぁ	scene_16
Yo, CLOUD! Still too early, ain't it?	おう！！　CLOUD！まだはやいんじゃねえか！	scene_16
Hey, yo!!! Someone's in here, alright!?	おう！！！いま使用中だっ！	scene_16
Whew… I don't know why I'm so tired.	フゥ……。なんだか、つかれちゃったね	scene_16
There's so many things I don't understand…	わからないこと、おおくて…	scene_16
I feel a little uneasy.	ちょっとだけ、不安なんだ	scene_16
What do you think of me?	わたしのこと、どう思ってる？	scene_16
I don't understand anything.	どうもこうもわからないよ	scene_16
Sorry, but I never think about those things.	悪いけどそういうこと考えたこともない	scene_16
How could you say such a thing! Sometimes you make me so mad!	あたまっ、きちゃうなあ！そんなこといえちゃうわけっ	scene_16
Oh, I never should have brought it up!!	も～う！相談したわたしがまちがってました	scene_16
…You're right.	…………そうだよね	scene_16
Even I don't understand myself.	わたしもね、わからないの。自分のこと	scene_16
I wonder what part of me is like an Ancient?	わたし、どのへんが古代種なの？	scene_16
What is an Ancient supposed to be like? It's strange, isn't it?	古代種ってどこがどうなるの？	scene_16
I don't understand it…	へんだよね。わからないよ…	scene_16
Ahh…I'm going around in circles. I wonder if there's any answer to this? Everything's so complicated.	はぁ…　どうどうめぐり。こういうのってこたえ、あるのかなあ。むずかしいよね、いろいろ	scene_16
I'm going to sleep.	さきに休ませてね	scene_16
I don't want to talk about it!	もういいですよっ！	scene_16
Be careful!	お気をつけて！	scene_16
I don't feel like doing anything. I just want to spend the rest of my life sleeping.	もう遊ぶ気も働く気もないです。最後の人生、ねだめですよ、ねだめ	scene_16
Good night.	では、おやすみなさ～い	scene_16
Will you be staying together?	いっしょにねますかい？	scene_16
No, thanks	やめとく	scene_16
Stop looking like a hunted animal! Whatever happens…happens.	せっぱつまった顔なんてやめ！なるようにしかなりません	scene_16
Just go with it.	あんまり、無理はしなさなんなって	scene_16
Johnny's New Home	ジョニーの新居	scene_16
What's with YOU?	なななななんだ？あななななたは！！	scene_16
Hey, is it really you?	ああっ、あんたは？もしかしてぇ！	scene_16
We were in SOLDIER, and childhood friends before that. You were such a playboy.	元ソルジャーかつ幼なじみでモテモテの遊び人	scene_16
And a $#&^ murderer!!	そ、そして……人殺し野郎！！	scene_16
Why can't I remember your name?	えっっと……お名前なんでしたっけ？	scene_16
Who are YOU?	おまえこそ誰だ？	scene_16
I'm CLOUD, and don't forget it	CLOUDだ、おぼえとけ	scene_16
That's right. Long time no see. Do you remember me?	そうだよな、ひさしぶりだもんな。俺のことなんか、わすれちゃったか	scene_16
That's okay. We'll just pretend like we don't know each other.	いいぜ、このまま、あんたと俺は関係なし。	scene_16
I started a new life in this town.	俺はこの街で新しいくらしをはじめた	scene_16
A lot of things happened to us. Heh, I better stop my complaining! I sure envy you all living out under the stars.	おたがい、いろいろあったよな。や！　もうぐちるのはやめ！いいよな、あんたたちみたいにの～天気に生きられりゃよ	scene_16
You think you're good enough to brag about how big you are?	どうどうと名乗るくらいのご身分とはね！	scene_16
I don't wanna hear it! Heh, no more complaining from me!	聞いてあきれるぜ！や！　もうぐちるのはやめ！	scene_16
From now on, I'm turning over a new leaf!	おたがい、新しい人生を生きような！	scene_16
Go on and beat it!	はやく出てってくれよ！	scene_16
I'm happy like this. So keep out of my life.	俺は、これでもハッピーにやってんだ。俺のラブリーなどうせい生活をじゃましないでくれ！	scene_16
I'm sorry about that. He's had some big shocks and has been depressed lately.	お客さん、ごめんなさいね！彼、ここんとこ、ショックなことがおおくてず～っと、ふさぎこんでるのよ～	scene_16
Oh, right! I remember that, too.	そうそう！そんなことも、あったね～	scene_16
Yeah, yeah! And you remember the time when….	でさ、でさ！そんとき…	scene_16
Hee, hee, hee!	ウフフフ！	scene_16
Ha, ha, ha!	イヒヒヒ……！	scene_16
Ha, ha…oh stop it! That's right. Oh really…	やだ～！そうなの～	scene_16
Yeah. Oh yeah, and then that time…	そうそう。でね……	scene_16
Yeah, yeah!	うんうん！	scene_16
CLOUD, would you mind leaving us alone for the day?	CLOUD……。ごめん、今日はふたりにさせてね！	scene_16
We haven't seen each other for ages and sometimes it's fun to talk about old times for a change.	ひさしぶりだしたまには息抜きもね	scene_16
Yeah, don't get mad or anything.	そういうことだから……。悪く思うなよ	scene_16
I'll try not to be back too late.	あんまり遅くならないようにするから	scene_16
So please don't worry about us!	ね、心配しないで！	scene_16
Worry?	心配なんて…	scene_16
Yeah…	ああ…	scene_16
I'm not worried.	べつに心配なんて	scene_16
Just remember we're leaving early tomorrow.	明日には出発だからな	scene_16
You're right…	そうなんだ…	scene_16
OK, I know.	うん、わかった	scene_16
…mumble…mumble… (TIFA, promise me you're gonna be happy.)	ムニャムニャ……（TIFAちゃん絶対、しあわせになんだぞ）	scene_16
Heh, heh, heh! She and I are getting along pretty good.	エヘヘへ……彼女とはなかよくやってますよ	scene_16
But I'm such a pitiful waste…	でも、俺みたいな情けねえ野郎じゃね…	scene_16
…sigh…I'm not good enough for her. What should I do?	はあ……俺なんかじゃ、資格がねえよ。どうしたら、いいんだろ	scene_16
I proposed to her in the middle of all that Meteor stuff!	メテオのどさくさにまぎれて彼女にプロポーズしちゃったよ！	scene_16
I don't care even if the world were to end right now!	たとえこのまま世界が終わってもそれはそれ！	scene_16
I can't think of anything else!	いまはなにも考えられません！	scene_16
No, no, NO!! Meteor's getting closer every minute!!	ダメだダメだダメだ！！メテオがどんどんでかくなってる！！	scene_16
I wanna live my life right now!! I want to build a home and grow old together with her!	俺はいまがむしゃらに生きたい！！彼女といっしょに生きのびて所帯をもつのだ！！	scene_16
If you can't do it, then I will! And that's that!	あんたにできなきゃ、俺がやる！！ただそれだけだ！	scene_16
I'm gonna do my best, so you hang in there too!	俺もがんばるから、あんたもがんばれ！	scene_16
Oh! CLOUD!!	あっ！CLOUD！！	scene_16
Look, look at that!	あれ、見て！	scene_16
Who, Hojo?	あいつは宝条…	scene_16
That girl in the bikini?	水着の女の子か…	scene_16
Is that man over there, Hojo?	あの男、宝条か？	scene_16
Go over and talk to him.	ね、話つけてきてよ	scene_16
Not a bad view…	悪くないながめだな…	scene_16
What're you looking at?	もう！！　どこ見てんのよ！	scene_16
That man over there. That's Hojo from Shinra. Get outta here Go talk to him!	あそこの男、神羅の宝条よ！ふざけてないで話つけてきて！	scene_16
God!! What do you want?	あら！！なにか御用？	scene_16
I want to talk with him	そこの男に用がある	scene_16
Is that Hojo?	そいつは宝条か？	scene_16
(Hey, who do you think you are?)	（なによっ、えらそうに）	scene_16
Professor Hojo. That scary man says he wants to talk with you.	ねぇ、宝条博士～。こわい人が、用があるって～	scene_16
(What's his problem?)	（なんなのこの人）	scene_16
Yes, that's right. It's the Professor!	そうよぅ～。博士なのよぅ～	scene_16
Professor… someone's here to see you, sir.	博士～お客さんよぅ	scene_16
I have a bad feeling about this.	やな予感するね	scene_16
I'm busy right now.	いまいそがしい	scene_16
…But, Too bad.	……だって～。残念でしたぁ～	scene_16
No, I remember you all now…	いや、まちたまえ。きみはたしか、私の記憶にある……	scene_16
Heh heh heh… All right. You sure are loud.	クックックッ……。わかったよ、騒々しいなきみは	scene_16
Long time no see, CLOUD.	ひさしぶりだなCLOUDくん	scene_16
Yes, yes. I remember now.	ああ、そうそう。思い出しましたよ	scene_16
Hojo…	宝条……	scene_16
Sometimes you just gotta do something like this.	たまにはこういうのもいいものだね	scene_16
What are you doing?	……何をしている	scene_16
It should be obvious, I'm getting a tan.	見てのとおりだ。日光浴	scene_16
Answer me!	まじめに答えろ！	scene_16
Hmm! I believe we're both after the same goal.	ふん……私の目的は君と同じだと思うが	scene_16
You mean Sephiroth?	セフィロスか？	scene_16
Did you see him?	君たちは会えたのか？	scene_16
I see…Ha! Ha!	そうか……ふむふむ	scene_16
What is it?	なんだ？	scene_16
Nothing. I just remembered a certain hypothesis…	いや、ちょっとした仮説を思いついたのだが……	scene_16
Haven't you ever had the feeling something is calling you?	君は、何かに呼ばれているという感じがしたことはないかな？	scene_16
Or that you had to visit some place?	または、どうしてもある場所へ行かなくてはならないという気持ちになるとか……	scene_16
I'll go anywhere Sephiroth is at!	俺はセフィロスがいる場所ならどこへでも行く！	scene_16
To beat him and put an end to all this!	あいつを倒すために！決着をつけるためにな！	scene_16
I see… This could be interesting.	なるほど……これはイケるかもしれないな	scene_16
Were you in SOLDIER? Heh heh heh! Would you like to be my guinea pig?	ソルジャーか……クックックッ。ん、私の実験のサンプルにならんか？	scene_16
Oh, now what? Are you going to draw your sword?	ん…なんだ？剣でもぬくか？	scene_16
CLOUD, don't. If he dies, we won't find out anything!	CLOUD、だめっ！この人、死んだら何もわからなくなっちゃう！	scene_16
Stop, CLOUD! I know how you feel, but you mustn't.	やめて、CLOUD！気持ちはわかるけど、ダメよ	scene_16
Yo, yo! It's a bad idea to kill him.	お、おいっ！こいつをやるのはマズイんじゃねえのか？	scene_16
…huff…puff… Stop, CLOUD!	ゼェゼェ……やめろ、CLOUD	scene_16
Knock it off, CLOUD! Look I don't know, but he knows a lot of stuff, right?	だめだよ、CLOUD！アタシにはわかんないけどこいつ、いろいろ知ってんだろ？	scene_16
Say, aren't you the 'Ancient'? 	おや、ときにきみは……古代種の娘ではないか	scene_16
I'm AERIS. The least you can do is remember my name.	わたし、AERIS。名前くらい覚えなさいよ	scene_16
I want you to tell me something, Professor Hojo…	ねえ、宝条博士教えてほしいの	scene_16
I know I'm an Ancient. My mother told me.	わたし、自分が古代種なのは知ってる。母さんに聞いたから	scene_16
Your mother? Oh, you mean Ifalna. How is she?	母さん？ああ、イファルナか。元気にしてるのか？	scene_16
You didn't know!? She died.	知らないの？死んじゃったよ	scene_16
…I see.	……そうか	scene_16
Professor Hojo?	……ねえ、博士	scene_16
Is Jenova an Ancient? Is Sephiroth an Ancient? Do we all have the same blood?	ジェノバは古代種なの？セフィロスは古代種なの？わたしと同じ血、流れてるの？	scene_16
…mumble…mumble…head west…	……ボソボソ………西へ…………………	scene_16
He's mumbling slowly… That must mean he's hiding something!	ボソボソ作戦？ってことは、何か隠してる！	scene_16
Hey! Answer us!!	ねぇ！答えなさいよ！！	scene_16
Grrr, Grrr… …huff…puff…	ガルルル……！！……ゼェハァ……	scene_16
It's no use. It's no go.	……だめだ。むだだよ	scene_16
Professor Hojo is so sweet. He's going to experiment on me.	宝条博士ってやさしいんだよ。わたしを実験してくれるんだって	scene_16
He never takes off his lab coat even in this heat. I guess that's the mark of an intellectual.	この暑さのなか、実験服をぬぐことはない。知的な男のダンディズムよね～	scene_16
I'll interpret Professor Hojo's whispers.	宝条先生のボソボソを通訳するね	scene_16
Head west, past Mt. Corel and keep going…	ここから西のコレル山をこえて進んでる……	scene_16
Did you get that? I didn't understand it well, myself.	わかったかしら？わたし、よくわかんな～い	scene_16
I'd be happy to be a guinea pig, if it's for Professor Hojo!	宝条先生だったら、よろこんで実験台になっちゃう！	scene_16
Yes, Professor Hojo. Where?	はあ……宝条先生。いま、いずこ	scene_16
It looks like the Professor discovered or found a solution to something.	先生、なにかを発見～解明～したみたいなの	scene_16
You know, I wonder… if they headed west for Mt. Corel?	で、それっきり……やっぱり、西のコレル山にむかったのかしら	scene_16
I'm getting a little sad.	ちょっとくやしかったな	scene_16
Professor Hojo looks happy like a child when he discovers something. He gets this big smile and then laughs…	宝条先生、なにかを発見したとき子供みたいにうれしそうな顔でクックックッって笑って……	scene_16
I guess we should chase after him. A vacation for two from Mt. Corel to Gold Saucer.	あと、追っかけちゃおうかな。コレル山からゴールドソーサーへふたりのバカンス♥	scene_16
That's right!! It totally skipped my mind!	そうだっ！！わすれてたわ！	scene_16
There was something I was supposed to tell you.	な～んか、あなたにつたえなきゃいけないことがあったのよ	scene_16
That's right! It's about that!	そうよ！あれよ！	scene_16
It was yesterday. A man wearing a black cape came up from the ocean.	きのうのことなんだけど海から黒マントの男があがってきたの。ザバザバってさあ	scene_16
I think he had tickets for the Gold Saucer… no, that wasn't it… I wonder if it was all just an illusion?	ゴールドソーサーのチケットもってたような気がしたけど……そんなわけないよね。あれって、まぼろしかなあ	scene_16
Hey! President Rufus came here yesterday.	ねえ、ねえ？きのう、ルーファウス来たんでしょ	scene_16
He used to be the President's little boy. We nicknamed him the little Prez!	彼、昔はプレジデントのボンボンで～。ついたあだなが、プレジデントボンボン！	scene_16
He didn't look much different than the surfers on the beach.	そこで遊んでるサーファーたちとたいして変わらなかったのよ	scene_16
heh heh… All the good ones are gone.	へへ……ぜんぶ、とられちゃったよ	scene_16
What about that one? Shall we make do with her?	いまきた子でがまんすっか？	scene_16
But she's got a guy with her.	でも、彼がいっしょじゃん	scene_16
No problem, I can handle him.	あんくらいならだいじょぶだいじょぶ	scene_16
Right? You thought so, too?	ねぇ？　そだろ！	scene_16
Geez! What about those two?	ウヒ……あの二人組にするか？	scene_16
Heh heh…I want the one on the left.	へへ……おれ、左の子がいい！	scene_16
Well then, I guess that leaves me with the one on the right.	じゃ、おれ右でがまんするよ	scene_16
Hey… heh heh…don't forget to talk to me, too.	ねぇねぇ……ヘヘ……ちょっとは俺とも話してよ	scene_16
Yipes!! Help!!	うひゃ～！！たちけて～！！	scene_16
…breath…breath! Kind of takes your breath away, don't it!?	ハァッハァッ……！いきつぎわすれちゃうだろ～！！	scene_16
If you're headed for Mt. Corel, then you'd better buy some "Soft".	きみたち、コレル山へ向かうなら『金の針』を買っていくほうがいいよ	scene_16
At least that's what they always say, don't they?	よくいうでしょう？	scene_16
Be prepared, and you'll never fear.	そなえあればうれいなし。とらぬたぬきのかわざんようってばボクってインテリ！	scene_16
Hey, I'm no idiot. I NEVER count my chickens before they hatch! Not bad, huh?	う～ん、調子でません。これも神羅の男たちのせいさ	scene_16
Hmm. Man, I'm draggin' today. It's all Shinra's fault.	うらむよなあ、神羅カンパニー！悪者だよな、神羅	scene_16
I really hate Shinra, Inc.! They're all crooked, those Shinra.	へヘ……でも、これってひがみってやつだなあ。さわやかじゃないなあ	scene_16
Hmm… What a bitter guy Chill out a bit.	うひゃ！！話しかけないで～！	scene_16
Eeeew!! Leave me alone!	ウップ！　ブクブク………しずんじゃうよ～	scene_16
Ublk! …glug…glug… You're gonna make me drown!	いつものことだが本日もあいてにされないのであった	scene_16
Always the same story… Women never pay any attention to me…	ナンパならおことわりよ。まにあってますから	scene_16
If this is your idea of flirting…forget it. I do fine as it is.	海の風と太陽。自然っていいわね～。いきかえるわ～	scene_16
The sea, the wind and the sun. Don't you just love the outdoors? It always puts me back on track.	あら？　ちょうどいいところに	scene_16
Hey, good timing. Would you mind putting lotion on me?	オイルぬっていただけますか？	scene_16
With pleasure	よろこんで	scene_16
Sorry	おことわりだ	scene_16
Uhhhnn…	あ～ん♥	scene_16
Than--kyu!	ありがと♥	scene_16
Hey, loosen up a bit.	あら、おかたいのね	scene_16
I'm trying to learn how to swim before the end of the world.	世界の終わりまでに上手におよげるようにがんばってんだから～	scene_16
Sitting around waiting for Meteor to come…… Why's it gotta fall on us?	メテオはねてまてか……なんだってあんなもんがふってくんだろ	scene_16
It's getting closer and closer. Someone will do something, don't you think?	だんだん近づいてきてるの。だれか、なんとかしてくれるのよね	scene_16
The sea breeze, sun and Meteor. Isn't nature strange?	海の風と太陽とメテオ。自然って不思議よね～	scene_16
I don't care even if it is the end of the world, I just want to sit here and drink cocktails!	世界の終わりでもおいしいカクテルを飲みながらゆるりゆるゆるとすごしたいわ～！	scene_16
Ooooh…I think I drank too much.	ウェッ……の・み・す・ぎ	scene_16