Gongaga Village	ゴンガガ	scene_19
Jungle	ジャングル	scene_19
Meltdown Reactor	メルトダウン魔晄炉	scene_19
Residence	民家	scene_19
Zack's Home	ザックスの実家	scene_19
Mayor's Home	村長の家	scene_19
Received "Titan" Materia!	『タイタン』のマテリアを手にいれた！	scene_19
Received "Deathblow" Materia!	『ひっさつ』のマテリアを手にいれた！	scene_19
Received "X-Potion"!	『エクスポーション』を手にいれた！	scene_19
Received "White M-phone"!	『ホワイトメガホン』を手にいれた！	scene_19
You a traveller? Hey wait, that glow in your eye… Are you in SOLDIER?	旅の人かい……おんや？あんたのその目の輝きは……ソルジャーさんだね？	scene_19
Grandma	おばあさん	scene_19
Oh, you're right! Don't you know anything about our son?	あらあらホントだよ！あんたウチの息子を知らないかい？	scene_19
Grandpa	おじいさん	scene_19
His name is Zack.	ザックスっちゅう名前なんだが	scene_19
It's been close to 10 years since he left for the city, saying that he didn't want to live in the country…	こんなイナカじゃくらせないとか言い残して都会へいったままもう、かれこれ１０年近く……	scene_19
He left saying he's going to join SOLDIER. You ever hear of a Zack in SOLDIER?	ソルジャーになるっちゅうて村を飛び出したんだあんた、知らないかい？ソルジャーのザックス	scene_19
Hmmm…I don't know.	さあ……知らないな	scene_19
Zack…	……ソルジャーのザックス……	scene_19
Young lady, you know him?	娘さん、知ってるのかい？	scene_19
I remember he wrote us 6 or 7 years ago saying that he had a girlfriend. Could that have been you?	そういえば６、７年前に手紙がきてガールフレンドができましたって書いてあったけど、あんたかい？	scene_19
…No, it wasn't.	……ちがいます	scene_19
Zack…	ザックス……	scene_19
What a shock… I didn't know Zack was from this town.	……この村にザックスの家があるなんて知らなかったからびっくりしちゃった	scene_19
You know him?	知ってるヤツか？	scene_19
Didn't I tell you? He was my first love.	いつか話さなかった？わたし、初めて好きになった人	scene_19
Zack… SOLDIER First Class. Same as CLOUD.	ザックス……ソルジャー・クラス１ＳＴ。CLOUDと同じ	scene_19
Strange, there aren't that many who make First Class, but I've never heard of him.	クラス１ＳＴなんて何人もいないはずだ。でも俺は知らないな	scene_19
That's all right. It's all in the past now. I was just worried because I heard he's been missing.	別にかまわないの。むかしのことだしね。ただ、行方不明だから心配なだけ	scene_19
Missing?	行方不明？	scene_19
I think it was five years ago. He went out on a job, and never came back.	５年前かな。仕事で出かけてそれっきり	scene_19
He loved women, a real lady's man. He probably found someone else…	女の子が大好きなヤツだったからね。どこかで知り合った子と仲良くなっちゃったのよ、きっと	scene_19
Hey? What's wrong?	あれ？　どうしたの？	scene_19
Poor guy	それは心配だな	scene_19
(…jealous…envious…)	（やきもち……しっと……）	scene_19
I don't really mind that I haven't heard from him. But I feel for his parents.	いいんだけど、べつに。でも、ご両親にくらい連絡すればいいのにね	scene_19
Are you…jealous? Hmm?  Hmmm? Are you, CLOUD?	もしかして……やきもちやいてる？ん？　んん？どうなのかな、CLOUDくん？	scene_19
I'm kidding. I'm sorry.	な～んて、ごめんね	scene_19
I was hoping maybe you were…	そうだったらうれしい……かな	scene_19
AERIS…	AERIS……	scene_19
Let's go, CLOUD.	行きましょ、CLOUD	scene_19
Do you know him?	知ってるのか？	scene_19
N, no, I don't know him!	い、いいえ、知らないわ！	scene_19
Your face tells me differently.	いかにも知ってるって顔してるぞ	scene_19
I told you, I don't!	知らないんだってば！	scene_19
That sounds just like you, leaving town, and saying I'm joining SOLDIER!'.	でもさ、ソルジャーになるっ！なんて言い残して村を出たなんてまるでCLOUDみたいね	scene_19
There were a lot of guys like that back then.	あのころは、そういうヤツがたくさんいたんだろうな	scene_19
You must really be something making it in SOLDIER out of a group like that.	そんなたくさんのなかからソルジャーになるなんてCLOUD、えらいえらい	scene_19
I really respect you…	そんけいしちゃうなぁ……	scene_19
I just got lucky	運が良かっただけさ	scene_19
I worked hard for it	がんばったからな	scene_19
Don't be so humble!	けんそんしちゃってぇ！	scene_19
Hard work pays off, huh.	努力はむくわれるってわけね	scene_19
You know…	あのね……	scene_19
I'm as proud of CLOUD joining SOLDIER as if it were me.	CLOUDがソルジャーになったの私、自分のことみたいにほこらしいのよ	scene_19
CLOUD, thanks for caring.	CLOUD心配してくれてありがとう。	scene_19
A reactor explosion three years ago took my husband…	３年前の魔晄炉爆発事故で夫は……	scene_19
Do people really need reactors to live?	はたして、人が生きていくのに魔晄炉が必要なのでしょうか？	scene_19
Aren't there more important things in life?	もっと大切なことがあるのではないでしょうか……？	scene_19
You want something?	ほお……何か用かい？	scene_19
Buy weapons?	武器を買いたい	scene_19
Hear a story?	話を聞きたい	scene_19
Nothing in particular	特に用事はない	scene_19
Huh, did you want something?	え……何の用かしら？	scene_19
Buy accessories?	アクセサリーを買いたい	scene_19
Uh, need somethin'?	ああ……何か用か？	scene_19
Need a room?	宿泊したい	scene_19
Oh, you here to shop?	おお……買いものにきたのか？	scene_19
Buy items?	アイテムを買いたい	scene_19
This is Gongaga Village. Many people died here in a Mako reactor explosion.	ここは、ゴンガガ村。魔晄炉の爆発事故のために多くの人々を失った村じゃ	scene_19
The Shinra people told us that everyone would be happy once the reactor was built. But all it brought us was sadness…	神羅のものたちは、魔晄炉ができれば幸せになると言いおった。しかし、魔晄炉はわしらに悲しみしか与えなかった……	scene_19
Shinra built the reactor, without even thinking about the town's safety. And, this is the result.	神羅のやつらは、村の安全など考えずに、魔晄炉を建設した。その結果が、これさ	scene_19
One day, a huge explosion. killed many of the townspeople…	ある日、魔晄炉が大爆発を起こした。その事故に巻きこまれて多くの村人が死んでしまった……	scene_19
It's been a while since the explosion, but you can still find the pieces it left all over town.	魔晄炉の爆発事故が起こってからずいぶんたつが、そのつめあとはいまだに村のあちこちに残っている	scene_19
We voted to outlaw the use of Mako energy and live with nature, ever since the explosion.	わたしたちゴンガガ村の住人は魔晄炉の爆発事故があってからは魔晄エネルギーの利用を止めて自然とともに生きることを選んだの	scene_19
People can live without the Shinra's Mako Reactors.	神羅の魔晄炉がなくても人は生きていけるのよ	scene_19
No matter how much I pray, it won't bring our grandson back…	いくら　いのっても死んだマゴはかえってこん……	scene_19
…You don't have enough money. Come back when you get some.	……金が足りないな。金をためてから、来るんだな	scene_19
It's 80 Gil a night.	一泊８０ギルだぜ	scene_19
Pay up	８０ギル払う	scene_19
There's something shiny back there…	奥の方に、何か光るものがある……	scene_19
Don't do anything	何もしない	scene_19
Reach for it	手をのばしてみる	scene_19
A ruined reactor.	壊れた魔晄炉……	scene_19
TIFA… What happened?	TIFA……いったい、どうしたんだ？	scene_19
What happened to you two?	ふたりとも、どうしたんだ？	scene_19
…Zack.	……ザックス	scene_19
Zack. I don't know anything about that man.	ソルジャーのザックス。おれは、そんな男、知らない	scene_19
…But That name sounds familiar…	しかし……その名前には、聞き覚えがある……	scene_19
Why?	なぜだ……！？	scene_19
That can't…	そんな……	scene_19
Have you ever met someone in SOLDIER named Zack?	なあ、あんたザックスっちゅうソルジャーに会ったことはないかの？	scene_19
I can't believe he hasn't contacted us in 10 years…! …After all, we're his parents.	１０年も連絡もよこさんとは……なんちゅう息子じゃ	scene_19
It's 300 Gil a night.	一泊３００ギルだぜ	scene_19
Pay 300 Gil	３００ギル払う	scene_19
I am a traveling salesman, going around the world.	わたしは、世界を旅する行商人。	scene_19
I came because I heard that near this village was Materia strong enough to shake the earth.	このゴンガガ村の近くに『大地をゆるがす力を持つマテリア』があると聞いて、来てみたのだが……	scene_19
Even I get homesick and want to see my family.	そんなわたしだが、むしょうに家族に会いたくなることがある	scene_19
I have a favor to ask of you. Can you get this letter to my lovely wife?	そこであなたに、たのみがある。どうかわたしの愛する奥さんにこの手紙をとどけてもらいたい	scene_19
Will you do it for me?	おねがいできるだろうか？	scene_19
Take the letter	手紙を受け取る	scene_19
My wife lives in Kalm. I really appreciate this.	わたしの愛する奥さんはカームの町に住んでいる。どうか、よろしくたのむ	scene_19
What's going on in a world about to end? Is kindness the first to vanish?	なんということだ……死が目前に迫っているこの世界ではもはや人情もかれはてたか……	scene_19
They sell the weapons on the second floor. Climb up the pole to get there.	武器は、２階で売っているわ。そこの柱をのぼってちょうだい	scene_19
Lifestream? Never heard of it.	ライフストリーム？そんなもの、聞いた事ないわ	scene_19
Planet structure? …Who cares about that?	星のしくみ？……どうでもいいわ、そんなこと	scene_19
Why don't you go ask Bugenhagen of Cosmo Canyon hard questions like that?	そういうこむずかしい事はコスモキャニオンのブーゲンハーゲンという人に聞けば？	scene_19
Seems like the Shinra is planning something big to destroy Meteor…	あのメテオをこわすために神羅が大きな計画を立てているそうね……	scene_19
I heard they're going to do something with all that Huge Materia they've been gathering…	大きなマテリアを集めてなにかをするつもりらしいけど……	scene_19
After what happened with the reactor you can't trust Shinra.	魔晄炉のこともあるし神羅のすることは信用できないわ	scene_19
…Everyone's going to die. Everything's coming to an end.	……みんな、死ぬのよ。何もかもが、終わるのよ	scene_19
You lost? When that happens the only ones you can count on are your friends.	道にまよったのじゃな？そういう時に一番たよりになるのは友、じゃよ	scene_19
The first thing you gotta do is find your best friend.	もっとも大切な友を探すこと。それが先決じゃて	scene_19
This reactor's useless, but I hear there's still Huge Materia at the Corel, Fort Condor, and the Junon reactors.	ここの魔晄炉はもう使い物にならんが【コレル】、【コンドルフォート】、【ジュノン】の魔晄炉の中には、大きなマテリアが残っているそうじゃ	scene_19
Shinra's gathering all the Materia from those places… But for what?	いま神羅はそれの回収にかかっているそうだが……いったいなんのために	scene_19
Shinra's tried a lot of things, but it's only HUMAN. It's fate that Meteor will kill the people.	神羅もいろんな手をつくしたがしょせん、ちっぽけな人間のやること。メテオによって人が滅びるのは運命なのじゃよ	scene_19
Tell me, young man.	おしえてくれ、若者よ	scene_19
Can't we be happy without having to sacrifice anything?	幸せは、犠牲なしに得ることはできないのじゃろうか？	scene_19
Can't time pass without unhappiness?	時代は、不幸なしに越えることはできないのじゃろうか……	scene_19
Hey, CLOUD. How did the Turks know to wait and ambush us here?	ねぇ、CLOUD。どうしてタークスは、オイラたちをまちぶせできたのかな	scene_19
…You'd think someone told the Shinra about us?	……だれかが、オイラたちのことを神羅に知らせているのかな	scene_19
…Is someone there?	……誰かいる	scene_19
Hey, Rude. Who do you like?	なあ、ルード。あんた、誰がいいんだ？	scene_19
What are you getting so embarrassed about? Come on? Who do you like?	なに赤くなってるのかな、と。ん？　誰がいいのかな？	scene_19
…TIFA.	……………TIFA	scene_19
Hmm…	な、なるほど……と	scene_19
That's a tough one.	つらいところだな、あんたも	scene_19
But, poor Elena. She…you…	しかし、イリーナもかわいそうにな。あいつ、あんたのこと……	scene_19
No, she likes Tseng.	いや、あいつはツォンさんだ	scene_19
I never knew that! But Tseng likes that Ancient…	そりゃ初耳だな、と。だってツォンさんはあの古代種……	scene_19
What are they talking about?	あいつら何の話してるんだ？	scene_19
It's so stupid!	ホント、くだらない！	scene_19
They always talk about who they like or don't like. But Tseng is different.	先輩たち、いつでも誰が好きとかキライとかそんな話ばっかりなんですよ。ツォンさんは別ですけど	scene_19
Ah! Oh no!	あ！　いけない！	scene_19
They're here! They're really here!	先輩たち！来ました！あの人たち、ホントに来ましたよ！	scene_19
Hmm… Then it's time…	そうか……出番だな、と	scene_19
Rude…don't go easy on them even the girls.	ルード……あの娘がいても手を抜くなよ、と	scene_19
…Don't worry, I'll do my job.	……仕事はちゃんとやるさ	scene_19
Then, we're counting on you. I'll report to Tseng!	じゃ、先輩たち。あとはよろしくおねがいします。私はツォンさんに報告にいきま～す！	scene_19
It's been a while.	久しぶりだな、と	scene_19
Payback time for what you did in Sector 7.	７番街の借りを返すぞ、と	scene_19
Sector 7?	７番街……忘れたな	scene_19
Out of our way	ジャマだ……どこか行け	scene_19
That's sad.	それはさびしいな、と	scene_19
I don't like being taken for a fool.	なめられるのは嫌いだな、と	scene_19
Hey, something seems wrong, Like they knew we were coming.	ねえ、なんか変じゃない？待ちぶせされてたみたいよ	scene_19
…How could they know we were coming here.	……どうしてわかったのかな？わたしたち、ここに来ること	scene_19
I don't like it. How'd they find out where we were?	気にいらねえぜ。どうしてオレたちの居場所がわかったんだ？	scene_19
Interesting… They were definitely waiting for us.	興味深い……やつらはあきらかにまちぶせしていたようだが	scene_19
I don't like this! It's like the whole world knows where we're going.	なんかイヤなかんじ！アタシたちの行き先ってバレバレみたいだよ	scene_19
How'd they know that we were here?	なんで、ここにおるのんがわかったんやろ？	scene_19
How did they know that we were here?	何故、わたしたちがここにいることがわかったのだ……	scene_19
They followed us… But there weren't any signs of it. Then, that means…	尾行されたか……いや、そんな気配はなかった。ということは……	scene_19
A spy? No way.	スパイ！？……まさか	scene_19
That there's a Shinra spy…	神羅のスパイがいるとか……	scene_19
A spy, maybe? No, no way.	もしかしてよ、スパイ？いや、まさかな	scene_19
…someone's been informing them.	……だれかが内通しているのか	scene_19
Maybe it's someone in this group?	仲間んなかにスパイでもいるんじゃないの～？	scene_19
You don't think there's a spy, do you CLOUD?	まさか、CLOUDさんスパイでもおると、思てますんか？	scene_19
I hate this. Now everyone's gonna blame me because I'm new.	たまらんなぁ～。そんなん、新入りのボクがうたがわれるんに決まってますやん	scene_19
It means there's a Shinra spy…	神羅の手先がいる……ということか？	scene_19
I don't even want to think about there being a spy…	スパイがいるなんて考えたくもない……	scene_19
I trust everyone.	俺はみんなを信じるよ	scene_19
That's as far as you go.	これ以上、先には進ませない	scene_19
Man, looks like they've taken a short cut.	気にくわねぇな。先回りされてるみてぇだ	scene_19
And a couple of Shinra dogs are here too!	けっ、神羅のイヌがいるってのかよ！	scene_19
The Shinra build reactors to make money. And this is what happens.	神羅のやつらは、金もうけのために魔晄炉をつくる。そして、その結果がこれだ	scene_19
You saw that village. It's always the powerless that suffer from tyrants like Shinra.	見ただろう、あの村を。神羅の横暴でよ、被害にあうのはいつでも力を持たない人間だぜ	scene_19
The one's with the power control those without it. That's just the way of the world now.	力を持つものが持たないものを支配する。それが、今の世界ってわけだ	scene_19
But I can't let 'em do that. That's why I formed AVALANCHE to fight 'em.	オレは、そんなことは許せねぇ。『アバランチ』を結成して神羅カンパニーと戦ってるのもそんな世界を変えてえからだ	scene_19
…Yo, CLOUD You still gonna fight with us, right?	……なあ、CLOUDこれからもオレたちと一練に戦ってくんだろ？	scene_19
We need you, man.	オレたちにゃ、おまえが必要なんだ	scene_19
You got it	任せておけ	scene_19
Thanks, man.	ありがとうよ	scene_19
…!!	…………！！	scene_19
I never shoulda believed you.	おまえなんかに期待したオレがバカだったよ	scene_19
This reactor's a failure.	ここの魔晄炉は失格ねえ	scene_19
What I'm looking for is big, large, Huge Materia. You seen any?	私が探してるのはビッグでラージでヒュージなマテリアなのよ。あなた知らない？	scene_19
…No I haven't seen it. I'll get on it right away.	……存じません。さっそく調査します	scene_19
Please. We could make the ultimate weapon if we only had some.	おねがいね。それがあれば究極の兵器がつくれそうなのよ	scene_19
I just can't wait.	それは楽しみですね	scene_19
With Hojo gone, the Weapon Development's been getting a bigger budget.	宝条がいなくなったおかげで私の兵器開発部に予算がた～っぷりまわってくるの	scene_19
I envy them.	うらやましいかぎりです	scene_19
But, even if we make the perfect weapon, could that stupid Heidegger even use it?	でもね、せっかく完璧な兵器をつくってもあのバカのハイデッカーに使いこなせるのかしら	scene_19
Oh…sorry! I forgot Heidegger was your boss! Ha ha ha!	あら、ごめんなさい！ハイデッカーはあなたの上司だったわね！キャハハハハ！	scene_19
Let's go!	行きましょ！	scene_19
…Big, large, Huge Materia?	ビッグでラージでヒュージなマテリア？	scene_19
An ultimate weapon? The perfect weapon?	究極の兵器？完璧な兵器？	scene_19
Just what are the Shinra up to?	神羅め、今度は何を始めるつもりなんだ……	scene_19
It's Scarlet, Head of Shinra Weapon Development.	神羅の兵器開発部部長スカーレットのおでましか--	scene_19
Hmph! This isn't any good either.	……フンッ！ここもダメだわ	scene_19
You only get junky Materia from junky reactors.	チンケな魔晄炉にはチンケなマテリアしかないみたいね	scene_19
This is just part of the job. Don't take it personally.	これも仕事だ。悪く思うなよ、と	scene_19