Cosmo Canyon	コスモキャニオン		scene_20
I am home! It is I, Nanaki!	ただいま～！ナナキ、帰りました～	帰	scene_20
Hey, Nanaki! You're safe!	おお、ナナキ！無事だったか！	無事	scene_20
Come on, and say hello to Bugenhagen!	さあ、ブーゲンハーゲンさまにごあいさつを！		scene_20
…Nanaki?	……ナナキ？		scene_20
Welcome to Cosmo Canyon. Are you familiar with this land?	ようこそコスモキャニオンへ。この地のことはごぞんじですか？	地	scene_20
No	知らないな	知	scene_20
Welcome to Cosmo Canyon. Make yourselves at home.	ようこそコスモキャニオンへ。ゆっくりしていってください		scene_20
You lied. That is something that is not treated lightly here in Cosmo Canyon.	ウソをつきましたね。このコスモキャニオンでは許されないことですよ	許	scene_20
Let me explain.	では、語らせていただきましょう	語	scene_20
People from all over the world gather here to seek the Study of Planet Life.	ここには世界中から『星命学』を求める人々があつまってきます	世界中星命学求人	scene_20
Wooooooooo!	うぉぉおおお！		scene_20
I always wanted to come here!	来たかったぜコスモキャニオン！	来	scene_20
Ummgah! I'm sorry it's full now, so I can't let you enter.	んが！今は定員いっぱいなので中には入れてあげられません	今定員中入	scene_20
They helped me when I was on the road. Please let them in.	その人たちにはほんのちょっとだけ世話になったんだ。いれてあげてよ	人世話	scene_20
…Oh, is that so? You helped our Nanaki? Please, come in.	……そうでしたか。ナナキがほんのちょっとだけ世話になりましたか。では、どうぞおはいり下さい	世話下	scene_20
Who is Nanaki?	ナナキというのは？		scene_20
Nanaki is Nanaki. That's his name.	ナナキはナナキ。かれの名前です	名前	scene_20
Leaving already? You should get some rest.	もう行くのか？少し休んでいけばいい	行少休	scene_20
Since you're here, why don't you listen to Bugenhagen's story?	せっかくですからあなたがたもブーゲンハーゲンさまのお話をきいていかれては？	話	scene_20
Leaving already? But it appears your friends still want to learn more about the Planet…	おや、もうご出発ですか？あなたのお友だちはまだ星について学びたいみたいですが……	出発友星学	scene_20
Did you get to see Bugenhagen's contraption? If you haven't yet, you must!	ブーゲンハーゲン様のアレはごらんになりました？まだでしたら、ぜひどうぞ！	様	scene_20
Hm? If you're looking for Bugenhagen, he went to the Sealed Door.	あれ？ブーゲンハーゲン様なら『無用の扉』のほうへ行かれましたよ	様無用扉行	scene_20
Remember, there's a steel door on the way to Bugenhagen's room.	ホラ、ブーゲン様のお部屋へ行くとちゅうのあの鉄の扉ですよ	様部屋行鉄扉	scene_20
What's that door there for anyhow? It's been closed forever…	ホントにあの扉なんの役にたつんでしょう？ずーっと閉じたままで……	扉役閉	scene_20
Oh, it's you. This is terrible. The color of that unlucky star…	ああ、あなたたちですか。大変なことになってしまいましたね。あの不吉な星の色……	大変不吉星色	scene_20
The children are all so scared that they won't even go outside.	子供たちなんか、こわがって外へ出てこようとしないんですよ	子供外出	scene_20
I'd rather not see it either…	できることなら、わたしだってあんなもの、見たくはないですがね……	見	scene_20
Bugenhagen seems rather down ever since he returned from that trip.	あの旅から帰られてからというものブーゲンハーゲン様、あまり元気がないようなんです	旅帰様元気	scene_20
I'm worried something might happen to Bugenhagen now of all times…	こんな時にブーゲン様にまでもしものことがあったら……しんぱいです	時様	scene_20
Nanaki, it's really bad. Ever since Bugenhagen returned from that last trip, he doesn't seem well.	おおナナキ、大変なんだ。あの旅から帰られてからというものブーゲンハーゲン様、あまり元気がないんだよ	大変旅帰様元気	scene_20
Why don't you hurry and see Bugenhagen?	おまえも早くブーゲン様のところへ行ってあげておくれ	早様行	scene_20
Bugenhagen is what keeps our hearts strong…	ブーゲンハーゲン様は今の私たちの心のささえです……	様今私心	scene_20
Here is where I was…I mean, …this is my hometown.	ここがオイラの……ちがうちがう！……ここが私の故郷だ	私故郷	scene_20
My tribe were protectors of those who appreciate this beautiful canyon and the Planet.	私の一族はこの美しい谷と星を理解する人々を守ってくらしてきた	私一族美谷星理解人守	scene_20
My brave mother fought and died here, but my cowardly father left her… I am the last of my race.	だが勇ましい戦士であった母は死にふぬけの父は逃げだし一族は私だけになってしまった	勇戦士母死父逃一族私	scene_20
Cowardly father?	ふぬけの父？	父	scene_20
Yes. My father was a wastrel.	ああ。父は見下げたふぬけ野郎だ	父見下野郎	scene_20
And so the mission I inherited from my ancestors is to protect this place. My journey ends here.	だから、ここを守るのは残された私の使命だ。私の旅はここで終わりだ	守残私使命私旅終	scene_20
Hey! Nanaki--! You're home!	お～い！　ナナキ～！帰ったのか～！	帰	scene_20
Coming, Grandpa!	いまいくよ！　じっちゃん！		scene_20
Good timin'. Let's take a breather.	ちょうどいい。オレたちもここらで小休止といこうぜ	小休止	scene_20
I got stuff I want to find out, too.	オレはいろいろ知りてえこともあるしな	知	scene_20
That's perfect. Why don't we take a break too? We can meet back here in a while, OK?	ちょうどいいわ。私たちも一休みしない？しばらく自由行動ね！	私一休自由行動	scene_20
Let's rest for a bit. There are some things I want to find out about anyway.	ね、ちょっと休んでこ。わたし、いろいろ聞いてみたいことあるし	休聞	scene_20
Rest, rest, rest! I wanna rest! Ok! That's that!	休も休も休も！アタシたちも休もっ！よし、けってーい！	休休休休	scene_20
I'm just dead tired. Everyone, how 'bout some rest?	もうヘロヘロですわ。みなさん、ぼちぼち休みにしませんか？	休	scene_20
Yaaay! Nanaki! Nanaki's back! It's all thanks to this flame!	わーい、わーい！ナナキが！ナナキが帰ってきたです！この炎のおかげなのです！	帰炎	scene_20
This fire is called 'Cosmo Candle'. It has burned for generations.	この火はね。『コスモキャンドル』なのです。むかーしむかしからもやされつづけてるのです	火	scene_20
It is a holy flame that protects this canyon.	つまり、この谷をまもる聖なる炎ってわけなのです	谷聖炎	scene_20
I've heard it only went out once, long ago.	でもね、あたしが生まれるうーんとまえに１度だけこの火が消えたことがあったんですって……	生度火消	scene_20
The elders said something horrifying occurred, but I really don't know much else about it.	とってもこわーいことがあったって長老はいってたけどあたし、よくわからないのです	長老	scene_20
So this is Cosmo Canyon… Quite a mysterious place.	これがコスモキャニオン……なるほど、神秘的な場所ですね	神秘的場所	scene_20
Have you come to seek the Study of Planet Life?	あなたがたも『星命学』の研究にいらしたので？	星命学研究	scene_20
No	そうじゃない		scene_20
Oh yeah? What? The car broke down!?	おや、さようで。え？　車がこしょう？	車	scene_20
Why don't you look around Cosmo Canyon while I fix the car?	車がなおるまでコスモキャニオンを見学されては？	車見学	scene_20
Please get some rest while I fix your car.	車がなおるまでゆっくり、体を休めてください	車体休	scene_20
The repair on your car is completed.	車の修理、終わりましたよ	車修理終	scene_20
Now you should be able to go wherever you want.	これでもう、どこへでもいけるはずです		scene_20
How much do I owe?	お礼の金を……	礼金	scene_20
Much obliged	助かった、それじゃ	助	scene_20
No charge! You'd do the same for me, right?	お礼なんて！困ったときはおたがいさまです	礼困	scene_20
Please, take 1000 gil	１０００ギル受けとってくれ	受	scene_20
I guess you're right	それもそうだ、それじゃ		scene_20
…You don't even have that much. Don't tease me, okay?	……そんなお金持ってないじゃないですか。からかわないでください	金持	scene_20
Are you sure…? Well, all right. Thank you.	そうですか……それじゃ、えんりょなく		scene_20
Oh yeah. Did you stay at the inn already?	ああそうそう。ここの宿屋、もう泊まりました？	宿屋泊	scene_20
There was a bottle on the sofa there a couple of days ago…was it yours?	この前、あそこのソファーにきれいなビンが置いてあったんですがあなたがたのですか？	前置	scene_20
Oh, really?	おや、そうですか		scene_20
There really isn't much else to see here.	しかしここにはほかに見るべきものもあまりないようですがね	見	scene_20
Yeah? I heard there's an awesome observatory here. I'd like to see it if I have a chance.	やはりそうですか。なんでもここにはスゴイ天文台があるそうですからね。ぜひ一度見てみたいものです	天文台一度見	scene_20
Whoa!!	うわっ！！		scene_20
Don't scare me like that. I almost fell over.	おどかさないでくださいよ。危うく落ちるところだった	危落	scene_20
Nanaki, are you leaving again? We want you to stay here forever…	ナナキ、またどこかへいっちゃうですか？ずっとここにいてほしいです……		scene_20
Mmm… I think the teachings of the 'Study of Planet Life' are true.	う～ん……『星命学』の教えはたしかに正しいです。そう思います	星命学教正思	scene_20
But can people used to Mako energy ever go back…?	でも一度魔晄の便利さを知ってしまった人間がはたしてもとにもどれるのだろうか……	一度魔晄便利知人間	scene_20
Mmm… I can't stand here talking about the Study of Planet Life'.	う～ん……もう『星命学』がどうこう言ってられなくなりました	星命学言	scene_20
I think I'll head back to my homeland now…	私もそろそろ故郷にもどることにしますよ……	私故郷	scene_20
Oh, Nanaki's with you. Make yourselves at home.	おお、ナナキもいっしょか。ゆっくりしていきな		scene_20
Wait for me! I'm coming too!	待ってくれ！　オイラも行く	待行	scene_20
Mmm?	うん？		scene_20
Bugenhagen	ブーゲンハーゲン		scene_20
CLOUD. Please look after Nanaki.	CLOUDよ。ナナキをよろしくたのむ		scene_20
I think I grew up a little. That's what happened!	オイラ、少しだけ大人になった。そういうこと！	少大人	scene_20
Ho Ho Hoooo. Come back whenever you need my knowledge.	ホーホーホウ。わしの知識が必要になったらいつでも歓迎じゃ	知識必要歓迎	scene_20
Tasty Cocktails!	おいしいカクテル！		scene_20
Pub "Starlet"	パブ『スターレット』		scene_20
Fluffy Beds!	フカフカのベッド！		scene_20
In "Shildra Inn"	宿屋『シルドラ・イン』	宿屋	scene_20
Come in today!	ぜひいちど		scene_20
It's right near Cosmo Candle!	おたちよりください！聖火コスモキャンドルのすぐそばです！	聖火	scene_20
Cosmo…Canyon? I wonder if there's any relation to the planet or the Ancients…	コスモ……キャニオン？関係あるのかな？星とか、古代種とか……	関係星古代種	scene_20
I finally made it… So this is…Cosmo Canyon!	ついに来たぜ……ここが、ここがコスモキャニオンか！	来	scene_20
RED XIII seems different, doesn't he?	RED XIII、なんだか様子がヘンじゃない？	様子	scene_20
Hmmm… Any Materia? Any Materia around?	ムフフ……あるかなマテリア？マテリアあるかな？		scene_20
Hmmm…So this is Cosmo Canyon.	ハア……これがコスモキャニオンですか		scene_20
Oh, welcome.	あら、いらっしゃい		scene_20
The people of this canyon hate to compete. So almost everything here are replicas.	この谷の人間は、あらそいをきらうからね。ここにあるのも、ほとんどレプリカなのさ	谷人間	scene_20
But that's all right. Some of them you really can use.	でもだいじょうぶ。ちゃんと使えるものもあるからね	使	scene_20
Welcome. You still want more weapons? You sure are weird…	はいよ、いらっしゃい。あれ、まだ武器を買うの？あんたも変わった人だね……	武器買変人	scene_20
Uh, I mean, it's weird. If there weren't people like you, I'd be out of business. Heh, heh, heh…sweat…!	まあいいや、そんな人もいないとわたしもヒマになっちゃうからね。ハハハハハ！	人	scene_20
Number 4	ナンバー４		scene_20
Now hiring!	アルバイトぼしゅう！		scene_20
Looking for someone who	タイクツにたえられる		scene_20
can stand long hours of boredom!	ガマンづよい方求む！	方求	scene_20
For details, contact	くわしいお間い合わせは	間合	scene_20
the "Turtle's Paradise"!!	居酒屋『かめ道楽』まで！！	居酒屋道楽	scene_20
No experience necessary.	経験は間いません。	経験間	scene_20
Looking for emotionally stable people	武器を見てもこうふんしない	武器見	scene_20
who don't get excited at the sight of weapons!	おだやかな性格の方求む！	性格方求	scene_20
We offer a small, but good	ちょっとせまいけれど		scene_20
working environment!	明るいしょくばです！	明	scene_20
Elder's Room	長老の部屋	長老部屋	scene_20
Elder Hargo	長老ハーゴ	長老	scene_20
Where did I put it? I know it's around here…	どこへやったかいの……たしかこのへんに……		scene_20
Mmm? Oh, we have guests.  Good, good.	ん？おお、これまたお客さんか。いいともいいとも	客	scene_20
I know, I know.	わかっとる、わかっとる		scene_20
You came to ask me something, right? Am I right?	ワシになにかききにきたんじゃろ？　そうじゃろ？		scene_20
It's about the Promised Land	約束の地の話	約束地話	scene_20
Not really	そういうわけじゃない		scene_20
…The Promised Land. So what do you want to know?	……約束の地。そうか、知りたいか	約束地知	scene_20
There is no one place called the Promised Land. That's what I believe.	約束の地というのはなはっきり言って存在しない。ワシはそう考えておる	約束地言存在考	scene_20
No, no, it does exist. Hmmm…you can say that.	いやいや、存在する。ふむふむ……そうとも言える	存在言	scene_20
In other words, it doesn't exist for us, but it did for the Ancients.	ようするにワシらには存在しないが古代種にとっては存在した	存在古代種存在	scene_20
The Promised Land is the resting place of the Ancients.	ミもフタもない言い方をすれば約束の地は古代種の死に場所じゃ	言方約束地古代種死場所	scene_20
The life of the Ancients is one continuous journey. A journey to grow trees and plants, raise animals, and make Mako energy.	古代種の人生はきびしい旅の日々じゃ。草や木、動物、あらゆる生き物を増やして精神エネルギーをそだてる旅	古代種人生旅日草木動物生物増精神旅	scene_20
Their harsh journey continued throughout their lives…	彼らのつらい旅は生きているあいだずっと続いたという……	彼旅生続	scene_20
The place they returned to after their long journey… Their burial land is the Promised Land.	その旅を終え、星に帰る場所……つまり死に場所が約束の地	旅終星帰場所死場所約束地	scene_20
Huh? Supreme Happiness? I believe that, for the Ancients, it was the moment that they were able to return to their Planet, That moment when they were released from their fate, and gained their supreme happiness…	あん？　至上の幸福？古代種にとっては星に帰る瞬間運命から解き放たれる瞬間それは至上の幸福ではなかったか……と	至上幸福古代種星帰瞬間運命解放瞬間至上幸福	scene_20
At least that's what I believe. I really don't know whether or not it's true.	ワシはそう考えておるんじゃ。今となっては真実はわからんがの	考今真実	scene_20
Oh, that's not what you're here for?	なんじゃ、ちがったのか。		scene_20
I'd appreciate it if you didn't talk about such foolish things as legends and old wives tales.	悪いんじゃが、伝説とか昔話とかワシにはそんな話しかしてやれんよ	悪伝説昔話話	scene_20
There was this guy who studied Planetary Life' here.	ここで星命学を学んだ男がいたんだ	星命学学男	scene_20
He couldn't take things the way they were, so he went to Midgar to form AVALANCHE.	そいつは感動してこのままじゃいけないと考えてミッドガルでアバランチを結成した	感動考結成	scene_20
Wanna hear more?	……こんな話、興味ないよな？	話興味	scene_20
Go on	つづけてくれ		scene_20
Guess you could say this is where AVALANCHE was born.	言ってみりゃ、ここがアバランチの原点だな	言原点	scene_20
I always wanted to come here… And finally…I made it.	オレも一度は来たいと思っていたが……ついに……来た……ぜ	一度来思来	scene_20
A lot's happened…	いろいろ……あったぜ……		scene_20
And then?	つづきは？		scene_20
And then…? I don't know what's going to happen, now that there is no AVALANCHE…	つづき……？これからのことはわからねえ。アバランチはもうねえんだ……		scene_20
By the way, those that came with you are all at the Cosmo Candle.	そういえば、おまえさんといっしょに来た連中がコスモキャンドルの前に集まっとったよ	来連中前集	scene_20
Are you leaving?	もう出発するんかい？	出発	scene_20
Ahh, here it is.	おお、あったあった		scene_20
My job is to gather all the legends and the knowledge of the Planet and to make a book.	ワシの仕事はこの谷につたわる伝説や星の知識を本にすること	仕事谷伝説星知識本	scene_20
Then, even when I return to the Planet, the children may still be taught about many things…	こうすればワシが星にかえっても子供たちにいろいろなコトを教えてやれる……	星子供教	scene_20
Mm…oh, this? This is the Book of Stars. I'm just finishing it.	ん……ああ、これかね。これは星の本。もう少しで書き終わるところだよ	星本少書終	scene_20
Nothing is meaningless. If I do this then, someday, someone will run across it.	無意味なことなんかないとも。こうしておけば、いつかかならず誰かの目にふれるもんさ	無意味誰目	scene_20
The Ancients did the same. That is how we know about them, right? Maybe even my book also…	古代種だってそうしたんだ。だからワシたちは、彼らを知ることができただろ？ワシのこの本だって、きっと……	古代種彼知本	scene_20
I think Bugenhagen has foreseen things.	ブーゲンハーゲン様にはすべてお見とおしかもしれんよ	様見	scene_20
About the Planet… About Nanaki… And, about himself…	この星のこと……ナナキのこと……そしてご自分のこと……	星自分	scene_20
But, Bugenhagen would never say that. All he says is 'Ho Ho Hoooo'…	でも、ブーゲン様のことだからそんなこと言わんじゃろな。いつも『ホーホーホウ』……	様言	scene_20
Welcome to 'Shildra Inn'.	ようこそ『シルドラ・イン』へ		scene_20
It'll be 100 gil a night. Would you like to stay?	一泊１００ギルになりますがお休みになりますか？	一泊休	scene_20
Welcome to 'Shindra Inn'. It's times like this when a nice soft bed will do you good.	ようこそ『シルドラ・イン』へ。このような時にこそ人にはやわらかなベッドが必要なのです	時人必要	scene_20
Please	おねがいします		scene_20
No thank you	今はけっこうです	今	scene_20
Welcome to 'Shildra Inn'	ようこそ『シルドラ・イン』へ。		scene_20
As long as there are guests, our lights will always be on.	この地をおとずれる旅人がいるかぎりこの宿の明かりが消えることはありません	地旅人宿明消	scene_20
No, thanks	やめとくぜ		scene_20
It's times like this when a nice soft bed will do you good.	このような時にこそ人にはやわらかなベッドが必要なのです	時人必要	scene_20
I'm sorry, but you don't seem to have enough for a room…	まことにもうしわけありませんがお客様、宿泊料のほうが……	客様宿泊料	scene_20
Have a great dream of the stars…	すてきな星の夢を……	星夢	scene_20
Well then, please come again.	では、またのおこしをおまちしております		scene_20
Were you able to hear the stars whispers?	星のささやきはきこえましたか？	星	scene_20
Welcome. How 'bout our original cocktail, 'Cosmo Candle?'	いらっしゃい。うちのオリジナルカクテル『コスモキャンドル』はいかがです？		scene_20
A drink now and then is good for you. It'll relax you a bit. …If you know when to stop.	お酒はいいですよ。人の心をほがらかにさせますから。……ホドホドならね	酒人心	scene_20
How about our original cocktail, 'Lifestream'?	うちのオリジナルカクテル『ライフストリーム』はいかがです？		scene_20
You should forget your troubles with a drink. We humans sure are weak creatures…	お酒を飲んで、つらい心をたとえひとときでもいやせるのなら、それもいい。人間なんて弱いものです……	酒飲心人間弱	scene_20
That reminds me. I heard that someone here in Cosmo Canyon is selling some Healing Materia.	そういえば、このコスモキャニオンのどこかに、いやしのマテリアがあるという話を聞いたことがありますが	話聞	scene_20
Elder Bughe	長老ブーガ	長老	scene_20
Mmm…	ほいほい		scene_20
What is it?	なんじゃなんじゃ？		scene_20
The story of the Ancients	古代種の話を……	古代種話	scene_20
…Hmm. That's no fun… I wanna tell a story.	……チェッ。つまらんのう。長話をしたいのう	長話	scene_20
You can't talk of the Ancients, without mentioning Professor Gast. He used to come here sometimes.	古代種といえばガスト博士なのじゃ。時々ここにも来ておった	古代種博士時来	scene_20
He was a Shinra scholar who spent his life studying the Ancients.	博士は古代種のナゾを追い続けた 神羅の学者だったのじゃ。	博士古代種追続神羅学者	scene_20
He was a serious person, you never would have thought he'd be in Shinra.	神羅っぽくない生真面目な人じゃ	神羅生真面目人	scene_20
Must've been about 30 years ago, when he found the corpse of an Ancient. He was elated!	かれこれ３０年ちかく前になるがついに古代種の死体を見つけたとよろこんでおったな	年前古代種死体見	scene_20
If I recall…he named it 'Jenova' and was doing a lot of research…	たしか……ジェノバとかいう名前をつけていろいろ研究しておったのじゃが……	名前研究	scene_20
One day, he showed up here, looking very distressed.	ある日つかれきった顔をしてここに現れてな	日顔現	scene_20
He was mumbling something about Jenova not being an Ancient and that he'd done a terrible thing…	ブツブツ言うには、なんでもジェノバは古代種ではなかったとかとんでもないことをしてしまったとか……	言古代種	scene_20
He's been missing since then. I heard that he never went back to Shinra	それ以来、行方不明じゃ。神羅にももどらんかったそうじゃ	以来行方不明神羅	scene_20
So, if you ever see Professor Gast, I want you to tell him…	というわけでなガスト博士に会うことがあったら伝えてほしいんじゃ	博士会伝	scene_20
That the old man that likes to drink in Cosmo Canyon, wants to hear about the Ancients.	コスモキャニオンの酒好きジイさんが古代種の話を聞きたがっているとな	酒好古代種話聞	scene_20
Well, there's lots to talk about, but most things about the Ancients are all legend and folk tales, and no one knows the truth.	ま、話したいのはやまやまじゃが古代種のことは言い伝えや伝説ばかりで真実はもうだ～れにもわからんのじゃ	話古代種言伝伝説真実	scene_20
Mmm. I'm starting to feel good now. That bartender's cocktails always hit the spot.	ん～ええ気分じゃ。マスターのつくるカクテルはいつも最高じゃの	気分最高	scene_20
Is that so? You brought Nanaki back here?	そうかそうか。おまえさんたちがナナキをつれてきてくれたのか		scene_20
Yeah, thanks.	ウンウン、ありがとうよ		scene_20
Maybe there are some people here that know about the Promised Land and the Ancients.	ここなら約束の地とか古代種とかくわしい人、いるかもね	約束地古代種人	scene_20
RED XIII… I wonder what's happened to RED XIII…? He's as excited as a little boy.	RED XIII……どうしたのかな？子供みたいにはしゃいで	子供	scene_20
Are you going somewhere?	どこかへ行くの？	行	scene_20
Live with the Planet, die with the Planet.	星とともに生き星とともに死ぬ	星生星死	scene_20
Maybe this is the way it should be. Who knows? I'm full of booze…	これはこれでいいのかもしれん。酒もたらふく飲めたしの……	酒飲	scene_20
It's when I think about the children. I wonder if we can just save our own children.	でも、子供たちのことを考えるとなあ。あの子らだけでもなんとかならんもんかのぅ	子供考子	scene_20
Where is the Promised Land…? Maybe Bugenhagen knows.	約束の地はどこにあるのか……ブーゲンハーゲン様はごぞんじなのかもしれんなあ	約束地様	scene_20
Isn't Nanaki starting to notice? The reason why Bugenhagen sent him away from the canyon…	ナナキもなんとなくわかりはじめておるんとちがうかい？ブーゲンハーゲン様がナナキをこの谷から出した理由が……	様谷出理由	scene_20
No. 5	ナンバー５		scene_20
Our cocktails are good but our wine is the best! Please stop in the Turtle's Paradise!!	カクテルもいいけどやっぱり地酒がいちばん！ぜひいちど居酒屋『かめ道楽』へ！！	地酒居酒屋道楽	scene_20
…num…yawn…Sir… You…forgot…your… …change.	ムニャムニャ……お客さん……おつり……おつりわすれてます……	客	scene_20
…num…Yes, I'm coming…	ンニャ……は～い……ただいま……		scene_20
Are you here to shop?	お買いもの……ですふぁ？	買	scene_20
Oh…is that so… then let me…yawn…sleep…	ああ……そうですか……ならほっといて……ムニャ		scene_20
Oh…is that so…  You're here to shop?	ああ……そうですか……お買い……もの……お買いもの！？	買買	scene_20
I'm sorry! We hardly ever get any customers. Oh, but I DO have confidence in our Materia!	し、しつれいしました！あんまりお客さんがこないもんで……あ、でもマテリアは自信ありますよ！	客自信	scene_20
I'm…I'm so sorry! It seems I've gotten used to being lazy…	し、しつれいしました！いや、すっかりナマケぐせがついてしまったみたいで……		scene_20
Oh man… Everything will be over, once Meteor hits…	あ～あ……あの星がぶつかったらぜんぶおしまいか……	星	scene_20
I've been selling Materia for 10 years now, ever since I was 16. Geez, what have I been doing with my life?	１６からコツコツとマテリアを売りつづけてもう１０年。いったい僕の人生って……ん？	売年僕人生	scene_20
Welcome! Oh, it's nothing. Now, please make yourselves comfortable!	いらっしゃいませ！いえ、なんでも、なんでもないんです。さあ、どんどん買っていってくださいね！	買	scene_20
Thank you very much!	ありがとうございました！		scene_20
Oh man! This place looks like a real drag. And their Materia sucks, too.	あ～あ！たいくつそうなところだよ。たいしたマテリアもないしね		scene_20
God. I HATE studying!	う～。勉強はキライだよっ！	勉強	scene_20
Oh, welcome home. You want dinner first? Or…	あら、おかえりなさい。ね、すぐディナーにする？それとも……		scene_20
Dinner	ディナー		scene_20
Or…	それとも……		scene_20
All right, it'll be ready in no time…	は～い、それじゃすぐ……		scene_20
Oh honey…	まあ♥あなたったら……		scene_20
Wh…who are you? You…can't just come barging into my home uninvited!!	だ、誰ですかアナタ！か、かってに人のスイートホームに入ってくるなんて！！	誰人入	scene_20
Hmm, this place seems like it has a lot of secrets.	なんや、いろんな秘密がありそうなとこやな	秘密	scene_20
So, when's dinner?	ところでオバちゃんごはんまだですか？		scene_20
All right, all right. I'm making it right now.	ハイハイ。いまつくってますよ		scene_20
…But I wonder which one is going to eat…	……でもいったいどっちが食べるのかしら……	食	scene_20
Those two…uh, Anyway, are you two friends? It really seems strange.	あの２人……というかなんというか……とにかく、あなたのお仲間？変わってるわね	人仲間変	scene_20
What did they say?	なんやいいましたか？		scene_20
Oh man, I'm so busy. I need more help. …mummble…complain…	ああ、いそがしい。もっと人手がほしいわ。ブツブツ……	人手	scene_20
Hmm… I wonder what's going to happen now?	ハァ……どうなるのかしら。これから……		scene_20
Don't worry, Mom! All of us just need to go through that door!	かーちゃん、へいきだよ！みんなであのトビラの向こうにいけばいいんだ！	向	scene_20
Mr. Bugenhagen sealed it so we wouldn't have to worry about it!	ブーゲンハーゲン様がフーインしてるんだからしんぱいないよ！	様	scene_20
But what's a seal?	でも、フーインてなんなんだろ……		scene_20
What's wrong with Bugenhagen? Is he sick?	ブーゲン様、どうしたの？びょうきなの？	様	scene_20
No need to be sad, even if something should happen. Everything will return to the Planet…Bugenhagen says so.	何がおきても悲しむことはない。すべては星に帰っていく……ブーゲンハーゲン様はそうおっしゃいます	何悲星帰様	scene_20
Just the thought of something happening to Bugenhagen…worries me.	でも、ブーゲンハーゲン様になにかあったらと思うと……やっぱり悲しいです	様思悲	scene_20
Nanaki's Room	ナナキの部屋	部屋	scene_20
Don't worry about me. I've seen it many times.	オイラはいいよ～。何度も見たからさ	何度見	scene_20
I haven't been back for a while… Let me rest for a bit.	ひさしぶりに帰ってきたんだ。ゆっくりさせてよ……	帰	scene_20
It's not that I'm afraid of that big star.	べつにあのでっかい星がこわいんじゃないんです	星	scene_20
It's just that, uh, I have a stomach ache… That's why I'm not moving. That's the truth!	えっと、おなかがいたいからジッとしてるだけなのです。ホントなのです！		scene_20
Both Nanaki and Bugenhagen are gone… I feel so lonely…	ナナキもブーゲンハーゲン様もいないです……あたし、さびしいです……	様	scene_20
That Nanaki's slick! He said, I'll protect this canyon'! But he didn't. Forget about Nanaki.	ナナキ、ズルイです！『オイラがこの谷をまもるよ』ってそう言ってたのに！ナナキなんか、もうしらないです……	谷言	scene_20
Sorry…I'm really sorry. But now, I have…	ゴメン……ゴメンよ。でも、今のオイラには……	今	scene_20
He's finally come home, but Bugenhagen doesn't seem well…	やっと帰ってきてくれたのにブーゲンハーゲン様、元気ないです……	帰様元気	scene_20
I want to hear Bugenhagen talk with Nanaki like we used to do…	はやく前みたいにナナキといっしょにブーゲンハーゲン様のおはなしききたいです……	前様	scene_20
Nanaki, is it true that Bugenhagen left on a journey? Then that means he's better, right? He IS going to come back soon, right?	ナナキ、ブーゲンハーゲン様たびにでたって本当なの？なら、元気になったんだよね？またすぐに帰ってくるよね？	様本当元気帰	scene_20
…Don't worry. Grandpa will come back floating, saying 'Ho Ho Hoooo' again…	……だいじょうぶ。じっちゃんのことだからまたすぐにプカプカやってくるさ。『ホーホーホウ』って……		scene_20
Yea, that's right! Ho Ho Hoooo'!	ウン、そうなのです！『ホーホーホウ』なのです！		scene_20
It's Ho Ho Hoooo! Ho Ho Hoooo!	ホーホーホウです！ホーホーホウ！		scene_20
Shildra Inn	シルドラ・イン		scene_20
Hello. Looking for anything in particular?	やあ、どうも。何をお探しかな？	何探	scene_20
Hi. Of course, our store's open.	おや、どうも。もちろん、店は開いてますよ	店開	scene_20
No need to fear. I have the Study of Planet Life' right here.	怖くはありません。私には『星命学』がありますから	怖私星命学	scene_20
No, maybe I AM a bit afraid. But, whenever I'm reading 'Study of Planet Life,' I can forget all my fears.	いや、本当は怖いのかもしれない。でも、少なくとも『星命学』の本をよんでいる間は、そのことを忘れられるんです……	本当怖少星命学本間忘	scene_20
Received "Elixir"!	『エリクサー』を手に入れた！	手入	scene_20
Received "Telpostone"!	『テレポストーン』を手にいれた！	手	scene_20
Received "Magic Source"!	『マジックアップ』を手にいれた！	手	scene_20
Received "Full Cure" Materia!	『フルケア』のマテリアを手にいれた！	手	scene_20
Gate of Naught	『無用の扉』前	無用扉前	scene_20
Bugenhagen sealed this door shut.	このトビラってさあ。ブーゲンハーゲンさまがフーインしてるからあかないんだ		scene_20
How'd he do that? With super glue?	フーインて、なんだろ？きょうりょくせっちゃくざいのことかな？		scene_20
Nope… It doesn't open… How'd he seal it? With a huge magnet?	う～ん……やっぱりひらかないよ～。フーインてなんなんだろ？きょうりょくじしゃくかな？		scene_20
It seems like the only one that	やはりブーゲンハーゲンでなければ		scene_20
can open it is Bugenhagen…	開けられないようだ……	開	scene_20
Observatory	天文台	天文台	scene_20
Bugen Research Center	ブーゲンの研究所	研究所	scene_20
CLOUD, this is my grandfather, Bugen.	CLOUD、この人がブーゲンのじっちゃん	人	scene_20
He is incredible. He knows everything.	なんでも知ってるすごいじっちゃんさ	知	scene_20
Ho Ho Hoooo. I hear that you looked after Nanaki. 	ホーホーホウ。ナナキがちょっとだけ世話になったようじゃの	世話	scene_20
Nanaki is still a child you see.	ナナキはまだまだ子供だからのう	子供	scene_20
Please stop, Grandfather. I'm 48.	やめてくれよ、じっちゃん！オイラはもう４８歳だよ	歳	scene_20
Ho Ho Hoooo. Nanaki's tribe has incredible longevity.	ホーホーホウ。ナナキの一族は長命じゃ	一族長命	scene_20
So you see his 48 years would only be equivalent to say that of a 15 or 16 year old in human reckoning.	４８歳といっても人間の年で考えればまだ１５、６歳くらいのものじゃ	歳人間年考歳	scene_20
15 or 16!?	１５、６歳！？	歳	scene_20
He's quiet and very deep. You thought he was an adult?	無口で考え深い。あんたはナナキのことを立派な大人だと思っていたのかな？	無口考深立派大人思	scene_20
…Grandfather. I want to be an adult.	……じっちゃん。オイラはやく大人になりたいんだよ	大人	scene_20
I want to grow up to be able to protect you and the village.	はやくじっちゃんたちを守れるようになりたかったんだよ	守	scene_20
Ho Ho Hoooo. No Nanaki. You can't stand on your own yet.	ホーホーホウ。いかんな、ナナキ。せのびしてはいかん		scene_20
To do that now would destroy you in the long run.	せのびをするといつかは身をほろぼす	身	scene_20
Reaching up into the heavens, threatening to snatch the very stars from the great city of Midgar. You've seen it, haven't you?	天にとどけ、星をもつかめとばかりにつくられた魔晄都市。あれを見たのであろう？	天星魔晄都市見	scene_20
Well, that's a bad example. Looking up too much makes you lose perspective.	あれが悪い見本じゃ。上ばかり見ていて自分の身のほどを忘れておる	悪見本上見自分身忘	scene_20
When it's time for the Planet to die, you'll understand that you know absolutely nothing.	この星が死ぬときになってやっと気づくのじゃ。自分が何も知らないことにな	星死気自分何知	scene_20
…When the Planet dies?	……星が死ぬ？	星死	scene_20
Ho Ho Hoooo. It may be tomorrow, or 100 years from now… But it's not long off.	ホーホーホウ。明日か１００年後か……それほど遠くはない	明日年後遠	scene_20
How do you know this?	どうしてそんなことがわかるんだ？		scene_20
I hear the cries of the Planet.	星の悲鳴が聞こえるのじゃ	星悲鳴聞	scene_20
The sounds of the stars in the heavens. While this goes on, planets are born, and die.	天に輝く星の音。こうしているうちにも星は生まれ、死ぬ	天輝星音星生死	scene_20
What was that?	今のは？	今	scene_20
Ho Ho Hoooo. That was a scream from the Planet.	ホーホーホウ。この星のさけびじゃ	星	scene_20
Didn't you hear it? As if to say… I hurt, I suffer…	痛い、苦しい……そんなふうに聞こえるじゃろ？	痛苦聞	scene_20
They have come here on a journey to save the planet.	CLOUDたちは星の命を救うために旅をしているんだ	星命救旅	scene_20
Why don't you show them your apparatus?	じっちゃんのじまんのアレを見せてやったらどうかな	見	scene_20
Ho Ho Hoooo. To save the planet? Ho Ho Hoooo!	ホーホーホウ！星を救う！　ホーホーホウ！	星救	scene_20
Impossible. What can humans do?	そんなことは不可能じゃ。人間なんぞに何ができる	不可能人間何	scene_20
But, then again, I guess it wouldn't hurt to show him.	しかし、なんじゃ。わしのじまんのアレを見るのはけしてムダではなかろう	見	scene_20
He brought friends, too. I'll go get them.	ああ、その人たちもCLOUDの仲間だ。オイラが行くよ	人仲間行	scene_20
CLOUD, please call one of them.	そうだCLOUD。誰かつれておいでよ	誰	scene_20
Only three people can fit in Grandfather's machine.	じっちゃんのアレは定員３名だからね	定員名	scene_20
Bugenhagen!	ブーゲンハーゲンさま～！		scene_20
Several odd looking people are here.	またヘンテコな人たちがいっぱいきましたです～	人	scene_20
The whole place has gotten busy all of a sudden.	なんじゃ、急にさわがしくなったな	急	scene_20
Don't worry. My machine won't run away. Go and invite your friends.	そうあわてんでもわしのアレはにげたりせんよ。仲間もさそってくるといい	仲間	scene_20
Here, over here. The door's unlocked, come in.	お～い、こっちじゃ。とびらのカギは開いとるから入ってくるがいい	開入	scene_20
I hope great Bugenhagen will take care and not overexert himself.	ブーゲンハーゲン様のことどうかよろしく。あまりムリはさせないように	様	scene_20
'Ho Ho Hoooo.' I may be light, But I'm not as young as Nanaki.	『ホーホーホウ』なんてフワフワしてても、ナナキのように若くはないからして……	若	scene_20
Oops. That will only get you angry. You're just like me.  Ho ho ho.	おっと。そんなコト言ってると怒られるかの。ワシも似たようなもんだしの。ホッホッホ	言怒似	scene_20
Ho Ho Hoooo. It looks like you have them all together. Then let's begin.	ホーホーホウ。そろったようじゃな？それじゃ、はじめようかの		scene_20
I'll stand there.	ホレ、そこにたつんじゃよ		scene_20
So pretty…It's just like the real thing!	きれい……ホントの宇宙みたい。ね、CLOUD？	宇宙	scene_20
Wow! It's just like the real thing!	うわ～！　本物の宇宙みたい！	本物宇宙	scene_20
This is really somethin'!	こいつはすげえ！		scene_20
Whew! Just like the real thing!	ひゃぁ～！ほんまもんみたいや～！		scene_20
Woa! Wooooah! Pretty good, surprisin' me!	おっ！　おおっ！アタシを驚かせるなんてやるじゃないか！	驚	scene_20
Hmm, yes pretty good. This is my laboratory.	ほほ、そうじゃろう。これがワシのじまんの実験室じゃ	実験室	scene_20
All the workings of space are entered into this 3D Holographic System.	この宇宙の仕組みが全てこの立体ホログラフィシステムにインプットされておる	宇宙仕組全立体	scene_20
Hey! A shooting star!	あっ！　流れ星！	流星	scene_20
Look, look! A shooting star!	みてみて！流れ星！	流星	scene_20
Whoa! There goes a shootin' star!	おわっ！　流れ星や！	流星	scene_20
Whoa! Shootin' stars!	おおっ！　星が流れてるぜ！	星流	scene_20
Wh, what the? A shooting star?	な、なんだ？　流れ星？	流星	scene_20
Wow, how wonderful.	うわ～、ステキ		scene_20
Oh! This is amazing!!	スゴイ、スゴイ、スゴイスゴ～イ！！		scene_20
I'm so overwhelmed!	感激もんですわ～！	感激	scene_20
This's really somethin'!	こいつはすごいぜ！		scene_20
Whew!!	ヒュ～！！		scene_20
Ho Ho Hoooo. Yes, it is something, isn't it?	ホーホーホウ。そうじゃろ、すごいじゃろ		scene_20
Well, let's get to the subject.	さて、そろそろ本題に入ろうかの	本題入	scene_20
Eventually…all humans die. What happens to them after they die?	人間は……いつか死ぬ。死んだらどうなる？	人間死死	scene_20
The body decomposes, and returns to the Planet. That much everyone knows. What about their consciousness, their hearts and their souls?	身体は朽ち、星に帰る。これは広く知られているな。では、意識、心、精神はどうじゃ？	身体朽星帰広知意識心精神	scene_20
The soul too returns to the Planet.	じつは精神も同じく星に帰るのじゃな	精神同星帰	scene_20
And not only those of humans, but everything on this Planet. In fact, all living things in the universe, are the same.	人間だけではない。この星、いや宇宙に生きるものすべてひとしく	人間星宇宙生	scene_20
The spirits that return to the Planet, merge with one another and roam the Planet.	星に帰った精神はまざりあい、星をかけめぐる	星帰精神星	scene_20
They roam, converge, and divide, becoming a swell, called the 'Lifestream'.	星をかけめぐり、まざり、分かれ『ライフストリーム』と呼ばれるうねりとなる	星分呼	scene_20
Lifestream… In other words, a path of energy of the souls roaming the Planet.	ライフストリーム……すなわち星をめぐる精神的なエネルギーの道じゃな	星精神的道	scene_20
'Spirit Energy' is a word that you should never forget.	『精神エネルギー』この言葉を忘れてはいかん	精神言葉忘	scene_20
A new life…children are blessed with Spirit Energy and are brought into the world.	新しい命……子供たちは精神エネルギーの祝福を受けてうまれてくる	新命子供精神祝福受	scene_20
Then, the time comes when they die and once again return to the Planet…	そして、時が来て、死にまた星に帰る……	時来死星帰	scene_20
Of course there are exceptions, but this is the way of the world.	むろんいくつかの例外はあるがこれがこの世界の仕組みじゃ	例外世界仕組	scene_20
I've digressed, but you'll understand better if you watch this.	いろいろ話してしまったがまあ、これを見たらわかるじゃろ	話見	scene_20
Spirit energy is the source of life for	精神エネルギーのおかげで	精神	scene_20
trees, birds, and humans.	木や鳥や人間は……	木鳥人間	scene_20
And not only living things.	いやいや生き物だけではない。	生物	scene_20
It makes it possible	星が星であるためには	星星	scene_20
to form Planets.	精神エネルギーが必要なんじゃ。	精神必要	scene_20
And if that Spirit Energy	その精神エネルギーが	精神	scene_20
were to disappear…	なくなったらどうなる？		scene_20
It would be the end of life as we know it.	……終わりじゃ	終	scene_20
…These are the basics of the Study of Planet Life.	……これが星命学の基本じゃな	星命学基本	scene_20
If Spirit Energy disappears, our Planet will die.	精神エネルギーが失われると星が滅びる……	精神失星滅	scene_20
Ho Ho Hoooo. Spirit Energy is efficient BECAUSE it exists within nature.	ホーホーホウ。精神エネルギーは自然の流れの中でこそその役割を果たすのじゃ	精神自然流中役割果	scene_20
When Spirit Energy is forcefully extracted, and manufactured, it can't accomplish its true purpose.	むりやり吸い上げられ加工された精神エネルギーは本来の役割を果たさん	吸上加工精神本来役割果	scene_20
You're talking about Mako energy, right?	魔晄エネルギーのことを言ってるのか？	魔晄言	scene_20
Everyday Mako reactors suck up Spirit Energy, diminishing it.	魔晄炉に吸い上げられずんずん減っていく精神エネルギー	魔晄炉吸上減精神	scene_20
Spirit Energy is compressed in reactors and processed into Mako energy. All living things are being used up and thrown away.	魔晄炉によって過度に凝縮される精神エネルギー。魔晄エネルギーなどと名づけられ使いすてられているのは、すべて星の命じゃ	魔晄炉過度凝縮精神魔晄名使星命	scene_20
In other words, Mako energy will only destroy the Planet…	すなわち魔晄エネルギーはこの星を滅ぼすのみ……じゃ	魔晄星滅	scene_20
The story of the planets… and those who lived with them…	星の話……星とともに生きた者の話……	星話星生者話	scene_20
If you want to know more, then you must listen to the words of the elders.	もっと知りたいかの？それなら長老たちの話を聞くとよかろう	知長老話聞	scene_20
Nanaki? His father a coward?	ナナキが？父親をふぬけと？	父親	scene_20
So that's it…Nanaki's been thinking that all this time…	そうか……ナナキがそんなことを……		scene_20
Ho Ho Hoooo. You people.	ホーホーホウ。あんたたちか		scene_20
Where is Nanaki? I hope he wasn't a burden.	ナナキはどうしてるかの？メイワクかけとらんかの？		scene_20
Ho Ho Hoooo. I'm glad you're back, Nanaki.	ホーホーホウ。よく帰ったな、ナナキ	帰	scene_20
I hate to trouble you, but please look after Nanaki.	すまんが、これからもナナキのことをよろしくな		scene_20
Ho Ho Hoooo. That's a machine only I can use.	ホーホーホウ。それはわしにしかあつかえんキカイじゃよ		scene_20
Ho Ho Hoooo.	ホーホーホウ		scene_20
…no time for humming now. The Planet is nearing imminent death.	……と言ってられる場合じゃないんじゃの。まさに星の死が近づいておる	言場合星死近	scene_20
But is this perhaps, what the Planet wanted? Did the Planet actually want to end like this?	しかし、これが星の望んだことかの？星はこんな終わりかたをねがったのかの？	星望星終	scene_20
I don't believe so. Were it not so, you people would still have much to do.	そんなはずはないじゃろう。だとすれば、まだあんたたちにもやれることはあるはずじゃ		scene_20
And myself, too. Come back whenever you are in need of my knowledge.	もちろんわしにもじゃ。わしの知識が必要になったらいつでもきてくれい	知識必要	scene_20
Where is CLOUD? Wasn't he with you?	ところでCLOUDは？いっしょじゃないのかの？		scene_20
Cosmo Candle	コスモキャンドル		scene_20
Cosmo Canyon… This's where AVALANCHE was born…	コスモキャニオン……アバランチの生まれた場所……	生場所	scene_20
I promised my guys someday… when we saved the Planet from the Shinra, that we'd all go to Cosmo Canyon and celebrate…	あいつらと約束してた。いつか……神羅からこの星をすくったその時にはコスモキャニオンへ行って祝杯をあげよう……	約束神羅星時行祝杯	scene_20
Now they're all gone… died for the Planet.	みんな……みんないなくなっちまった……この星を守るために	星守	scene_20
…Really? To save the Planet?	……本当に？この星の命を守るため？	本当星命守	scene_20
We all… we all hate the Shinra…	オレたちは……オレは……神羅が憎かっただけ……	神羅憎	scene_20
But is it right to go on?	そのオレに……これ以上旅をつづける資格はあるのか？	以上旅資格	scene_20
Will they… …will they ever forgive me?	あいつらは……それを許してくれるのか？	許	scene_20
…Right now, I really don't know. But I do know one thing.	……今はわからねえ。だがよ、オレはきめたんだ	今	scene_20
If there's anything I can do, to save the Planet…or the people livin' on it… Then I'm gonna do it!	オレが何かすることでこの星が……この星にすむ人間がすくわれるなら、オレはやるぜ	何星星人間	scene_20
I don't care if it's for justice or revenge, or whatever. I don't care…	正義だとか復讐だとかそんなことは他のやつらが勝手に決めりゃいい	正義復讐他勝手決	scene_20
Urrrrrgh! I'm gonna do it!!	うおおおお！オレはやるぜ！！		scene_20
Again… Again…AVALANCHE's born again!	もう一度……もう一度アバランチの結成だ！	一度一度結成	scene_20
Bonfires are funny, aren't they?	たき火って不思議ね	火不思議	scene_20
They make you remember all sorts of things.	なんだかいろんなこと思い出しちゃうね	思出	scene_20
You know, CLOUD. five years ago…	あのねえ、CLOUD。５年前……	年前	scene_20
…It's nothing.	……ううん		scene_20
No, forget it. I'm afraid to ask…	やっぱりやめる。聞くのが……怖い	聞怖	scene_20
What is it?	なんだよ		scene_20
It feels like… it feels like you're going far away…	CLOUD……どこかに行っちゃいそうで……	行	scene_20
You really, really are… you…right?	CLOUDは……本当に本当にCLOUD……だよね	本当本当	scene_20
I learned a lot. The elders taught me many things.	わたし、べんきょうしちゃった。長老さんに教えてもらったの。いろいろ	長老教	scene_20
About the Cetra… And the Promised Land…	セトラのこと……約束の地のこと……	約束地	scene_20
I'm…alone… I'm all alone now…	わたし……ひとりだから……ひとりだけになっちゃったから……		scene_20
But I'm…we're here for you, right?	俺が……俺たちがいるだろ？	俺俺	scene_20
I know. I know, but… I am the only…Cetra.	わかってる。わかってるけど……セトラは……わたしだけなの		scene_20
Does that mean we can't help?	俺たちじゃ、力になれないのか？	俺力	scene_20
What a boring place, just like I thought. I wanna go somewhere! Let's go find some Materia!	予想どおり、たいくつなとこだね～。はやく、どっか行こ！そいで、マテリア探そ！	予想行探	scene_20
I wonder how many years it's been… Gosh, it brings back memories……	こんなん、何年ぶりやろか……な～んや、いろんなこと思いだしますなぁ……	何年思	scene_20
…Long ago.	……ずっとむかし		scene_20
…When I was still very small. We were all around this flame…	オイラが本当に子どものころだ。あの日も、やっぱりみんなでこの火をかこんで……	本当子日火	scene_20
No, never mind…	やっぱり話すのや～めた	話	scene_20
It's about my parents.	オイラの両親のことだからさ	両親	scene_20
When I talk about my Mother, I am full of pride and joy…	母さんの話をするとオイラの胸はほこらしい気持ちではちきれそうになる	母話胸気持	scene_20
And that's fine. …But when I think of my father, my heart is full of anger…	それはいいんだ。でも、父親のことを思い出すとオイラの胸は怒りで……	父親思出胸怒	scene_20
…You really can't forgive your father?	……やはり父親が許せないか	父親許	scene_20
Of course. He…left Mother for dead.	当たりまえだよ。あいつは……母さんを見殺しにしたんだ	当母見殺	scene_20
When the Gi tribe attacked, he ran off by himself, leaving Mother and the people of the Canyon!	ギ族が攻めてきたときあいつは１人で逃げ出した。母さんと谷の人たちを放り出してさ！	族攻人逃出母谷人放出	scene_20
…Come, Nanaki. There's something you should see.	……来るがよい、ナナキ。おまえにみせたいものがある	来	scene_20
The place may be dangerous.	ちょっとばかり危険な場所だ	危険場所	scene_20
CLOUD. Will you and one other person come with us?	CLOUDよ。おまえと、あと１人いっしょに来てくれんか	人来	scene_20
…Where're they going?	……どこ行こうってんだ？	行	scene_20
Can I go too?	私も行っていいの？	私行	scene_20
I wonder what he wants to show RED XIII?	何かしらね、RED XIIIに見せたいものって……	何見	scene_20
Dangerous? Count me out…	キケンなんやったらエンリョしますわ……		scene_20
I wonder what he wants to show him? Hmm, maybe it's Materia that's been passed down for generations?	見せたいものって、アレかな？ホラ、この谷に代々つたわるマテリアとかさ！	見谷代	scene_20
Are we all set?	用意はいいかの？	用意	scene_20
Not ready yet? Tell me when you are ready.	なんじゃ、まだか。用意ができたら教えておくれ	用意教	scene_20
Ho Ho Hoooo. Shall we go?	ホーホーホウ。なら、行くとするかの	行	scene_20
All right. Come in, come in.	これでよし。さあ、入った入った	入入	scene_20
Okay. You lead the way, Grandpa…	あれ？じっちゃんが案内してくれるんじゃないの？	案内	scene_20
What, are you crazy? It's dangerous in there. I told you that!	な～に言うとるんじゃ。ちょっとばかり危険だと言うたじゃろ	言危険言	scene_20
You want an old man like me to go first? I'll be right behind you.	年寄りに先を行かせるのか？わしは後ろからついていくよ	年寄先行後	scene_20
Sealed Cave	封印の洞窟	封印洞窟	scene_20
What is it? You're going back? I'll be waiting here for you when you're ready.	なんじゃ、もどるのか？わしはここで待ってるから用意ができたらすぐくるんじゃぞ	待用意	scene_20
I can't leave this door open forever.	この扉、いつまでも開けておくわけにもいかんのでな	扉開	scene_20
Good. Then we shall proceed.	よしよし。それじゃ行くとしよう	行	scene_20
Cave of the Gi	ギ族の洞窟	族洞窟	scene_20
Everyone here's a Ghost of the Gi tribe, killed in a certain battle.	ここにいるのはみなギ族の亡霊じゃ。ある戦士に倒された、な	族亡霊戦士倒	scene_20
 A certain battle?	ある戦士……？	戦士	scene_20
The vengeful spirits of the Gi didn't disappear, and couldn't return to the Lifestream…	しかし、死してなおギ族の憎悪の精神は消えず、ライフストリームに帰ることすらこばんでいるのじゃ……	死族憎悪精神消帰	scene_20
We still have far to go. Ho Ho Hoooo.	先はまだ長いぞ、ホーホーホウ	先長	scene_20
This cave leads to the back of Cosmo Canyon.	この洞窟はコスモキャニオンの裏へとつづいておる	洞窟裏	scene_20
If we had been attacked by the Gi here, we wouldn't have stood a chance.	ここからギ族に攻め入られたらひとたまりもなかったじゃろう	族攻入	scene_20
This is a strange looking rock…	不思議な形をした石だ……	不思議形石	scene_20
Break it open	くずしてみる		scene_20
Leave it alone	そっとしておく		scene_20
Funny looking rock…	おかしな形をした石だ……	形石	scene_20
An odd shaped rock…	きみょうな形をした石だ……	形石	scene_20
A strange shaped rock…	変わった形をした石だ……	変形石	scene_20
Received "Added Effect" Materia!	『ついかこうか』のマテリアを手にいれた！	手	scene_20
As you can see, this cave leads to the back of Cosmo Canyon.	みてのとおり、この洞窟はコスモキャニオンの裏へとつづいておる	洞窟裏	scene_20
Even though the Gi outnumbered us, they could not attack through here because the passage is too narrow.	ギ族はわしらより体も大きくなにより残忍じゃ。ここから攻め入られたらひとたまりもなかったじゃろう	族体大残忍攻入	scene_20
Let's move on.	さあ、先へ進もうかの	先進	scene_20
Received "Black M-phone"!	『ブラックメガホン』を手にいれた！	手	scene_20
This warrior went through the cave all alone.	その戦士はこの洞窟を１人で走りぬけた	戦士洞窟人走	scene_20
Fighting attackers one after another…	次から次へと襲いかかってくるギ族と戦いながら……	次次襲族戦	scene_20
Grandpa… That warrior…	じっちゃん……その戦士って……	戦士	scene_20
Ho Ho Hoooo… We're almost there.	ホーホーホウ……あと少し、じゃな	少	scene_20
Received "Fairy Ring"!	『フェアリーリング』を手にいれた！	手	scene_20
What is this?	なんということじゃ……		scene_20
Grandpa, is he?	じっちゃん、こいつは……！？		scene_20
After death… The ghosts of the Gi. Like stagnant air…	死してなお……ギ族の亡霊が……よどんだ大気のように……	死族亡霊大気	scene_20
This…can't be!!	これは……いかん！！		scene_20
…Thank you, CLOUD. because of you, we survived.	……ありがとう、CLOUD。あんたたちのおかげでなんとか助かったよ	助	scene_20
Nanaki, you have grown strong, too.	ナナキもいつのまにか、ずいぶん強くなっていたんじゃな	強	scene_20
…Oh yeah?	へへへ……そうかな？		scene_20
Now I know that it wasn't a mistake bringing you here…	やはりお前を連れてきたのは間違いではなかったようじゃ……	前連間違	scene_20
Come, I have something I want to show you. Right over here.	さ、お前に見せたいものはすぐそこじゃよ	前見	scene_20
Received "Gravity" Materia!	『じゅうりょく』のマテリアを手にいれた！	手	scene_20
Cet Wall	セトの壁	壁	scene_20
This is…	ここは……		scene_20
…The warrior who fought against the Gi.	……その戦士はここでギ族と戦った	戦士族戦	scene_20
He kept them from taking even one step into Cosmo Canyon.	ギ族が一歩たりともコスモキャニオンに入りこめないようにな	族一歩入	scene_20
But he was never able to return to town…	そして自分は二度と村へもどることは	自分二度村	scene_20
Look, Nanaki. Look at your father, at the warrior, Seto.	見るがいいナナキ。おまえの父、戦士セトの姿を	見父戦士姿	scene_20
…That… That's…Seto?	……あれが……あれが……セト……？		scene_20
Seto continued to fight the Gi tribe here. …To protect this Canyon.	セトはあそこでギ族と戦いつづけた。この谷を守りつづけた	族戦谷守	scene_20
Even after the Gi's poisonous arrows turned his body to stone…… Even after they all ran away… Seto, continued to protect us.	ギ族の毒矢で体を石にされても……ギ族がすべて逃げだしたあとも……戦士セトはここを守りつづけた	族毒矢体石族逃戦士守	scene_20
And he continues to protect us, even now.	いまもこうして守りつづけている	守	scene_20
Even now…	いまも……		scene_20
You thought that he was a coward and ran away. But he, alone risked his life to protect Cosmo Canyon.	たとえ、逃げだしたひきょうものと思われても、たった１人、命をかけてコスモキャニオンを守ったんじゃ	逃思人命守	scene_20
That is your father, Seto.	それがおまえの父親セトじゃ	父親	scene_20
That…is Seto? …!? Did Mother know?	あれが……あれがセト？……！？母さんはこのことを？	母	scene_20
Ho Ho Hoooo…She knew. The two of them made me promise to keep this cave shut.	ホーホーホウ……知っておったよ。２人はあの時、わしに頼んだんじゃ。この洞窟は封印してくれとな	知人時頼洞窟封印	scene_20
They asked me to seal it myself and not to tell a soul.	わし１人で封印しそのことは誰にも話してはいけない	人封印誰話	scene_20
They said we should forget about this cave.	こんな洞窟のことは忘れた方が良いから、と言ってな	洞窟忘方良言	scene_20
CLOUD… Would you mind leaving the two of us alone?	……CLOUD。勝手を言ってすまないがわしら、２人きりにしてくれんかの	勝手言人	scene_20
Nanaki. I want you to continue your journey with CLOUD and the others.	ナナキよ。CLOUDたちと旅をつづけるのじゃ	旅	scene_20
Grandpa!?	じっちゃん！？		scene_20
Listen, Nanaki.	聞くのじゃ、ナナキ	聞	scene_20
CLOUD says they are trying to save the Planet.	CLOUDたちは星を救うなどと言っておるな	星救言	scene_20
Honestly, I don't think it can be done.	正直なところ、そんなことができるとは、わしには思えん	正直思	scene_20
For even if they stop every reactor on the Planet, it's only going to postpone the inevitable.	この星のすべての魔晄炉を止めても星の死は、ほんの少しのびるだけじゃ。	星魔晄炉止星死少	scene_20
Even if they stop Sephiroth, everything will perish.	セフィロスとやらを倒しても同じこと。かたちあるものは必ず滅す、じゃ	倒同必滅	scene_20
But, Nanaki. I've been thinking lately.	だがな、ナナキ。わしは最近考えるんじゃ	最近考	scene_20
I've been thinking if there was anything WE could do, as a part of the Planet, something to help a Planet already in misery…	こんなにも星が苦しんでいるのに星の一員、いや、星の一部であるわしらにできることは本当に何もないのか、とな	星苦星一員星一部本当何	scene_20
No matter what happens, isn't it important to try?	結果はどうなろうと何かやることが大切なのではないか？	結果何大切	scene_20
Am I just wishing against fate?	わしは運命を受け入れすぎるのではないか？	運命受入	scene_20
I am too old to do anything about it…	だが、何かをするにはわしは年をとりすぎた……	何年	scene_20
This year, I'll be 130. Ho Ho Hoooo.	ことしで１３０歳じゃよ。ホーホーホウ、じゃ	歳	scene_20
That is why, Nanaki, you must go with them! For my sake.	だからナナキよ、行けい！わしの代わりにすべてを見とどけるんじゃ	行代見	scene_20
Grandpa…	じっちゃん……		scene_20
I wanted to show you your real father before you left…	おまえがここを離れる前にどうしても父親の真実の姿を見せておきたかったんじゃ……	離前父親真実姿見	scene_20
I'm so glad that you came back while I was still alive to show you.	わしが生きてるうちにおまえが帰ってきてよかったわい	生帰	scene_20
Grandpa…don't talk like that. I don't want to think of life… without you…	じっちゃん……さみしいこと言うなよ。じっちゃんがいなくなるなんてオイラ……	言	scene_20
Ho Ho Hoooo. Well, I've had a long life.	ホーホーホウ。わしはもうじゅうぶん生きたよ	生	scene_20
Grandpa! You must live!	じっちゃん！生きててくれなくちゃダメだ！	生	scene_20
I'll see to it.	オイラは見とどける	見	scene_20
I'll see to what's happening to the Planet. And I'll come back to tell you.	星がどうなるのかを見とどけてそして帰ってくる。じっちゃんに報告するために	星見帰報告	scene_20
Nanaki…	ナナキ……		scene_20
I am Nanaki of Cosmo Canyon! The son of the warrior, Seto!	オイラはコスモキャニオンのナナキ。戦士セトの息子だ！	戦士息子	scene_20
I'll come back a warrior true to that noble name! So please, Grandpa…	その名にはじない戦士になって帰ってくる！だから、じっちゃん！	名戦士帰	scene_20
That's…Seto's… Seto…	あれは……セトの……おお……セト……		scene_20
Seto… Fa…Father…	セト……父……さん……	父	scene_20
Shall we get going?	そろそろ出発しようか	出発	scene_20
So this is it, RED XIII…	ここで、お別れね。RED XIII……	別	scene_20
That's just the way it goes. …You came in handy at times…	しかたねえさ。……けっこう頼りになるやつだったんだけど、な	頼	scene_20
The buggy's fixed, so we can go now.	バギーは何とか動けるようになったぜ	何動	scene_20
They said they finished fixin' the buggy.	バギーの修理、終わったらしいぜ	修理終	scene_20