What!?	え～っ！！		scene_21
This was all burnt down, wasn't it?	燃えちゃったはず、だよね？	燃	scene_21
…I thought so.	……そのはずだ		scene_21
Then why… My house is still here too…	それなのに、どうして？私の家もある……	私家	scene_21
The hell's goin' on!? This a dream or somethin'?	どうなってるんだよ！おまえ夢でも見てたのか？	夢見	scene_21
…Something's strange?	……なんだか、変？	変	scene_21
I wonder what's going on…	どういうことなんだろう……		scene_21
CLOUD, maybe you were just dreaming…?	CLOUDさん、夢でも見とったんとちゃいますか？	夢見	scene_21
Hey, it isn't like what you told me!	聞いてた話とちがうぜ！	聞話	scene_21
What the…?	なになに！？		scene_21
You said the whole town burnt down, right?	おまえ、この村は全部燃えちまったって言ってたよな	村全部燃言	scene_21
This is Nibelheim, right? But the town's all here.	ここ、ニブルヘイムだよね？村、ちゃんとしてるよ	村	scene_21
This is Nibelheim? I heard it burnt down.	ここがニブルヘイム？燃えて全滅って聞いてたけど	燃全滅聞	scene_21
The whole town was destroyed by Sephiroth. At least that's what I heard…	セフィロスのせいで村は全滅。そう聞いてましたけど……	村全滅聞	scene_21
Didn't you say that your hometown burned down?	おめえ、故郷は燃えてなくなったとか言ってなかったか？	故郷燃言	scene_21
I thought someone said this town burnt down!	村、なくなったって誰かから聞いたよ！	村誰聞	scene_21
You tryin' to fool us?	おまえ、オレたちをだましやがったのか！？		scene_21
Hey, what's going on?	ね、どうなってんのかな？		scene_21
CLOUD… Did you lie to us?	CLOUD……オイラたちにウソついた？		scene_21
CLOUD, did you make up that story just to get our support?	CLOUDさん同情でもひこ思て、つくり話ですか？	同情思話	scene_21
Yo, CLOUD. It's not good to lie.	CLOUDよう。ウソはいけねえぜ		scene_21
What happened?	どしたの？		scene_21
I'm not lying!	俺はウソなんか言ってない	俺言	scene_21
I remember…the intense heat of the flames…	俺はおぼえてる……あの炎の熱さを……	俺炎熱	scene_21
Wooow… He's…calling…Sephiroth… is…calling…	うぁぁぁあああ……呼んで……る……セフィロスが……呼んでる……	呼呼	scene_21
The…Great…Se…phi…roth… is…near..."	セフィ……ロス……さま……ちかくに……いる……		scene_21
In…side…inside…the Mansion… Urrrrrrrgh…the great…Sephi…roth	……屋敷……の……なか……おおぉぉぉ……セフィ……ロス……さま	屋敷	scene_21
Great…Sephi…roth… …left us…	セフィ……ロス……さま…………行って……しまった……	行	scene_21
Over…mountains… …gone…	山……こえて……行って……しまった……	山行	scene_21
What is it?	なんだい、あんた？		scene_21
Nothing	なんでもないんだ		scene_21
I lived in this house until I was 14…	俺はこの家に１４歳まで住んでいた……	俺家歳住	scene_21
No, but this town was burned down.	いや、それよりこの村は全部燃えたはずだ	村全部燃	scene_21
You're sick, saying such things…	なにをネボケたこと言ってるんだい！	言	scene_21
Get out of here!	顔あらってからおとといおいで！	顔	scene_21
Oh, really. Then, it'll help me too.	そうかいそうかい。そりゃぁ、私も助かるよ	私助	scene_21
What's going to happen to this Planet!? What the hell's Shinra doing!?	この星はどうなっちまうんだい！神羅カンパニーは何をしてるんだい！	星神羅何	scene_21
A man with a black cape!?	黒マントの男！？	黒男	scene_21
He has a tattoo of the number '11'…	『１１』のイレズミがある……		scene_21
…Must…go… …Reun…ion…	……行かな……くては…………リユニ……オン	行	scene_21
…Must…get…it… and bring…to…Se…phi…roth…	あれ……を……手にい……れセ……フィロスに……とどけるの……だ	手	scene_21
Then…become…one… with…Se…phi…roth…	そ……して……おぉ……セフィ……ロスと……ひとつ……に		scene_21
This guy's number '5'…	この男はナンバー『５』……	男	scene_21
CLOUD… CLOUD was playing.	CLOUD……CLOUDが弾いてた	弾	scene_21
I wonder what…this is?	なんだろう……これ		scene_21
Received "Elemental" Materia!	『ぞくせい』のマテリアを手にいれた	手	scene_21
It looks like Materia, but I can't hold any more.	マテリアみたいだけど、もうもてない		scene_21
TIFA's secret savings, 1 gil came out of the keyboard.	ピアノのけんばんの間からTIFAのへそくり１ギルがでてきた	間	scene_21
I've heard this melody somewhere before. I played it well.	どこかで聞いたメロディ。なんとなくうまく弾けた……	聞弾	scene_21
I have the sheet music for that song.	その曲なら、がくふがあるわ	曲	scene_21
Huh? Wait a minute! There's something inside the music sheet.	あれ？　ちょっと待って！がくふの間に何かはさまってる	待間何	scene_21
TIFA, what's happened to our town? Was it all an illusion, or just a dream? No, it was neither. I remember trying to get people out of the flames, but not having the strength… Burning with anger, I went to the reactor to kill Sephiroth.	TIFAよこの村はいったいどうなっているのだ？あれは幻、それとも夢だったのか？いや、そんなはずはない。私ははっきりと覚えている。炎の中から無事な者を救いだそうとしたが力およばず……怒りに燃えた私はセフィロスを倒すべく魔晄炉へ向かった。	村幻夢私覚炎中無事者救力怒燃私倒魔晄炉向	scene_21
But he was nowhere to be found.	セフィロスの姿は見えなかった。	姿見	scene_21
Instead, I found you, collapsed inside. 	そのかわり魔晄炉の中で倒れていた TIFA、おまえをみつけたのだ。	魔晄炉中倒	scene_21
I felt saving you was far more important than going after Sephiroth.	セフィロスを倒すよりも おまえの命を救う方が大切だと私は考えた。	倒命救方大切私考	scene_21
There were several others that were still alive inside, but I was only able to save you.	魔晄炉の中には他にも何人かまだ息のある者がいたのだが救うことができたのはおまえだけだった	魔晄炉中他何人息者救	scene_21
As I was coming out of the reactor, Shinra troops were just arriving.	魔晄炉から出ると、神羅の軍隊が 到着したところだった。	魔晄炉出神羅軍隊到着	scene_21
I recall a scientist named Hojo was in charge. He ordered the troops to gather up everyone still alive for the experiment. I didn't know what type of experiment he was talking about, but I wasn't about to let them have my dearest student.	指揮をとっていたのは、たしか宝条という科学者だったと記憶している。宝条は【少しでも息のある者は実験用に集めておけ】と兵士たちに命令していた。何の実験だか知らないが、かわいい弟子を渡すわけにはいかない。	指揮宝条科学者記憶宝条少息者実験用集兵士命令何実験知弟子渡	scene_21
Putting you on my back, I headed down the mountain to the village. I used the Cure spell on you many times.	私はおまえを背負って山をおりそして村を出た。私は道中何度もおまえにケアルをかけつつ	私背負山村出私道中何度	scene_21
And started to head for Midgar to look for a doctor for you. I didn't like that city, and my Cure spells weren't helping.	おまえの命を救ってくれる医者を求めてミッドガルを目指した。あの街は好きではないが、私のケアルだけではどうしようもなかった。	命救医者求目指街好私	scene_21
I decided to go to Midgar to find a doctor I could trust. I'm worried about you, but I can't settle down in one place for very long.	ミッドガルの信頼できる医者におまえをあずけて私は再び旅に出ることにした。おまえのことは心配だったがひとつ場所にとどまっていられないのが私の性分だ。	信頼医者私再旅出心配場所私性分	scene_21
Have you recovered fully? Are you well?	傷はすっかり良くなっただろうか？元気にしているだろうか？	傷良元気	scene_21
I wonder how many years have passed since then? I just got into town again, but I can't believe it… The whole town is back to normal, except for the strange people with black clothes all around.	あれから、何年がすぎたのだ？私はふらりとこの村に戻ってきたが正直なところ、おどろいている。村は元通りだが、黒い服の不気味な者たちがうろついている……。	何年私村戻正直村元通黒服不気味者	scene_21
The town reeks of Shinra, but I won't go after them. You may think I'm running from them, but it's just that I don't want anything to do with Shinra anymore. Feels like time is running out.	神羅のにおいがぷんぷんするが私は深追いするつもりはない。逃げていると言われればそれまでだが神羅にかかわるのは、もういやなのだ。さて、TIFA。この家の者が戻って来ないうちにここを立ち去らなくてはならない。時間はなさそうだ。	神羅私深追逃言神羅家者戻来立去時間	scene_21
I'm sure you'll find this letter. And this gift for you. It should come in handy.  	おまえは必ずこの手紙を見つけるにちがいない。それを信じてここに私からのおくりものを隠しておく。きっと役に立つだろう。	必手紙見信私隠役立	scene_21
I want to give it to you myself, but it's hard for my students to see me as an old man. I can't even jump anymore. But I hope you continue to sharpen your skills and remember what I taught you.	直接渡したいところだが弟子に老いた自分を見られるのはつらい。もう私はジャンプさえ出来なくなってしまった。私の技、おまえがみがきあげてくれることをねがっている。	直接渡弟子老自分見私出来私技	scene_21
To my most precious student,  From Zangan	最愛の弟子へ　ザンガン	最愛弟子	scene_21
Tifa's Final Mystery?	TIFAの最終奥義	最終奥義	scene_21
Received "Final Heaven"	『ファイナルヘブン』を手にいれた	手	scene_21
Did you play my piano?	私のピアノを弾いたの？	私弾	scene_21
No, I didn't	いや、弾かなかった	弾	scene_21
Yeah, I jammed on it	ギンギンに弾いた	弾	scene_21
Just a little…	ちょっとだけ		scene_21
I can read sheet music too, you know. Ummm, let's see…	俺だって、がくふくらい読め…… えっと……	俺読	scene_21
Do…\ Re…> Mi…> Ti…\ La…\ > Do…> Re…> Mi…> So…> Fa…> Do…> Re…> Do…\ Forget it…	ド…レ…ミ…シー…ラー…ド…レ…ミ…ソ…ファ…ド…レ…ド…いいや、もう		scene_21
Play the piano?	ピアノでも弾くか……	弾	scene_21
…Now, how did this go?	……どうやって弾くんだったかな？	弾	scene_21
I forgot	忘れた	忘	scene_21
I remember	おぼえてる		scene_21
Do [CANCEL]	×　ド		scene_21
Re [SWITCH]	□　レ		scene_21
Mi [MENU]	△　ミ		scene_21
Fa [OK]	○　ファ		scene_21
So [PAGEUP]/[PAGEDOWN] + [CANCEL]	Ｒ１かＬ１と×　ソ		scene_21
La [PAGEUP]/[PAGEDOWN] + [SWITCH]	Ｒ１かＬ１と□　ラ		scene_21
Ti [PAGEUP]/[PAGEDOWN] + [MENU]	Ｒ１かＬ１と△　シ		scene_21
Do [PAGEUP]/[PAGEDOWN] + [OK]	Ｒ１かＬ１と○　高いド	高	scene_21
But…I definitely remember playing the piano then. So why wasn't it burnt down?	あのとき……確かにこのピアノを弾いた。でも、なぜ焼けなかったんだ	確弾焼	scene_21
Tattoo number '4'	『４』のイレズミだ		scene_21
Received "Platinum Fist!"	『プラチナフィスト』を手にいれた！	手	scene_21
…Where…are…you? Great…Se…phi…roth…	……どこ……で……す……か？セフィ……ロス……さま		scene_21
Periodic Report to Professor Hojo	定期報告　宝条博士へ	定期報告宝条博士	scene_21
1  Clone Activity Report	１　コピー行動記録	行動記録	scene_21
Unfortunately, no 'CLONES' have left this town this quarter. As previously reported, the 'CLONES 'seem to be sensing something.	残念ながら今期も村を出て行った【コピー】はいません。すでに報告させていただいたとおり【コピー】たちは確かに何かを感じてはいるようです。	残念今期村出行報告確何感	scene_21
But all they say is, 'Reunion' or 'Sephiroth' and show no other signs of activity.	しかし、うわごとのように【リユニオン】【セフィロス】などと言うだけであり、どこかに旅立つという気配はまったくありません。	言旅立気配	scene_21
2  Confidentiality Report	２　機密保持関係報告	機密保持関係報告	scene_21
A total of eight people have visited this town this quarter.	今期に村をおとずれた人間は計８名。 	今期村人間計名	scene_21
Fortunately, none knew about the incident five years ago.	さいわい、今期も、５年前の事件を 知っている者はいませんでした。	今期年前事件知者	scene_21
Therefore, no one knows the town was restored exactly as it was five years ago. Our staff, disguised as townspeople, have improved their acting skills, and we do not report any problems at this time.	ですから、村が燃える前と同じように再建されたことに気づいた者はいません。村人のふりをしているスタッフの演技もなかなか上手くなりましたのでこちらの方は間題なしと思われます。	村燃前同再建気者村人演技上手方間題思	scene_21
That is all.	以上、報告いたします	以上報告	scene_21
Give me a room	とめてくれ		scene_21
It'll be 100 gil a night. Is that all right with you?	１泊１００ギルになります。よろしいですか？	泊	scene_21
Enjoy your stay.	では、ごゆっくりどうぞ		scene_21
You don't have enough money.	お金……足りないですね	金足	scene_21
Well, maybe next time…	では、またの機会に……	機会	scene_21
Oh, I'm so sorry. I've got lots to do…	あ、すいません。ちょっと仕事がたてこんでますので……	仕事	scene_21
This town was supposed to have burnt down five years ago.	この村は５年前に全部燃えてしまったはずだ	村年前全部燃	scene_21
What the hell is going on?	いったいどうなってるんだ？		scene_21
Sir, don't say such awful things.	お客さん、変なこと言わないで下さい！	客変言下	scene_21
I was born and raised in this town. What you say never happened.	私はこの村で生まれ育ちました。そんなことは全然なかったですよ	私村生育全然	scene_21
You're lying…	おじさん、ウソついてる……		scene_21
EXCUSE ME! That's so rude…	失礼だなぁ……	失礼	scene_21
If you're going to talk like that, I'm going to have to ask you to leave.	変なこと言うなら出ていってもらいますよ	変言出	scene_21
I'm checking the Mako boiler. Please don't bother me now.	魔晄ボイラーの調子が見てるんです。ジャマしないでくださいよ	魔晄調子見	scene_21
…Welcome. It's 100 gil a night…	……いらっしゃい。１泊１００ギルですが……	泊	scene_21
Spend the night.	とまる		scene_21
He has a tattoo number '6'. Hmm? He has something…	『６』のイレズミがあるな。ん？　何か持ってる……	何持	scene_21
Urrr…rrrrr…rrrgh… Must…go to…Re…union…	う……あ……ぁああ……リユ……ニオン……行きたい……	行	scene_21
Nibelheim House	小さな姉弟がいた家２階	小姉弟家階	scene_21
Re…union.	……リュ……ニヨン		scene_21
Re…union.	………………ヨン		scene_21
…The Black Cape…	黒マントの……	黒	scene_21
Nice town, huh?	ここはいい村でしょ？	村	scene_21
We've been in business here for a long time…	あたしらは昔っからここで商売してますけどね……	昔商売	scene_21
…You're lying.	……ウソだ		scene_21
Do you have anything to do with this town?	もしかして……あなた、この村の関係者？	村関係者	scene_21
How about bein' born and raised here?	そう、この村で生まれ育った	村生育	scene_21
Nope, guess not	いや、ちがう		scene_21
I was here until I was 14, and I don't remember you.	１４歳までここにいた。俺はあんたなんか知らない	歳俺知	scene_21
…Nothing.	……なんでもない		scene_21
It's not nice to lie!!	ウソはいけませんよ！！		scene_21
Oh yeah?	ホッ……		scene_21
How can you shop at a time like this?	あんたら、こんな時に買い物なんかして、どうするの？	時買物	scene_21
What? Me, in business?	えっ？　商売だろうって？	商売	scene_21
Don't worry, it's all right. I get paid by the company.	いいのいいの、ウチは会社から給料出てるから	会社給料出	scene_21
But my real job is protecting Nibelheim's secret.	ニブルヘイムの秘密を守るのがウチらの本当の仕事なんだよ	秘密守本当仕事	scene_21
What? Secret?	えっ？　秘密？	秘密	scene_21
We don't have a clue. But it's all right.	ウチらは知らないな。でも、いいのいいの	知	scene_21
It's all over anyway!	もう全部終わりなんだからさ！	全部終	scene_21
Finished, finito, over!! Even as we speak Meteor… This is the end!	終わり終わり終わり！！ああ、こうしてる間にもメテオが～！　終末が～！！	終終終間終末	scene_21
He has a tattoo of the number'12'. Mmm? He has something.	『１２』のイレズミがあるな。ん？　何か持ってるぞ	何持	scene_21
Can…you…hear? The…voice…of…Se…phi…roth?	聞こ……え……る？セフィ……ロスの……声……	聞声	scene_21
Something is written on the back of the lid.	ふたのウラに文字がきざまれている	文字	scene_21
(1)Right 36	【１】　…　右　３６	右	scene_21
Something is written on the floor.	ゆかに文字がきざまれている	文字	scene_21
(2)Left 10	【２】　…　左　１０	左	scene_21
(3)Right 59	【３】　…　右　５９	右	scene_21
(4)Right 97	【４】　…　右　９７	右	scene_21
I have a bad feeling about this…	いやな予感が……	予感	scene_21
Open the safe	それでも金庫をあける	金庫	scene_21
[Empty Entry]	メモリ		scene_21
Success	せいこう		scene_21
Fail	失敗	失敗	scene_21
Received Key Item "Key to the Basement"!	キーアイテム『地下室のカギ』を手にいれた！	地下室手	scene_21
C project	ＣーＰＲＯＪ		scene_21
specimen(B)  codeC	サンプル　ー　Ｂ（コードＣ）		scene_21
A scratch left by a fingernail inside the beaker… Let's get out of here…'.	ビーカーの内がわにツメでキズつけたあとが……『ここから逃げよう……』	内逃	scene_21
specimen(A)  codeZ	サンプル　ー　Ａ（コードＺ）		scene_21
A scratch left by a fingernail inside the beaker… Feeding Time'…that's our chance…!	ビーカーの内がわにツメでキズつけたあとが……『エサの時間が…チャンスだ……』	内時間	scene_21
Escapee Report no. 1 X Month X Day Two escapees were located near Midgar.	逃亡者に関する報告書　１ Ｘ月Ｘ日 当施設から逃亡した２名を ミッドガル近辺で発見しました]	逃亡者関報告書月日当施設逃亡名近辺発見	scene_21
Escapee Report no. 2 Description at the time of capture.	逃亡者に関する報告書　２ 発見時の状態	逃亡者関報告書発見時状態	scene_21
A  Former member of SOLDIER/Number(   ) No effect could be detected from either Mako Radiation Therapy or Jenova on him.	Ａ　元ソルジャー／ナンバー【無】 魔晄照射およびジェノバの影響は 見受けられませんでした。 	元無魔晄照射影響見受	scene_21
B  Regular/Number (   ) Reaction to Jenova detected.	Ｂ　一般／ナンバー【無】ジェノバへの反応過多が見受けられました	一般無反応過多見受	scene_21
Escapee Report no. 3 Status.	逃亡者に関する報告書　３：処分に関して	逃亡者関報告書処分関	scene_21
A  Shot for resisting.	Ａ　抵抗したため、射殺。	抵抗射殺	scene_21
B  Escaped during A's resistance.	Ｂ　Ａが抵抗する間に逃亡	抵抗間逃亡	scene_21
Escapee Report no. 4 Other	逃亡者に関する報告書　４ ：その他	逃亡者関報告書他	scene_21
B's whereabouts is currently unknown. But pursuit is unnecessary due to his diminishing consciousness. Awaiting further instructions.	現在、Ｂの行方は不明です。しかし、Ｂは意識の乱れがかなり進行している様子でしたのでこのまま放置しておいても間題は無いというのが我々の見解です。今後に関する指示をおねがいします	現在行方不明意識乱進行様子放置間題無我見解今後関指示	scene_21
Sephiroth!	セフィロス！		scene_21
Being here brings back memories.	なつかしいな、ここは		scene_21
Are you going to participate in the Reunion?	ところで、おまえはリユニオンに参加しないのか？	参加	scene_21
I don't even know what a Reunion is!	俺はリユニオンなんて知らない！	俺知	scene_21
Jenova will be at the Reunion. Jenova will join the Reunion, becoming a calamity from the skies.	ジェノバはリユニオンするものだ。ジェノバはリユニオンして空から来た厄災となる	空来厄災	scene_21
Jenova, a calamity from the skies? You mean she wasn't an Ancient!?	ジェノバが空から来た厄災？古代種じゃなかったのか！？	空来厄災古代種	scene_21
…I see. I don't think you have the right to participate.	……なるほど。おまえには参加資格はなさそうだ	参加資格	scene_21
I will go North past Mt. Nibel. If you wish to know…then follow…	わたしは【ニブル山をこえて北】へいく。もしお前が自覚するならば……わたしを追ってくるがよい	山北前自覚追	scene_21
…Reunion? Calamity from the skies?	……リユニオン？空から来た厄災？	空来厄災	scene_21
Hojo's Letter	宝条の手紙	宝条手紙	scene_21
I must get rid of all those that stand in the way of my research. Even that one from the Turks.	私の研究の邪魔をする者を全て取り除かなければならない。タークスのあの男も例外ではない	私研究邪魔者全取除男例外	scene_21
I scientifically altered him and put him to sleep in the basement. If you want to find him, search the area.	私はタークスの男に生体学的な改造をほどこし、地下に眠らせた。もし興味があるなら探してみるがよい	私男生体学的改造地下眠興味探	scene_21
But…this is merely a game I thought of. It is not necessary for you to participate if you don't want to.	ただし……これはあくまで私がきまぐれでおもいついたゲームにすぎない。むりにつきあってくれる必要はない	私必要	scene_21
There seems to be another letter.	手紙は２まいあるようだ	手紙	scene_21
Read it	もう１まいの用紙をみる	用紙	scene_21
Ignore it	無視して旅を急ごう	無視旅急	scene_21
Move the dial on the safe carefully but quickly. You have 20 seconds. You can not go past the numbers while turning. The 4 hints for the numbers are…	金庫のダイヤルはしんちょうにかつ、すばやくまわす。２０秒以内だ。少しでも行き過ぎてはいけない。４つのダイヤルのヒントは……	金庫秒以内少行過	scene_21
dial (1)	ダイヤル　【１】　のヒント		scene_21
dial (2)	ダイヤル　【２】　のヒント		scene_21
dial (3)	ダイヤル　【３】　のヒント		scene_21
The lid of the box with the most oxygen.	酸素が一番多いハコのふた	酸素一番多	scene_21
Behind the Ivory's short of tea and ray.	空のない黒と白のウラ	空黒白	scene_21
The creek in the floor near the chair on the second floor… then to the left five steps, up nine steps, left two steps, and up six steps.	２階のイスのそばのユカのきしみ……そこから左５歩、上９歩、左２歩、上６歩	階左歩上歩左歩上歩	scene_21
The fourth row has been written in invisible ink…	４行目があぶりだされた……	行目	scene_21
Dial (4) is  (Right 97)	ダイヤル　【４】　は　【右　９７】	右	scene_21
Look, something is written on the back…	よく見るとウラにも文字がかいてある……	見文字	scene_21
Look at the back	ウラを見てみよう	見	scene_21
Ignore	無視しよう	無視	scene_21
You still don't get it? Don't give up if you've only checked it once. You have to be persistent.	まだわからないのかね？一度調べたからって安心してはだめだよ。しつこく調べなくては	一度調安心調	scene_21
Look, this letter could be in invisible ink.	よく見るとこの手紙はあぶりだしのようだ	見手紙	scene_21
Read it	あぶりだしてみよう		scene_21
There are four things in this mansion… Check more closely.	この屋敷の中で４つあるもの……それをもっとよく調べてみてくれ	屋敷中調	scene_21