Better ask the Captain about this town. He's the one in charge of it.	この村のことなら艇長に聞いてくれ。ここを仕切ってるのはアイツだからな	scene_23
Captain?	艇長って？	scene_23
Did you see a man in a black cape?	黒マントの男を見たか？	scene_23
The Captain was a pilot when Shinra was still interested in their Space Program.	艇長は神羅カンパニーがまだ宇宙開発に手を出していたころのパイロットさ	scene_23
He was going to be the world's first astronaut, but there was an accident…	世界初の宇宙飛行士になる予定だったのだがま、ちょっとした事故があってな	scene_23
Ever since then, he's been wasting his life away here dreaming about going into outer space.	で、まあ、それ以来ここで宇宙に飛び立つ夢を見ながらくすぶってるってわけよ	scene_23
A man in a black cape? Nope…never seen him.	黒マントを着た男？さあ……知らないなあ	scene_23
This used to be a Shinra base where they used to launch rockets.	ここは元々神羅のロケット打ち上げ基地だったのじゃ	scene_23
You saw the leaning rocket, right? That's Shinra No. 26. It never got off the ground though.	かたむいたロケットを見たじゃろ？あれが神羅２６号じゃ。一度も飛んだことはないんじゃが	scene_23
Everyone in this town was a mechanic back when they were planning to launch the rocket.	ここの住人はみんなロケット打ち上げ計画のときのメカニック仲間なんだ	scene_23
Rocket launch plan? What do you mean?	ロケット打ち上げ計画？何のことだ？	scene_23
You don't know?	君たち、知らないのかい？	scene_23
There was a plan to send a man into outer space. It was headed up by the leader of the Shinra Space Program, Palmer.	神羅の宇宙開発部門の長であるパルマーの主導で、人間を宇宙におくろうとした計画があったのさ	scene_23
This town is the result of the plan, but the plan got cut…	でも、その計画も中断しちゃってね……この村は、その計画のなごりなのさ	scene_23
Who's the 'Captain'?	艇長とは、誰のことだ？	scene_23
Did you see a man in a black cape?	黒マントを着た男を見なかったか？	scene_23
Did you meet the Captain already? He's really the town's representative, so you should really talk with him.	艇長には、もう会ったかい？この村の顔とも言える男だから一度会っておくといいよ	scene_23
Welcome to the Shanghai Inn!	上海亭に、ようこそっす！	scene_23
It's 100 gil a night. Would you like to spend the night?	一泊１００ギルですけど、とまるっすか？	scene_23
Yes sir. Thank you!	へいっ、まいどっす！	scene_23
Well then, come by again sometime.	ん～、また来てくださいっす	scene_23
Excuse me. Please don't come in here. Our books and the room keys are in here, so I'll have to ask you to please stay out.	お客さん、困るっすよ。こっちには台帳や部屋の鍵とかが置いてあるんで、入ってこないでほしいんすけど	scene_23
The books… Maybe we could find out who's been here?	台帳……宿泊客の名前がわかるかもな	scene_23
Was there a man in a black cape?	黒マントの男はいないか？	scene_23
Look, we're all adults here, so I'd appreciate it if you used some discretion.	そうそう、お客さんもオトナなんすからフンベツってものをもってほしいっす	scene_23
A man with a black cape? No, no one like that has ever stayed here.	黒マントの男っすか？そんな人は泊まってないっす	scene_23
Would you like something to drink?	何か飲んでいかれますか？	scene_23
Let me hear your story	話を聞かせてくれ	scene_23
CID's had some bad breaks. It's really no one's fault he couldn't go into space.	CIDもかわいそうにな。あいつが宇宙に行けなかったのは誰が悪いのでもない	scene_23
Just bad luck, I guess…	ただ、ツキがなかっただけさ……	scene_23
If he keeps up like that, he's gonna collapse someday. Y'know what I mean? I'm talkin' heart attack.	そんなふうに心の余裕がないのではいつか倒れてしまいますよ。心の重圧にたえかねて、ね	scene_23
…That's too bad. Please come again.	…………残念です。また、おいで下さい	scene_23
A drink will ease your heart…	１杯の酒はこころの安らぎ……	scene_23
Welcome! This is the Item Shop.	ようこそ！ここはアイテム屋です。	scene_23
…Hey now! I would appreciate it if you wouldn't come in.	……困りますねぇ。こーゆーとこには入ってこないでいただきたいのですが	scene_23
What's that?	あれは……！？	scene_23
A rusty old rocket… Wonder why they made something so huge?	サビついたロケット……何のために、こんな巨大なものが……？	scene_23
That rusted out rocket is all that remains of the Shinra's Space Program.	あのサビついたロケットは神羅カンパニーが宇宙開発に力を入れていたころのなごりさ	scene_23
It just looms there. That's how the town got its name… Shinra No. 26'.	あすこにそびえるがこの村の名前の由来宇宙ロケット『神羅２６号』じゃ	scene_23
Want to look at the rocket with me?	どうじゃ？わしと一練に見上げてみるか？	scene_23
Yeah, let's take a look	見上げる	scene_23
No, not interested	見上げない	scene_23
I get so impressed every time I look at it.	何度見ても、感動するのぉ	scene_23
Oh, how boring…	なんじゃ、つまらん……	scene_23
All gramps does is gaze at that rocket all day long.	ウチのじいさんったら一日中ロケットばかりながめておるのぉ	scene_23
Well, he really loves machinery…	ありゃあ、機械が大好きな男じゃからのぉ	scene_23
Excuse me… You don't have enough money.	お客さん……お金、足んないっすよ	scene_23
Let me handle all your weapon and accessory needs!	武器やアクセサリーの事ならまかせてくんな！	scene_23
There's a bunch of Shinra people here messin' with the rocket…	なんか、神羅の人間がぎょ～さんやってきてロケットをいじりまわしちょるが……	scene_23
Is my rocket…all right?	わしのロケット……大丈夫かの？	scene_23
The Shinra serious 'bout launching that piece of crap rocket? But why now?	あのボロロケットを打ち上げるって神羅のやつら、本気なのかね？何をいまさら……	scene_23
…I'm in here.	……入ってるよ	scene_23
Urrrrgh, urrrgh	う～ん、う～ん	scene_23
P… Urrrrgh…aaaaaghh…	くーーーっつ、つらい……	scene_23
There's a lot happenin' in the world outside, but as long as I got this rocket I'm satisfied.	なんか、外の世界では色々起こっているようじゃがわしはこのロケットさえあればじゅ～ぶんマンゾクじゃ	scene_23
Anyways.	と・こ・ろ・で	scene_23
How 'bout it? Want to look at the rocket with me?	どうじゃ、あんた？わしと一練にロケット見上げんか？	scene_23
My, my precious rocket… It's gone.	わ、わしの愛しいロケットが……行ってしもうた	scene_23
Hmph, I know. No matter how much I look, the rocket's still gone.	ふっ、わかっておるさ。いくら見上げてももうあのロケットがないことはな	scene_23
But I just can't stop it. Just call it an old man's folly if you will.	しかし、あきらめきれんのじゃよ。老人のグチと思うて笑ろうてくれ	scene_23
What's young President Rufus doing by getting all those mechanics together?	ルーファウスの若社長メカニックたちを集めてどーするつもりなんだろ？	scene_23
Guard	警備兵	scene_23
Those terrorists are here!	テロリストどもが来たぞ！	scene_23
Guard Captain	警備隊長	scene_23
Don't let them get any further! Everyone, ATTACK---!	ここより一歩も進ませるな！総員、突撃ィ～～！	scene_23
Oh, I'm getting excited.	わくわくしちゃう	scene_23
Mmm, a SPECTACLE.	ん～、スペクタクル～	scene_23
Urrrgh, you're not going anywhere!" Uh un, nowhere!	ぬうう、行かせはせん！行かせはせんよ！	scene_23
Goddammit, what the hell do they think they're gonna do to my rocket!?	チクショウ、あいつら！オレ様のロケットに何しやがる気だ！	scene_23
I'm outta here, CLOUD! I'm gonna kick those $^%$# Shinra right out of my rocket!	行くぜ、CLOUD！神羅のクソッタレ野郎どもをオレ様のロケットから、たたきだしてやる！	scene_23
Wait, CLOUD!	待ってくれ、CLOUD！	scene_23
If you're gonna kick those *#$% Shinra out of my rocket, then take me with you!	オレ様のロケットから神羅のクソッタレ野郎どもをたたきだすんだろ？オレも連れてってくれ！	scene_23
ALL RIGHT! Let's show those &$!@& Shinra!	よっしゃ！神羅どもに目にもの見せてやろうぜ！	scene_23
CLOUD, what are you doin'!? They're gonna launch the rocket!!	CLOUD、何してる！ロケットが発射されちまうぞ！！	scene_23
You again?	……おまえたちか	scene_23
We will eliminate everyone who gets in Shinra's way.	……神羅の計画を邪魔するものは、排除する	scene_23
…They got us.	……やられた	scene_23
…Hmm.	……ふむな	scene_23
What? You guys are terrorists? Wow, that's kinda exciting!	なに、なに？あなたたち、テロリストなの？わくわくしちゃう	scene_23
Mmm, here comes some hard action!	ん～、ハードアクション～	scene_23
Hmm. Is it real or fake?	う～ん。本物なのかニセ物なのか？	scene_23
I'm so curious I can't sleep.	気になって、気になって夜もねむれないよ～	scene_23
Mmm… I'm starting to see it now… Sorry to get you into this. For me, it's a kinda hobby.	う～ん。そろそろ見あきてきたなぁわしの趣味につきあわせてしまってすまんのぉ	scene_23
But, out of appreciation, let me give you this.	お礼と言ってはなんじゃがこれをあんたにあげよう	scene_23
I wish you'd take care of it and use it…	だいじに使ってもらえるとわしもうれしいんじゃが……	scene_23
Maybe it's time for me to get a new hobby…	わしも、そろそろ新しい趣味を探してみようかのぉ……	scene_23
Oh, it's you? I heard you and the Captain really made a BANG!	ああ、あんたたちか。艇長と組んで、ハデにやったようだね	scene_23
I also heard that Rufus was so pissed off he went on a rampage and that no one's been able to get near him!	あの後、ルーファウスはカンカンで手がつけられなかったそうだよ。ふふふ、久々にスッとしたよ	scene_23
If things go on like this, then Meteor's just going to smash right into us and kill us all, right? …I guess that's life?	このままだと、メテオがふってきてみんな死んでしまうんだって？……まあ、人生そんなもんかもね	scene_23
I get so restless with the rocket gone. And now that we can see Meteor clearly, …I can't stand it.	ロケットがなくなってしまったからどうも落ち着かないんだよね。前よりもメテオがはっきりと見えるようになったし……たまんないね	scene_23
I heard Tiny Bronco broke…	タイニー・ブロンコを壊してしまったって話を聞いたけど……	scene_23
That sucks. I was secretly eyeing that thing. Broke, huh? What a drag.	困っちゃうなぁ。ひそかに僕が狙っていたのになぁ。壊れちゃったのかぁ。残念	scene_23
Look up at the sky. The bigger Meteor gets, the less time we have to live.	空を見てみるといいよ。メテオがあんなに大きく見えるようではもう、われわれの命も長くはないね	scene_23
I still can't believe that piece of crap rocket actually made it into space…	しかし、信じられないよ。あのボロっちいロケットが宇宙に行ったとはねぇ……	scene_23
I guess the mechanic was a genius.	やっぱり、メカニックが優秀だったってことだな、きっと	scene_23
Because those Shinra creeps locked us up in our houses, we couldn't even watch the rocket lift off.	この前、神羅のヤツらが来たときにわしらを家におしこめてくれたおかげであの日はロケットを見上げられなかったわい	scene_23
I never thought that my only hobby would be destroyed by that arrogant young Rufus!	ルーファウスごとき若造のせいでわしのコウショウなシュミが。邪魔されるとは……！	scene_23
Mmm. You know that Shinra sports car at CID's house? It might be fun to try and restore that thing…	う～む。CIDの家にある神羅のスポーツカー……あいつをレストアしてみるのもおもしろいかもしれんな……	scene_23
Welcome to the Shanghai Inn! Only 300 gil a night?	上海亭に、ようこそっす！一泊３００ギルですけど、とまるっすか？	scene_23
Y'know, I heard Rufus rushed back to headquarters in Midgar…	そういえば、ルーファウスさんはあわててミッドガルの本社ビルに帰ったようでしたが……	scene_23
Even though they failed to blow up Meteor with the rocket, the Shinra haven't given up yet…	ロケットによるメテオ爆破が失敗におわっても、神羅はまだあきらめてはいないようですね	scene_23
Looks like they're gathering all the weapons from all their bases and are preparing for a final showdown.	各地の施設からいろいろな兵器を集めて、最後の抵抗をしようとしているようです	scene_23
I heard a rumor that a Shinra airship carrying a secret weapon was attacked by a monster and sunk to the bottom of the sea…	そういえば、秘密兵器を運んでいた神羅の飛空艇が、モンスターにやられて海底に沈んだ、というウワサですが……	scene_23
You don't feel comfortable here? Then, everytime you look in the sky you see Meteor.	ここにいると、落ち着きませんか？空を見上げると、イヤでもメテオが目に入りますからね	scene_23
How long's that guy gonna be in the bathroom? I need to go, too…	向かいの席にすわっていたヤツいつまでトイレに入っているのかな？オレも使いたいのによぉ……	scene_23
Seems like Palmer of Shinra, Inc. ordered soldiers to restore the rocket…	神羅のパルマーさんが兵士を引き連れてロケットを整備しているようですが……	scene_23
Meteor's coming toward us!? And I can't even go to the bathroom…!?	メテオがふってくるんだって！？おまけに、いつまでたってもトイレは使えないしよ……	scene_23
OK, which is gonna happen first? Meteor hits us, or that guy comes out of the bathroom?	こうなりゃ意地だ。メテオがふってくるのが早いかあいつがトイレから出るのが早いか	scene_23
I'm not movin' from this spot till I see it with my own eyes.	オレは、この目で見とどけるまでここから離れないぞ	scene_23
Even with all this goin' on outside, that guy still won't come out of the bathroom? He must be a damn water tank!?	こんな騒ぎになってもトイレから出てこない……実はあいつ、すごい大物なのかも！？	scene_23
Is Gramps gonna stay like that even though rocket's gone?	ロケットもなくなったってのにウチのジイサンはいつまであーしとるつもりなんじゃろ？	scene_23
Geeeeez, it's boring! Isn't anything exciting going to happen here?	ああ、つまらないわ……何かおもしろいことはないかしら？	scene_23
Now that one of Shinra's greatest events is over, I guess it's back to the same old boring life again…	神羅の一大イベントも終わってしまったしまた、つまらない毎日が始まるのね……	scene_23
Mmm, I'm so bored. Isn't there anything that can excite me?	うーん、ヒマだなぁ。何かワクワクすることはないかな？	scene_23
Even the rocket launch wasn't all THAT great.	ロケット打ち上げも、終わってしまえばたいしたことでもなかったなぁ	scene_23
Shera	シエラ	scene_23
I'll take care of everything at home. But please take care of the Captain.	この家のことはわたしにまかせておいてください。……艇長をよろしくおねがいします	scene_23
What's going to happen?	……この世界はどうなってしまうのでしょう？	scene_23
Now all we have to take care of is Meteor, right? You should be able…	あとは、あのメテオをなんとかすればいいのですね。あなたたちなら、きっと……	scene_23
Excuse me… …Please take care of the Captain.	あの…………艇長をよろしくおねがいします	scene_23
There're tons of what look	こっとう品と言ってもいいような	scene_23
like antique guns.	銃が、山のようにかざってある。	scene_23
…I bet the owner of this store	……きっと、この店のオーナーは	scene_23
was a real gun fanatic.	かなりのガンマニアなのだろう。	scene_23
A gun is a MAN'S weapon! Nuthin' else'll do!	男の武器は、銃だ！それ以外は認めん！	scene_23
Hmm, let's see… do I know any good jokes?	ん～、何かおもしろいシャレはないかな？	scene_23
It's my job to make people laugh all over the world…	世界の人々を笑わせること。それがわたしの使命……	scene_23
Hey CID! I just thought of the best joke! Listen to this one.	おっ、CID！ついに究極のシャレを考えついたんだ！ぜひ聞いてくれよ	scene_23
I'm so sick of hearing these dumb puns, but okay…let's get it over with. Go on…let me hear it.	おまえのダジャレは聞きあきたがしかたないから聞いてやる。ホレ、言ってみろ	scene_23
Uh, now, let's see, how did it go?	ええと、なんだったっけな……	scene_23
…'He's crude an' a jerk'… I mean, He's 'Rude of the Turks'!	『みんな、のたうち回ってるど』じゃなくて『神羅のタークスのルード』って奴がきてるぜ	scene_23
'President Rufus, lathers Tantrics'… Uh, I mean… President Rufus, gathers mechanics'…	『ルーファウスの若社長は目がみっつ』じゃなくてルーファウスの若社長はメカニックを集めて	scene_23
'Raunchy meat, a pocket full, at the cafeteria'. Uh, I mean… Launch a beat up rocket full of Materia'.	『あんたのブランケットにまったりとしたハム』じゃなくてあんたのボロロケットにマテリアボムを積んで打ち上げるつもりらしいぜ	scene_23
And I thought it might be fun to hear some of your stupid puns again for old times sake… my mistake.	……久しぶりに会っておめえのくだらねぇダジャレもなつかしいと思ったが……	scene_23
Oh, 'crap-again'(oh, captain).	いやいやそんなていちょう（艇長）にほめるなよ～	scene_23
Dammit! That does it!	やっぱムカつくぜ！	scene_23
How rude…	ひ、ひどい……	scene_23
Rude, hell! You're the one who always cracks those #$##@& jokes!	けっ！おめえがつまらねぇこと言うからだ	scene_23
Sorry, 'bout that, now lesse…	いらん邪魔が入ったが……	scene_23
Looks like that *&%$#^$ Rufus wants to use my rocket for somethin'.	ルーファウスのボンボン野郎がオレさまのロケットを使って何かやらかすつもりらしいな	scene_23
Let's go to the launching pad!	ロケットの発射台の方に行ってみるとすっか！	scene_23
(A fearful sense of humor…)	（お、恐るべしギャグセンス……）	scene_23
…??	……？？	scene_23
Ugh… Nice kick.	ぐぅ……ナイスキック	scene_23
I got to learn more… Devotion, devotion.	もっと、修行せねば……精進、精進	scene_23
DAMMIT! No more of them ^$#%$@# puns!	けっ！おめぇのダジャレなんぞ、聞きたくもねぇ	scene_23
And?	で？	scene_23
(The problem starts way before his sense of humor.)	（センス以前の間題さ……）	scene_23
Shinra's trying to gather the Huge Materia from Corel and Fort Condor. There are four left, and they're transporting them here.	神羅は【コレル】、【コンドルフォート】のヒュージマテリアを回収しようとしちょる。最終的には４つ集めてこの村に運んでくるらしいわい	scene_23
I can't stand the thought of them using my rocket for something like this.	わしの大事なロケットをこんな事に使おうとするとは……たまらんのぉ	scene_23
Shinra's trying to gather the Huge Materia from the Junon Underwater Reactor. There are four left, and they're transporting them here.	神羅は【ジュノンの海底魔晄炉】のヒュージマテリアを回収しようとしちょる。最終的には４つ集めてこの村に運んでくるらしいわい	scene_23
I can't stand them using my precious rocket for a thing like this.	わしの大事なロケットをこんな事に使おうとするとは……つらいのぉ	scene_23
Authorized personnel only.	えっと、ここは関係者以外立入禁止っす	scene_23
Excuse me…CLOUD?	あ……CLOUDさん	scene_23
Did the Captain say anything?	艇長、何か言ってました？	scene_23
Welcome home.	おかえりなさい	scene_23
^%$#! Shera. What are you, blind!?	ケッ！　シエラよう。どうしてテメエはそんなにどんくせえんだよ！	scene_23
We got guests!! GET SOME TEA! ^%$#!	客が来たら茶くらい出せよな、このウスノロ！	scene_23
I…I'm sorry.	ご、ごめんなさい	scene_23
Really, don't mind us.	俺たちのことは気にしないでくれ	scene_23
Shut up! Sit your butts down in those chairs and drink your goddamn TEA!	うるせぇ！　ウダウダ言うな！客は、イスにすわっておとなしくしてろ！	scene_23
Arggggggh! DAMN, I'm pissed!	あ～～っ！ハラが立ってきた！	scene_23
…Damn, man. Wassup with that guy's attitude?	けっ、いけ好かねぇ野郎だ	scene_23
Sheesh!! What bad manners!	むっか～～！！たいど、悪いわよ	scene_23
Poor Shera.	シエラさん、かわいそう	scene_23
Who does he think he is?	なんてヤツだよ……！	scene_23
Man, this sucks!	なんか、ヤなかんじ～！	scene_23
Man, he sure seems wound up tight.	なんや、ごっつうキツい人やなぁ～	scene_23
Sorry. It's our fault.	悪かったな。俺たちのせいで	scene_23
No, no. He's always like this.	とんでもない。いつものことです	scene_23
Oh?	そうですか……	scene_23
Shera! I'll be in the backyard tunin' up Tiny Bronco!	おい、シエラ！オレ様はタイニー・ブロンコを整備しに裏庭に行ってるからな！	scene_23
An' make sure to serve them some tea! All right!?	客に茶ぁ、出しとけよ！！わかったな！	scene_23
He always like this? That's pretty bad!	いつもだって？そりゃ、ひでえな！	scene_23
Is it like this all the time? You keep quiet even when he's like that to you?	いつも？いつもあんなこと言われてだまってんの？	scene_23
Is it always like this?	いつものこと……	scene_23
Why is CID so hard on you?	どうしてCIDはあなたにあんなにつらく当たるの？	scene_23
I think it's a bit too harsh.	それはひどすぎると思う	scene_23
Is he like this all the time? Bitin' your head off like that? I could never stand it…	いっつも～？いっつもあんなにガーガー言われてますんか？たまらんなぁ……	scene_23
What's his prob!? I'm gonna go clean that guy's clock!!	なんだよ、それ！？アタシならぶんなぐってやるよ！	scene_23
…It's amazing that you can live with it.	……よくたえてるな	scene_23
No… It's because of my stupid mistake.	いいえ……私がドジだからしょうがないんです	scene_23
I was the one who destroyed his dream…	私があの人の夢をつぶしてしまったから……	scene_23
What happened?	なにがあったんだ？	scene_23
He pushed the Emergency Engine Shut Down switch, aborting the mission, to save my life.	あの人は、私を助けるためにエンジンの緊急停止スイッチを押したのです	scene_23
After that, the Space Program was cut back and the launch was canceled.	それ以後、宇宙計画縮小が決まってロケット発射は中止になりました	scene_23
It's my fault his dream was destroyed…	私のせいで、あの人の夢が逃げていったんです……	scene_23
That's why…it's all right. I don't care what the Captain says, I'll live my life for him.	だから……いいんです。艇長がどう思おうと、私はあの人につぐなわなくてはなりません	scene_23
Shera! You still haven't served 'em tea!	シーエラッ！ま～だ茶をだしてねえな！	scene_23
Hurry up and sit down! Or ain't my hospitality good enough for you!?	ほれ、とっととすわれ！オレ様のもてなしが受けられねえってのか！	scene_23
They're late… Where is Rufus?	おそいな……ルーファウスはよ	scene_23
Hey-HEY! Long time no see! So CID, how ya been?	うひょ！　ひさしぶり！CIDちゃん、元気してた？	scene_23
Well, if it ain't fat man, Palmer. How long were you figurin' on keepin' me waitin'!?	よう、ふとっちょパルマー。待ってたぜ！	scene_23
Hey-hey!  I don't know. The President's outside, so why don't you ask him?	うひょひょ！　わし、知らないな～。外に社長がいるから聞いてみれば？	scene_23
^$#&! Good for nothing, fat &$#$^@!	ケッ！あいかわらずの役立たずふとっちょめ	scene_23
Don't say 'fat'!	ふとっちょって言うな～！	scene_23
Hey-hey! Tea!	うひょ！　お茶だ！	scene_23
Can I have some too? With lotsa sugar and honey and… oh yeah, don't forget the lard!	わしにもちょうだい。サトウとハチミツたっぷりでラードも入れてね	scene_23
Hey-hey? Have we met before?	うひょひょ？どこかで会ったかな？	scene_23
So? When's the Space Program gonna start up again?	で、いつなんだ？宇宙開発計画の再開はよぉ？	scene_23
Is President Rufus here to announce that he's going to restart the Space Program?	ルーファウス社長が来たのは宇宙開発を再開するためなのでしょうか？	scene_23
Hey-hey! Is the tea ready yet?	うひょ！お茶はまだかな～？	scene_23
With plenty of sugar and honey. Oh yeah, and don't forget the lard, too.	サトウとハチミツたっぷりでラードもどっさり入れてね。うひょひょ！	scene_23
What the!? You got me all excited for nothing!?	な、な、な、なんでい！期待させやがって！	scene_23
Then, what'd you come here for?	そんなら今日は何の用で来た？	scene_23
I want to borrow the Tiny Bronco.	タイニー・ブロンコを返してもらおうと思ってな	scene_23
&^#^%! First the Airship, then the Rocket, and now, the Tiny Bronco.	ケッ！最初は飛空艇、次はロケットこんどはタイニー・ブロンコか	scene_23
Shinra took outer space away from me and now you want to take the sky away from me too!?	神羅カンパニーはオレ様から宇宙を奪っただけでは足りずに今度は空まで奪う気だな！	scene_23
Oh my…	おやおや……	scene_23
You seem to forget it was because of Shinra, Inc. that you were able to fly in the first place.	いままで、君が空を飛べたのは神羅カンパニーのおかげだ。それを忘れないでくれたまえ	scene_23
Uh, excuse me…	あ、あの、あなたたち……	scene_23
This way…	こちらへ……	scene_23
You wanted to use the Tiny Bronco, right?	あなたたちタイニー・ブロンコを使いたがっていましたよね	scene_23
I believe Palmer's going to take it. Why don't you talk to him?	パルマーが持っていくそうです。お話ししてみたら？	scene_23
We're going after Sephiroth. But seems like we've been going in the wrong direction.	我々はセフィロスを追っている。ただ、どうやら今まで見当違いの方向を探していたようだ	scene_23
But now, we think we know where he's headed. But, we have to cross the ocean. That's why we want your plane…	だが今はだいたい行く先がつかめてきたのでな。我々は海を越えなくてはならないんだ。それでお前の飛行機を……	scene_23
What're you guys doin' here?	おまえたち、なんだ？	scene_23
We heard the Captain was here.	艇長がここにいるって聞いてきたんだ	scene_23
Captain? I'm the Captain!	艇長だと？艇長とはオレ様のことだ！	scene_23
The name's CID. Everyone calls me 'Captain', though.	親からもらった名前はCID。みんなは艇長って呼ぶけどな	scene_23
What d'ya want?	で、なんの用でい？	scene_23
Tell me about this rocket	このロケットのこと、教えて	scene_23
Is Rufus coming?	ルーファウス、来るって？	scene_23
Can we borrow the "Tiny Bronco"?	タイニー・ブロンコ、貸して	scene_23
Wow! Not bad for a kid.	おっ！　若いモンにしちゃなかなか感心じゃねえか	scene_23
Alright then, I'll explain it to you.	よし、ここはオレ様自ら説明してやることにしよう	scene_23
You know Shinra developed a lot of technological gadgets during the meaningless war, right?	長くてくだらない戦争中に神羅カンパニーがいろんな技術を開発したのは知ってんだろ？	scene_23
Now it's a Mako company, but in the old days it was a weapons manufacturer.	今は魔晄屋だが、むかしは兵器開発会社だったからな	scene_23
Well, they came up with a Rocket Engine.	そんなかでよ、ロケットエンジンができちまったんだ	scene_23
There was so much excitement about the thought of going into outer space. Our dreams got bigger and bigger.	こりゃ宇宙へ行けるってんで大騒ぎよ。夢はどんどん広がった	scene_23
They put a major budget into it and made prototype after prototype! Finally, they completed Shinra No. 26.	予算もバカスカつぎこんで試作、試作、また試作！で、完成したのが、この神羅２６号	scene_23
They chose the best pilot in Shinra… no, in the world--me. I mean, come on.	パイロットには神羅一、いや世界一のウデを持つオレ様が選ばれた。ま、当然と言えば当然だわな	scene_23
And finally we get to the day of the launch. Everything was goin' well…	いよいよ迎えた打ち上げの日。何もかも上手くいってた	scene_23
But, because of that dumb-ass Shera, the launch got messed up. That's why they became so anal!	ところがあのノロマのシエラのせいで打ち上げはおじゃん。それがケチのつきはじめよ	scene_23
And so, Shinra nixed their outer space exploration plans.	神羅は宇宙開発計画をすてやがった	scene_23
After they told me how the future was Space Exploration and got my damn hopes up…DAMN THEM!	あれだけ、これからは宇宙だ！な～んて言って希望持たせてやがったクセによっ！	scene_23
Then, it was all over once they found out Mako energy was profitable. They didn't even so much as look at space exploration.	魔晄エネルギーが金になるとわかったらもう終わりだ。宇宙計画なんて誰も見向きもしねえ	scene_23
Money, moola, dinero! My dream was just a financial number for them!	かね、金、カネだぁ？オレ様の夢をソロバンかんじょうだけでぼうにふるない！	scene_23
Look at this rusted Rocket. I was supposed to be the first man in space with this.	見ろい……このサビだらけのロケットを。こいつで、オレ様は宇宙へ飛び出す最初の男になるはずだった	scene_23
Everyday, it tilts a little bit more.	いまじゃ、毎日にちょこっとずつかたむいてらあ	scene_23
At this rate, I don't know which'll be first, this thing falling over or me gettin' outta here.	このぶんだとコイツが倒れるのが先かオレ様がおっちぬのが先かってくらいだ……	scene_23
Yeah! It must be news about restarting the Space Program.	おう！　きっとよ、宇宙計画が再開されるって話にちげえねえ	scene_23
A young President, that's what we needed! He still has dreams, too!	やっぱり若い社長にかぎるぜ！夢があっていいやね	scene_23
You out of your *&$^$# mind!? That's my most cherished possession. I can't let you take it.	な～にバカなこと言ってやがるんだ！あれは大切なもんなんだ。貸せねぇよ	scene_23
Ummm… Just look around.	ん～、そのへん適当に見て回ってな	scene_23
My last hope is to talk to the President.	今回の、若社長が来るって話だけがオレ様に残された最後の望みさ……	scene_23
Hey! Get your ass in gear! You work like a snail!	おら、そんなカメみたいにちんたら仕事してるんじゃねえよ	scene_23
Even the moon'd get tired waitin' around for your ass!	お月さんがまちくたびれてそっぽ向いちまうぜ！	scene_23
I'm…I'm sorry.	す、すみません	scene_23
Don't take so much time checkin' that *%$^# oxygen tank!	そんな酸素ボンベなんかをいつまでもガチャガチャチェックしてんじゃねえよ！	scene_23
Shera, bein' careful's good, but no matter how many times you check that oxygen tank, it won't matter.	おいシエラよう、お前がマジメなのはいいんだけどよ、そんな酸素ボンベいくらチェックしてもムダだぜ	scene_23
That thing wouldn't break even if hell froze over.	そんなもん、天地がひっくり返ったって壊れやしねえんだから	scene_23
But…	え……でも	scene_23
No buts!!	でももヘチマもねえ！！	scene_23
You're not stupid, so be more efficient!	おめぇはバカじゃねぇんだからもちっと、手ぎわよくやれよ	scene_23
I'm sorry…	ごめんなさい……	scene_23
Instrument panel…all clear. Shinra No. 26, ready for launch.	計器オールクリア。神羅２６号、発射準備よし	scene_23
Control	管制官	scene_23
Engine pressure rising. Shinra No. 26, 3 minutes to launch. Beginning countdown.	エンジン圧力上昇中。神羅２６号、発射３分前。カウントダウン開始	scene_23
…Finally.	……いよいよだな	scene_23
What the? What happened!?	な、なんだ？　何が起った！？	scene_23
CID! We have an emergency situation!	パイロット・CID緊急事態です！	scene_23
A mechanic is still in the engine section of the rocket!	まだ船内のエンジン部にメカニックが残っています！	scene_23
What!? Who is the little ^%$@!?	何だって！？どこのバカやろうだ？	scene_23
I don't know. Activating the intercom in the engine section.	わかりません。エンジン部と音声つなぎます！	scene_23
Hey goddammit!! Who the &%$#'s still in there?	おい、コラ！！そんなところにいるのはどこのバカやろうだ！？	scene_23
It's Shera, Captain. Don't mind me, go ahead with the launch.	艇長、私です、シエラです。私にかまわず、打ち上げを行なって下さい	scene_23
Shera!? What are you still doin' in there!?	シエラぁ！？いまごろ、なにしてやがんだ！	scene_23
I was still concerned. The results of the oxygen tank test weren't satisfactory.	どうしても心配だったんです。酸素ボンベのテストで満足いく結果がえられなくて	scene_23
You stupid little $#^%!	バカやろう！	scene_23
It's gonna get so hot in there that there ain't gonna be #$!% left when we blast off!	そこはなあ、打ち上げのときうんこッカスも残んねぇほどバカ熱くなるんだ！	scene_23
You're gonna be burnt to a crisp! You're gonna die! You know that, doncha!?	そんなとこにいたら一瞬で黒コゲだぞ！おまえ、死んじまうんだぞ。わかってんのか！	scene_23
I don't mind.	いいんです	scene_23
If I can just fix this, the launch will be a success. I'm almost done.	これさえ直ればロケットは打ち上げできるんです。もう少しで終わりますから	scene_23
Almost done!? You're gonna die!	何がもう少しだ！おまえ、死んじまうんだぞ！	scene_23
CID, We must start the countdown. We won't make it if we don't!	CID、カウントダウン開始だ。もう、間に合わない！	scene_23
What are you going to do, CID? If we cancel now, it'll be another six months until the next launch!	どうするCID？ここで中止すれば、次の打ち上げまで６ケ月もかかっちまうぞ！	scene_23
Starting engine!	エンジン始動する！	scene_23
GODDAMMIT, Shera… you wanna make me a murderer?	くっ……シエラのヤロウめ……オレ様を人殺しにする気か？	scene_23
Tank Number 7 check is complete. Once I complete Tank Number 8, it's all clear.	７番ボンベまでチェック終わりました。８番ボンベが終わればオールクリアです	scene_23
Oh man, the moon…outer space… my dreams…	ああ、月が……宇宙が……オレ様の夢が……	scene_23
Ignite Engine!	エンジン点火！	scene_23
15 seconds until ignition. Internal temperature rising.	エンジン点火まで１５秒。船内温度上昇中	scene_23
SH-------#%!!	ンガーーーーーーッ！！	scene_23
Captain! Our dreams are finally coming true!	艇長！いよいよ私たちの夢がかないますね！	scene_23
We are so proud to be a part of the launch of Shinra No. 26.	ボクたちもハナが高いですよ。この神羅２６号の打ち上げに関われたなんて	scene_23
All right, Captain! Fly our dreams into outer space!	さあ、艇長！私たちの夢を乗せて、宇宙へ！	scene_23
Yeah! Leave it all to me! I'll be back in a few!	おう！　まかせとけ！ちょっくら、いってくるぜ！	scene_23
We're praying for your safety!	ご無事をおいのりしています！	scene_23
Captain, preparations are complete! All that's left is lift off!	艇長、整備はカンペキです！あとは、ゆくだけです！	scene_23
Thanks, guys!	ありがとうよ、おめぇら！	scene_23
Hey, wait a minute! Shera's still in here!	お、おい、ちょっと待て！まだシエラが残ってるんだぞ！	scene_23
Captain!	艇長！	scene_23
Shera!?	シエラか！？	scene_23
30 seconds until ignition. Beginning countdown.	エンジン点火３０秒前。カウントダウンを開始する	scene_23
CID! Forget about her. We won't make it in time!	CID！シエラの事はあきらめろ。もう、まにあわない！	scene_23
Come on, Shera…hurry up… You're gonna die…	シエラ……はやくしろ……このままじゃ死んじまうんだぞ……	scene_23
What…what am I… What am I supposed to do?	オレは……オレ様は……オレはどうしたらいい……？	scene_23
There's a Shinra logo on it. Tiny Bronco… This is cool.	神羅のマークがついている。タイニー・ブロンコか……いいな、これ	scene_23
Shinra always keeps the best things for themselves. Let's take it!	神羅はよ、こういう便利な物は絶対に独り占めしちまうんだよな。いただいちまおうぜ！	scene_23
I wonder if we can borrow it…	貸してもらえないかしら……	scene_23
Let's take it, OK CLOUD?	もらっちゃお？　ね、CLOUD！	scene_23
Will it fly? Is it all right to just take it?	空を飛べるのかな？勝手に乗っちゃマズイかな？	scene_23
CLOUD! If we steal it, we'll get in deep trouble!	CLOUDさん！こんなもんとったらえらいことになるで！	scene_23
…Want me to keep watch?	……見張っていようか？	scene_23
CLOUD, let's steal it! I love stealing from the Shinra!	CLOUD、盗もうよ！神羅の物盗むのは大好きなんだ！	scene_23
Um…may I help you?	あの……何か？	scene_23
No… We're just looking at it.	いや、なんでもないんだ。見せてもらっていただけだ	scene_23
…If you would like to use it, please ask the Captain. The Captain should be in the rocket.	……もしそれが使いたいなら艇長に聞いて下さい。艇長はきっとロケットのところにいると思います	scene_23
I'm Shera. And what are your names?	私、シエラといいます。あなたたちは？	scene_23
I'm BARRET, of AVALANCHE.	アバランチのBARRETだ	scene_23
TIFA. Nice to meet you.	TIFA。　よろしくね	scene_23
I'm AERIS.	わたし、AERIS	scene_23
Nanaki, otherwise known as RED XIII.	ナナキ、またの名をRED XIII	scene_23
Fortune telling machine CAIT SITH, here.	占い屋、CAIT SITHいいます	scene_23
VINCENT. I am…nevermind.	VINCENT。仕事は……まあ、いいだろう	scene_23
I'm YUFFIE!	アタシ、YUFFIE！	scene_23
Hmm… So you're not with the Shinra?	はぁ……神羅の人たちじゃないんですね	scene_23
I thought you were bringing approval for the Space Program.	私、宇宙開発再開の知らせがきたのかと思って	scene_23
…!?	……！？	scene_23
President Rufus is scheduled to come here. The Captain's been so restless all morning.	新社長のルーファウスさんがここへいらっしゃるそうなんです。艇長は朝からそわそわしてますわ	scene_23
Rufus!!?	ルーファウスが！！	scene_23
Hmm… Why do I have to do this…? I'm the head of the Space Program…	うひょ……なんでわしがこんなこと……わし、宇宙開発部門統括……	scene_23
I've seen you somewhere before…	お前らどこかで見たな……	scene_23
I know! The Shinra building! When the President was killed! Ulp!	そうだ！　神羅ビル！プレジデントが殺されたときだ！うひょ！	scene_23
We'll be taking the Tiny Bronco.	そのタイニー・ブロンコは俺たちがもらう	scene_23
Se…se…security!!	け、け、け、警備兵！！	scene_23
I can't stop it!	とまらねえぜ！	scene_23
I can't stop it!	とまらないの！	scene_23
I can't stop it!	とまんないっ！	scene_23
It's taking off.	とびあがっちゃうよ	scene_23
No! It's taking off!	あかん！とんでまう！	scene_23
No!! It's gonna take off!	ダメ！！とんじゃう！	scene_23
I can't stop…	とまらないな……	scene_23
Forget it! Get in!!	かまうな！　のりこめ！！	scene_23
All right, here we go!	よし、出発だ！	scene_23
Gimme that!	オレにやらせろ！	scene_23
I want to try it!	わたし、やってみたい！	scene_23
I wanna try!	私にやらせて！	scene_23
Leave it to me.	オイラにまかせて	scene_23
Let me handle it.	ボクにまかせて～な	scene_23
Let me be the pilot!	アタシにパイロットやらせて！	scene_23
I'll do it.	私の出番だな	scene_23
CID! Get on!	CID！　乗ってくれ！	scene_23
Godammit! What are you amateurs doing!	バカやろう！シロウトが何やってんだよ！	scene_23
CLOUD!? Don't let 'em get away! Shoot 'em down!	CLOUD！？逃がすな！　撃ちおとせ！	scene_23
%#^@!! The tail's been hit!	シィィーット！！尾翼がやられてるじゃねえか！	scene_23
Emergency landing…	不時着か……	scene_23
This's gonna be a big splash. Hold on to your drawers and don't piss in 'em!	さあ、でっけぇ衝撃がくるぜ。チビらねえようにパンツをしっかりおさえてな！	scene_23
She won't fly anymore.	こいつはもう飛べねえな	scene_23
Can't we use it as a boat?	ボートのかわりに使えるんじゃないか？	scene_23
$#&%! Do whatever you want!	ケッ！　好きにしろい！	scene_23
CID, what will you do now?	CID、あんたはこれからどうするんだ？	scene_23
I dunno. I'm history with the Shinra and I've given up on that town.	さあな。神羅とはきれちまったし村はあきちまった	scene_23
How about your wife? Shera?	奥さんは？　シエラはいいのか？	scene_23
Wife? Don't make me laugh! Just thinkin' 'bout marryin' her gives me the chills.	奥さん？　笑わせるない！シエラが女房だなんてトリハダがたつぜ	scene_23
What're you guys gonna do?	おまえらはどうすんだ？	scene_23
We're going after a man named Sephiroth. We'll have to get Rufus of the Shinra someday too.	セフィロスという男を追っている。神羅のルーファウスもいつか倒さなくちゃならない	scene_23
I don't know about any of that, but…	なんだかわからねえが……	scene_23
What the hell!? Sign me up!	おもしろそうじゃねえか！オレ様も仲間に入れろ！	scene_23
How 'bout it, everyone?	みんな、どうだ？	scene_23
I don't care.	かまわないぜ	scene_23
Of course, no problem!	もちろん、いいわよ	scene_23
I'm all for it.	さんせい、よ	scene_23
I don't really care.	オイラはかまわないよ	scene_23
I don't mind.	かまへんのと、ちゃいますか	scene_23
Whatever!	いいんじゃないの～	scene_23
…Do whatever you like.	……好きにしろ	scene_23
Glad to be aboard, numbskulls!	よろしくな、クソッタレさんたちよ	scene_23
Numbskulls…?	クソッタレ……	scene_23
Yeah. Anyone stupid enough to go up against Shinra nowadays, has GOTTA be a numbskull! I like it!	この時代、神羅にさからおうなんてバカヤロウのクソッタレだ！気に入ったぜ！	scene_23
So, where we headed?	で、どこへ行くんだ？	scene_23
Rufus was goin' after Sephiroth to the Temple of the Ancients.	ルーファウスのヤツはセフィロスを追って【古代種の神殿】に行くってほざいていたが	scene_23
Really!?…Where is it? That Temple of the Ancients?	本当か？！……どこだ？その【古代種の神殿】っていうのは？	scene_23
Dunno. That numbskull kid was tellin' me he was headin 'The wrong direction'… so maybe it's off this way?	さあな。あのクソむすこは『見当違いの方向』って言ってたからここからかなり離れた所じゃないのか？	scene_23
Let's just head for land and get some information. Temple of the Ancients… that name bothers me.	情報をとるためにとにかく陸地をさがそう。【古代種の神殿】……気になる名前だな……	scene_23
…Hm. How 'bout goin' west?	…………エヘ。　西へ行くっての、どう？	scene_23
No, no reason. NO reason at all!	ぜ～んぜん理由なんかないけどね。もう、ぜ～んぜん！	scene_23