Wilderness	荒れ地	荒地	scene_24
Wait, wait, wait, wai----t!!	待った待った待ったーっ！！	待待待	scene_24
What!? What happened all of a sudden?	なになに！？どうしたの、とつぜんあわてたりして？		scene_24
What!? The hell happened all of a sudden!?	な、なんだなんだ！？急にどうしたってんだ？	急	scene_24
What the--? Did something happen?	な、なによとつぜん！？何かあったの？	何	scene_24
What happened all of a sudden? Don't scare me like that!	ど、どうしたんだよ急に！？ビックリするじゃないかよ！	急	scene_24
Wh, wh, what is it, all of a sudden!? Don't scare me like that!	わ、わ、わ、なんや急に！？おどかさんといて～な	急	scene_24
What the HELL is it! Shoutin' out and jumpin' in front of me all of a sudden!	な、なんでえなんでえ！急にデカイ声出して飛びだすんじゃねえよ！	急声出飛	scene_24
What happened all of a sudden? Did something happen?	突然、どうしたというのだ？何かあったのか？	突然何	scene_24
I know this area pretty well.	アタシ、ここいらあたりはちょっとくわしいんだ		scene_24
It gets pretty tough past here. Better get ready…	この先ってさあ、かなりキツイんだよね。だからね、いろいろ準備を……	先準備	scene_24
…Hmmm… Something's fishy…	……ふ～ん……なんかアヤしいな～		scene_24
You're not planning something sneaky again, are you?	また何かイケないこと考えたりしてない？	何考	scene_24
You're not planning something sneaky again, are you?	何かイケないこととか考えたりしてない？	何考	scene_24
Hah, I know what you're thinkin'. And you sayin' that just now means you're up to somethin'! Right!?	……ハハーン、よめたぞ。そんなこと言っておまえまた何かたくらんでるんだろ！　ちがうか！	言何	scene_24
…You serious? And you sayin' that just now means you're up to somethin'! Right!?	……ホントか？そんなこと言っておまえ何かたくらんでねえか？	言何	scene_24
I don't trust you.	ハッキリ言ってどうも信用できないんだよな、おまえ	言信用	scene_24
…Really? Somehow, I don't believe it.	……本当に？な～んとなく、信用できないんだけどな	本当信用	scene_24
Are you trying to con us again?	また私たちをダマそうとしてるんじゃ……	私	scene_24
…Really? Something tells me I shouldn't trust you.	……本当に？な～んとなく、信用できないのよね	本当信用	scene_24
Are you going to trick us again?	ひょっとして私たちをダマそうとしてるとか……	私	scene_24
Hmm… Smells fishy.	クンクン……ウサンクサイにおいがするよ		scene_24
Are you going to trick us again?	まさか、またオイラたちをだしぬこうとか……		scene_24
My nose never lies!	オイラのハナはウソをつかないからね！		scene_24
You serious? I can't trust you.	ホンマか～？この人なんや信用でけんのや	人信用	scene_24
But then again, I guess I shouldn't talk.	ま、それはボクもいっしょやけどね		scene_24
Hey! You serious?	オウオウオウ！おめえ、それ本当だろうな？	本当	scene_24
If you're trying to con us, you won't get away with it!	このオレ様をだまそうったってそうはいかねえぞ！？	様	scene_24
Further down? I don't see any signs of danger…	ここから先が？そんな気配は感じられないが	先気配感	scene_24
There's something unnatural in the way YUFFIE's acting…	それにYUFFIEの態度にもどこか不自然なものが……	態度不自然	scene_24
No! It's REALLY tough…	ちちちがうって！ホントのホントに大変なん……	大変	scene_24
There they are, catch 'em!!	いたぞ、つかまえろ！！		scene_24
Shinra!?	神羅ッ！？	神羅	scene_24
The Shinra!?	あっ、神羅の……！？	神羅	scene_24
The Shinra!!	神羅かっ！！	神羅	scene_24
That's Sh…Shinra's…	し、神羅の……	神羅	scene_24
What, the Shinra!?	なにいっ、神羅だと！？	神羅	scene_24
It's Shinra!!	神羅のッ！！	神羅	scene_24
The Shinra!	神羅……！	神羅	scene_24
Shinra Soldier	神羅兵	神羅兵	scene_24
Hey, that's not them! These are the other guys from before!!	おい、違うぞ！　ヤツじゃない！こ、こいつら、例の！！	違例	scene_24
YUFFIE, did you by any chance…	YUFFIE、あなた、もしかして……		scene_24
YUFFIE, so you're…	YUFFIE、おまえ、やっぱり……！		scene_24
YUFFIE, you're not…	YUFFIE、あなたまさか……！		scene_24
So you were, YUFFIE!!	やっぱりYUFFIE……！！		scene_24
Not bad, YUFFIE, not bad at all.	YUFFIEさん、なかなかやりますなぁ		scene_24
YUFFIE! You sure got some nerve, kid!	YUFFIE！おめえいい度胸してんじゃねえか！	度胸	scene_24
So what does this mean? You will explain later.	これはどういうことか……後でじっくり説明してもらおうか	後説明	scene_24
I didn't know! I had nothing to do with this one!	知らない知らない！これはアタシとカンケーないって！	知知	scene_24
This one? What do you mean 'THIS one'?	これ『は』？これ『は』って、何？	何	scene_24
So you WERE up to something!	YUFFIE、あなたやっぱりイケナイこと考えてたでしょ！	考	scene_24
Whaddya mean 'this one'!? This one'?	これ『は』って何だ！『は』って！	何	scene_24
So you WERE plannin' somethin'!!	おまえ、やっぱり何かたくらんでたんだな！！	何	scene_24
This one? Did you just say 'THIS one'?	これ『は』？今、これ『は』って言った？	今言	scene_24
So you WERE trying something!	YUFFIE、やっぱりあなた何かたくらんでたのね！	何	scene_24
What do you mean 'this one'? THIS one'?	これ『は』って何だよ『は』って！	何	scene_24
So you were concocting some evil scheme!!	やっぱり何か悪だくみしてたんだ！！	何悪	scene_24
This one? What do you mean 'THIS one'?	これ『は』？『は』ってなんです？		scene_24
So you were planning on tricking us!	なんやほかにもやましいことでもあるんとちゃうか！		scene_24
Whaddya mean 'THIS one'? THIS one'!?	これ『は』っつうのは何だ！『は』っつうのはよ！	何	scene_24
So you WERE planning some crooked $%*&!!	おめえ、やっぱり何かたくらんでやがったな！！	何	scene_24
What do you mean, 'This one'?	これ『は』？『は』とはどういうことだ？		scene_24
You had something else in mind?	ほかのことなら心当たりがあるというのか？	心当	scene_24
No, umm, uh…	い、いや、あの……		scene_24
What should we do!?	ど、どうする！？		scene_24
Uh…Get them! Grab them and ask questions later!!	い……や、やれ！いいからやってしまえ！！		scene_24
What's going on!?	これ、どういうこと！？		scene_24
I thought something was missing… my Materia's all gone!!	なにかたりないと思ったらマテリア、マテリアなくなっちゃってる！！	思	scene_24
The hell's goin' on!?	おい、どうなってんだ！？		scene_24
I knew somethin' was missing. All my Materia's gone!!	なんかたりねえと思ったらマテリアが、マテリアがなくなっちまってる！！	思	scene_24
What's going on!?	いったい、どうなってるの！？		scene_24
I thought something was odd… My, my Materia is missing!!	なんだかおかしいと思ったらマテリアが、マテリアがなくなってるじゃない！！	思	scene_24
What's going on?	どうなってるんだよォ？		scene_24
I thought something was funny, my Materia's disappeared!!	なんかおかしいと思ったらマテリアが、マテリアがどっかへ行っちゃった！！	思行	scene_24
What's going on!?	どないなっとるんや、コレ！？		scene_24
Something's missing…my Materia…it's gone!!	なんや足りんと思とったらマテリアがゴッソリのうなっとるやないか！	足思	scene_24
What the hell's goin' on?	コリャー、どういうこったい！		scene_24
I knew I was missing something… My Materia's gone!!	なんかものたりねえと思ったら、マテリアのやつどっか行っちまいやがった！！	思行	scene_24
I thought something was wrong. So that's it.	どうもおかしいと思ったらなるほど、そういうことか	思	scene_24
My Materia's been stolen…	みろ、マテリアがぬきとられている……！		scene_24
Hey…where's YUFFIE?	おい……YUFFIEは……？		scene_24
Hey…where's YUFFIE?	ね……YUFFIE……は？		scene_24
Hey…where's YUFFIE?	ねえ……YUFFIEは……？		scene_24
Now…where's YUFFIE?	はて……YUFFIEさんは……？		scene_24
Ey…where the hell's that damn kid?	オイ……YUFFIEのやつは……？		scene_24
I'm SO mad!!	くーやーしーいーっ！！		scene_24
That &*&$ kid!!!	あーのーやーろーおーっ！！		scene_24
Grrrrrgh!! Arrrrrgh Uhhhhhhhhhhhh!!	ガーッ！！ガアーッウオオオオーッ！！		scene_24
She's done it again!!	やーらーれーたーっ！！		scene_24
I'll never forgive her!	まただますなんて！もう許さないから！	許	scene_24
ZOUNDS!!	チークーショーッ！！		scene_24
Grrrrrrrgh… Grrrgh! Grrrrrgh!!	ガルルル……ガウッ！ガウウッ！！		scene_24
She's done it again!	あちゃ～、やられてしもた～！		scene_24
She sure took us for fools!	いや～、すっかりハメられましたなぁ！		scene_24
That little ^%#^$@!!	あーのーやーろーおー！！		scene_24
Takin' me for a fool!!	このオレ様をコケにしやがったな！！	様	scene_24
Inexcusable…	これは見過ごせないな……	見過	scene_24
She was probably eyeing our Materia from the beginning.	最初からあのコわたしたちのマテリアねらってたのね、きっと	最初	scene_24
It looks like she went North. Let's hurry after her and get our Materia back!	あのコ、北の方に逃げたみたい。早く追いかけて、マテリア取り返さなくちゃ！	北方逃早追取返	scene_24
She was after our Materia from the start!!	あいつ、はじめっからオレたちのマテリアをねらってやがったんだ！！		scene_24
She went North! When I get my hand on her, I'll get our Materia back!	北だ、北に逃げてったぜ！絶対に、絶対につかまえてマテリア取りもどしてやる！	北北逃絶対絶対取	scene_24
C'mon! We're goin' after her!	急げ！後を追うぞ！	急後追	scene_24
She was after our Materia from the beginning.	はじめっから私たちのマテリアをねらってたんだわ	私	scene_24
She won't get away with this! I'm pretty sure she ran off North. Let's go after her!!	そんなことさせないから！たしか北の方に逃げてったわ。後を追いましょう！！	北方逃後追	scene_24
Her objective was stealing our Materia from the beginning.	はじめからオイラたちのマテリアがねらいだったんだ		scene_24
…sniff… North! She ran off to the North!	クンクン……北だ！北の方に逃げたよ！	北北方逃	scene_24
I'm not going to let her get away with this! Hurry, hurry! We have to get our Materia back!	このまま逃がすもんか！早く早く！マテリア取りもどさなきゃ！	逃早早取	scene_24
She must've been after our Materia from the beginning.	さいしょっからマテリアが目的やったんやな	目的	scene_24
We can't just let her get away, right? Then, let's hurry after her! Which way? It's North, the North! It's a message from the stars!	ほっとくわけやないんですやろ？ほんな、ちゃっちゃと追いかけましょ！方角？北です、北！占いのおつげや！	追方角北北占	scene_24
No doubt about it! That kid was after our Materia from the start!!	間違いねえ！はじめからオレ様のマテリアをねらってやがった！！	間違様	scene_24
Hmm… Looks like she went North.	フン……どうやら北に逃げたらしいな	北逃	scene_24
Don't drag your asses! We're going right NOW! That $#@^% is history!!	グズグズするない！すぐ出発するぞ！あのヤロー、とっつかまえてやる！！	出発	scene_24
Seems as though all that she was after was our Materia.	どうやら、最初からマテリアが目的だったようだな	最初目的	scene_24
We can't just let her get away. She ran to the North…	我々としてもこのままにしておくことはできないな。逃げたのは……北、か……	我逃北	scene_24
We must go after her and retrieve our Materia back.	さあ、後を追ってマテリアを返してもらわなければ	後追返	scene_24
Hey, we gotta problem! Our Materia's all gone!!	オイ、たいへんだ！オレたちのマテリアがなくなってる！！		scene_24
O…OH NO! All of our Materia…gone!?	た、た、たいへんだよ！オイラたちのマテリアがなくなっちゃった！！		scene_24
Wutai	ウータイ		scene_24
Hey!!	あッ！！		scene_24
Life is just like a river. It flows from the large ocean of life, and eventually it returns back to it.	人の生、ただ水の流れににたり。命の大海より流れいでまた大海へと帰るものなり	人生水流命大海流大海帰	scene_24
Wutai is a historical place. There are some very unusual things here you should see.	ここは歴史の地、ウータイ。めずらしいものもあるからごらんになるといいでしょう	歴史地	scene_24
YUFFIE? I saw her a while ago. She must be in one of the houses around here.	YUFFIEですか？さっきみかけましたよ。このあたりの家にいるんじゃないかしら……？	家	scene_24
Materia is like Life. They both come from the large ocean of life, and both must return to it.	マテリアも人の生ももとは同じ。いずれ命の大海へともどるべきものなのです	人生同命大海	scene_24
Life is like the dew on the leaves of the trees. Whether Meteor falls or not is no more than a fleeting glimmer.	人の生など、木の葉からしたたるあさつゆのようなもの。あの星が落ちようと落ちまいとほんの一瞬のきらめきにすぎないのです	人生木葉星落落一瞬	scene_24
Lord Godo is in this house.	この先の屋敷にはゴドー様がいらっしゃる	先屋敷様	scene_24
He used to be quite strong, but now, all he does is sleep…	むかしはたいそう強い方だったが今ではねてばかりだナ……	強方今	scene_24
What, YUFFIE… It's best to ask Lord Godo about that.	なに、YUFFIEとな……それならゴドー様にきくのがいちばんだナ。　なにせ……	様	scene_24
But today he's not in the best of… Well, I should say… But really he's not so…	いや、しかし今のゴドー様には……とはいっても……しかし、あれではナ……	今様	scene_24
Anyhow, for some reason YUFFIE's had a fondness for Materia ever since I can remember.	どういうわけかYUFFIEはむかしからマテリアが好きでナ。いつでもマテリアのありそうな場所をウロウロしてるよ	好場所	scene_24
She's always hung around places she thought might have it. That's just how she is. Sometimes she'll just bust into people's houses.	YUFFIEのやつ、あの性格だからナ。ときどき、人の家なんかに勝手にあがりこんだりするんだよ	性格人家勝手	scene_24
Other times she'll hide in the shadows just like a little kid.	そんでもって、ものかげにかくれたりなんかして……まだまだコドモなんだナ		scene_24
That reminds me, lately I've seen a kid around here that reminds me of YUFFIE.	そういえばさっきからYUFFIEみたいなコをみかけるな……		scene_24
Always sneakin' around corners and doin' somethin' she shouldn't.	どっかすみっこのほうでまたゴソゴソと、何かしてるんじゃないかナ	何	scene_24
She's always getting into fights. I guess she takes after Godo that way.	ケンカばかりしとるがあれでゴドー様とYUFFIEはじつによくにてるんだ	様	scene_24
Like father like daughter…	やはり親子なのかね……	親子	scene_24
Two girls just went off towards Da-chao. I wonder if that place is popular with the kids now?	そうそう、たった今女の子がふたりダチャオ像の方へ行ったがあれが今のはやりなのかナ？	今女子像方行今	scene_24
One had herself all tangled up in a rope. And the other one kind of looked like YUFFIE.	ロープでグルグルまかれてかかえられてったよ。そういやひとりはYUFFIEに似ていたナ……	似	scene_24
Hm, money? There's all kinds of money.	なに、カネ？カネと言ったっていろいろあるからナ……	言	scene_24
This type and that… Hey now that you mention it, there was some money over there.	あんなカネ、こんなカネ……おお、そういえばあそこにもカネがあったナ……		scene_24
The end is right in front of us…	すぐそこに終わりが近づいている……	終近	scene_24
But what can you do about it? Just go on living your life, day in and day out…	だからといって、私に何ができる？けっきょくいつもと同じ生活を送るしかないんだよナ……	私何同生活送	scene_24
Alright, alright, alright! I know!	ハイハイ、ハーイ！ボク、しってます！		scene_24
On the side of the mountain, right there in your face is Da-chao!	あそこのお山にガガン！と立ってるのはダチャオ像！	山立像	scene_24
I hear you can climb to the top, but since it's dangerous I'd be mighty careful if I were you!	てっぺんまでのぼることもできるんだけどちょっとアブないからよーくきをつけてねー！		scene_24
A girl with Materia? No, there hasn't been anyone climbing Da-chao for some time now.	マテリアもったおねえちゃん？ううん、ダチャオ像にはしばらくだれものぼってないよ！	像	scene_24
You know I've noticed that there's a pounding noise from time to time in this store.	そういえば、ここのマテリア屋さんの中で、なんだかゴトゴト音がしてたケド	屋中音	scene_24
Why Da-chao? Alright, alright, alright! I don't know!	なんでダチャオ像？ハイハイ、ハーイ！ボク、それわかりませーん！	像	scene_24
Alright, alright, alright! I saw an old man in flashy clothes running towards Da-chao!	ハイハイ、ハーイ！ハデハデなカッコをしたオジさんが、ダチャオ像の方に走っていったよ！	像方走	scene_24
He was babblin' somethin' and looked like he was floatin'! He almost bowled me over!	なんかホヒホヒ言ってたけどすんごくはやいんだ！ビックリしたよ！	言	scene_24
When that big star bashes into us, both Wutai and Da-chao are going to be dust! Can't we do anything?	あの星がぶつかったらダチャオ像も、ウータイもみんなこわれちゃうの！？そんなのヤダ！	星像	scene_24
This is MY house! Nobody gets in!	『アタシの家！誰も入るな！』	家誰入	scene_24
You can't get away, YUFFIE.	もう逃げられないぞ、YUFFIE	逃	scene_24
Give it up, YUFFIE!	あきらめなさい、YUFFIE		scene_24
You lost, YUFFIE.	テメエの負けだぜ、YUFFIE	負	scene_24
O…OK, I know… I was wrong…	わ……わかったよ……アタシが悪かった……	悪	scene_24
You win. I'll give you back your Materia…	アンタたちの勝ちだ。マテリアはぜんぶ返すよ……	勝返	scene_24
I don't think she came out from here… Is that OK?	あのコ、ここから出てないと思うけど……いいの？	出思	scene_24
Wait, that damn YUFFIE's gotta be somewhere in this cheap town! You jus' gonna leave?	待てよ、YUFFIEのやつまだこの町のなかにいるはずだぜ。それでも行くのか？	待町行	scene_24
Knowing YUFFIE, she's still hidden somewhere in town. You sure?	YUFFIEならこの町のなかにかくれてるはずよ。いいの？	町	scene_24
I know she hasn't left town! You still want to leave?	YUFFIE、この町からは出てないよ、きっと！行っちゃうの？	町出行	scene_24
You lettin' that damn kid off the hook? I know she's gotta be hiding around here somewhere!	オイオイ、あのガキほっぽってくのか？絶対まだこの町にいるぜ！	絶対町	scene_24
She couldn't have left town… I think she is must still be here. Or, do you want to go on?	YUFFIEならこの町から出てはいないと思うが……それでも行くのか？	町出思行	scene_24
Pub [Turtle's Paradise]	居酒屋　『かめ道楽』	居酒屋道楽	scene_24
Publicity Flyers! Notice	チラシキャンペーンの おしらせ		scene_24
[Turtle's Paradise] is now having a publicity campaign.	ただいま居酒屋『かめ道楽』では チラシキャンペーンを展開中です。	居酒屋道楽展開中	scene_24
Flyer's will be posted all over the world. So make sure you look for our flyers that say "Turtle's Paradise" 	世界各地にはられている『かめ道楽』のチラシ【かめ道楽　通信】　をさがしだしてください。	世界各地道楽道楽通信	scene_24
There's six in all. If you find them all, make sure to let the owner of Turtle's Paradise know. You can win a prize!	チラシはぜんぶで６枚。 すべてさがしだした方は 『かめ道楽』主人におしらせ下さい。 ささやかな景品をプレゼント！！	枚方道楽主人下景品	scene_24
All you have to do is read them. Please don't take them down or rip them up!!	チラシは見るだけでオーケー！ 他のお客様のためにも やぶったりしないで下さいネ！！	見他客様下	scene_24
Owner, Turtle's Paradise	『かめ道楽』主人	道楽主人	scene_24
Wutai‚ Old Man's House	ウータイ・おじじの家	家	scene_24
Well, well. Long time no see. What have you been up to? Let's see…what was your name?	おーおー、ひさしぶりじゃナ。今まで何しとったんじゃ。えーと…………誰だっけ？	今何誰	scene_24
No, Gramps! This isn't anyone you know! This is just some stranger who barged into our house!	ちがうの、おじじ！ぜんぜん知らない人よ！知らない人が勝手にあがりこんでるの！	知人知人勝手	scene_24
Oh, how exciting. You a friend of my grandson's?	おーおー、にぎやかなことじゃ。マゴのおともだちかな？		scene_24
No, Gramps! These guy's are creepy! They're runnin' all over the place!	ちがうの、おじじ！すっごくアヤしい人たちよ！ドタバタ走り回ってるの！	人走回	scene_24
Oh, you know lately things have been like that. You can even see the moon at noon. Everyone's celebrating.	おーおー、このごろはアレじゃな。ひるまでもお月さんが見えるんじゃナ。みんなもよろこんでおるわい	月見	scene_24
No, Gramps! That's a big red planet in the sky! Everyone's scared of it!!	ちがうの、おじじ！あれは、真っ赤に燃えてる星よ！みんなこわがってるの！	真赤燃星	scene_24
What are we going to do, Gramps? Some strange-looking girl came in here a minute ago and I…	どうしよう、おじじ！さっきもヘンなカッコしたおねえちゃんが、いきなり入ってきたとおもったら、あそこの……	入	scene_24
Oh no! More weirdos!	おじじ、たいへん！また、ヘンな人たちがきちゃった！	人	scene_24
No, these aren't like the one from a while ago, but these ones look weird, too!	ううん、さっききた人とはちがうの！　でもこの人たちもヘンなカッコ！	人人	scene_24
Bar [Turtle Paradise]	のみどころかめ道楽	道楽	scene_24
Yy, you!? How did you get here?	お、お前たち！？なんでこんなところへ……	前	scene_24
Never mind that. I guess it's fate that brought us together.	そ、そんなことどうでもいいわ。私たちタークスに会ったのが運のつき	私会運	scene_24
Get ready to die!!	さあ、かくごしなさいっ！！		scene_24
Elena, you talk too much.	……イリーナ、うるさいぞ、と		scene_24
Ww, what?	せ、先輩！？	先輩	scene_24
What are we doing way out here in the middle of nowhere?	俺たちがこんないなかに来てるのは、何のためだ？	俺来何	scene_24
We're taking a vacation and resting up from our work.	そ、それは、休暇をとってひごろのつかれをいやすため……です	休暇	scene_24
Now our vacation is ruined.	せっかくの休暇がつぶれちまうぞ、と	休暇	scene_24
B, but…	で、でも……		scene_24
Even the booze tastes bad now.	……せっかくの酒もマズくなる	酒	scene_24
…Sorry…	……はい……		scene_24
Drink, Rude! How long have we been a team?	もっと飲めよ、ルード、と。お前とくんでもう何年になる……？	飲前何年	scene_24
Being a Turk's been hard at times, but all in all, I'm glad I did it.	タークスの仕事はツライこともあるけど、ま、俺はやってきてよかったと思ってるぜ	仕事俺思	scene_24
After all, I got to meet a bunch of wing nuts like you.	お前みたいなヘンなやつにもであえたぞ、と	前	scene_24
To the Turks… To Reno…cheers!	タークスに……レノに……かんぱい		scene_24
Hmm, you're lucky all right. Now get out of my sight!	フン、運がよかったわね。さっさと消えなさい！	運消	scene_24
The next time we meet I won't be so nice.	この次に会った時はようしゃしないからね！	次会時	scene_24
Hey, hey, welcome! You on a trip? Well, just relax and make yourself at home.	はいはい、いらっしゃい。お客さんも旅の人だね？ゆっくりしてっておくれナ	客旅人	scene_24
Nowadays, Wutai's just able to get by thanks to the tourists.	今のウータイは、旅の人が観光にきてくれるおかげでもってるようなものだからナ	今旅人観光	scene_24
Seems like the town got really lively since you arrived. Did anything happen?	なんだかお客さんたちがきてから、そうぞうしいナ。なんかあったのかい？	客	scene_24
First the ground started shaking, then that large star…	地面がグラグラゆれたと思ったら今度はあのでっかい星……	地面思今度星	scene_24
Y, you think… It's all over?	や、やっぱりもう……ダメなのかいナ？		scene_24
Hey. You think the store feels gloomy?	ウーイ。さびしい店だろ？	店	scene_24
Let's just say that I like things quiet.	ま、静かなフンイキがおれはすきなんだけどね	静	scene_24
It's been really loud and busy outside.	それにしても、おもてはさっきからバタバタさわがしいナ……		scene_24
Someone outside must be up to something bad…	また誰か、おもてのツボに悪さでもしてるのかナ？	誰悪	scene_24
With things the way they are in the world I guess there's nothing I can do about it.	まあ、世の中がこんなになっちまっちゃあそれもしかたないか	世中	scene_24
Running around like a fool won't help matters any. So, we all might as well sit back and have a beer…	ジタバタしたってどうしようもねえんだ。みんなも酒でも飲めばいいのに……	酒飲	scene_24
So our reports were right! He IS here on vacation!	おお、やはり休暇でこちらにきているという情報は本当だったか！	休暇情報本当	scene_24
We've finally found him! Get the Turks here for back-up!	ついにヤツを発見したのだ！タークスにも協力をたのみたい！	発見協力	scene_24
…What a drag.	……やなこった、と		scene_24
Ww, what was that?	い、今なんと……？	今	scene_24
We're off duty now and can't save your butts.	俺たちは休暇中につきあんたらのおもりはできないぞ、と	俺休暇中	scene_24
We know you're off duty, but…	き、君たちが休暇中なのは我々も知っている。しかし……	君休暇中我知	scene_24
If you knew, then don't bother us! Lookin' at you is makin' me sober.	知ってるなら消えてくれ、と。あんたらのカッコを見てると酔いがさめちまう	知消見酔	scene_24
But you all have orders from headquarters to look for him too!	しかし、ヤツを探せという指令が本社から君たちにも出されているはず……！	探指令本社君出	scene_24
All right, fine! We'll get him without any help from the Turks, just you see!	ええい、もういい！タークスの力などかりなくてもヤツをつかまえてみせる！	力	scene_24
And don't think that headquarters isn't going to hear about this!!	このことは本社に報告しておくからな！！	本社報告	scene_24
Reno, do you think that was really such a good idea!?	レノ先輩！本当にそれでいいんですか！？	先輩本当	scene_24
I mean is that the way a professional, a Turk, would act!?	これがプロフェッショナルのタークスなんですか！？		scene_24
Elena. Don't misunderstand.	イリーナ。かんちがいするなよ、と		scene_24
Those who sacrifice themselves for their job aren't pros… …just fools.	仕事のためにすべてを犠牲にするのがプロじゃない。そんなのはただの仕事バカだ、と	仕事犠牲仕事	scene_24
Rude?	ルード先輩……	先輩	scene_24
Well, I don't buy that! Goodbye!!	私にはわかりません！……失礼します！！	私失礼	scene_24
Relax. She's not a child. Let her have her way.	ほうっておけよ。こどもじゃないんだ。好きにさせるさ、と……	好	scene_24
… It's just that we're off duty!	…………休暇だから手を出さないだけだ	休暇手出	scene_24
I don't feel like drinking with you. And don't talk to me.	お前らと酒を飲む気はない。気安くはなしかけるなよ、と	前酒飲気気安	scene_24
Hey. Did you hear? There used to be a Water God here in Wutai.	ウーイ。旅の人、知ってるかい？このウータイにはむかし水神様がいたんだナ	旅人知水神様	scene_24
They say the Water God was a huge snake!	そりゃあでっけえヘビみてえな神様だったって話だ	神様話	scene_24
Now we live in a world filled with Mako. Not many people would believe in something like that now.	今は魔晄の世の中だ。そんなもん信じる人間も少なくなったけどナ	今魔晄世中信人間少	scene_24
But some in the world, and here in Wutai, still believe.	でもこのウータイや世界のどこかにはまだあるらしいんだナ	世界	scene_24
Believe in the scales of the Water God and in Materia that has its power in it.	水神様のうろこだとか水神様の力をふうじたマテリアとかがさ	水神様水神様力	scene_24
Congrats! You have just found all six flyers for the "Turtle's Paradise"! 	おお！アナタ、この『かめ道楽』のチラシを、６枚すべて見つけられましたね！	道楽枚見	scene_24
How wonderful! Now here is your prize, just as we promised!!	なんとすばらしい！それではお約束どうりささやかな景品を！！	約束景品	scene_24
Please come again to "Turtle's Paradise"! We're looking forward to seeing you!	これからも『かめ道楽』をよろしくおねがいします！	道楽	scene_24
Wutai‚Pagoda	ウータイ五強聖の塔	五強聖塔	scene_24
That five-storied pagoda over there is called the Pagoda of the Five Mighty Gods…	あそこに見える五重の塔はウータイ五強聖の塔。五強の塔と呼ばれています	見五重塔五強聖塔五強塔呼	scene_24
The Five Gods are Power, Speed, Magic, War and Omni. Omni has the best of the others.	五強聖とは力、速、魔、武そして、すべてをかねそなえた総の５人を意味します	五強聖力速魔武総人意味	scene_24
For generations, we in Wutai have worshipped Da-chao the Water God.	そしてここウータイでは古くからダチャオ様と水神様がまつられています	古様水神様	scene_24
Legend has it that the village has been protected by Da-chao, the Water God, and the Five Mighty Gods.	古来よりこのウータイは五強聖とダチャオ様、水神様により守られてきたと言われているのです	古来五強聖様水神様守言	scene_24
But, in the last battle, we didn't fare so well… I guess our beliefs were only based on legend.	しかしこの前の戦ではそれもかなわず……やはり伝説は伝説にすぎなかったのかもしれません	前戦伝説伝説	scene_24
Have you ever heard of the Water God's scales?	水神様のうろこの話を聞いたことがありますか？	水神様話聞	scene_24
They're not just regular scales. They have special hidden powers. They're impervious to the strongest flames.	なんでも不思議な力をひめたうろこでそれを前にするとどんな炎でも消えてしまうとか	不思議力前炎消	scene_24
But, of course, I don't think they'd stand up to the fire that huge eerie-lookin' Meteor's gonna make when it crashes down.	とは言え、そんなものがあってもさすがにあの、不気味に燃える星の炎までは消せそうもありませんが……	言不気味燃星炎消	scene_24
Hmm… Corneo's good at escaping…	フン、コルネオのやつ、あいかわらず逃げ足だけはたいしたものだ、と	逃足	scene_24
…Elena.	……イリーナ		scene_24
Let's go, Rude. We'll give them a taste of what the Turks can do.	行こうぜ、ルード。タークスの仕事やつにじっくり見せてやろう	行仕事見	scene_24
That sounded okay.	……と、言いたいところだが	言	scene_24
If he has Elena, that's going to make things a little difficult.	イリーナが向こうの手にわたったとなるとちょっとやっかいだぞ、と	向手	scene_24
And uh…	そこで……と		scene_24
…OK. Corneo took YUFFIE from us.	……いいだろう。こちらもYUFFIEをコルネオにさらわれた		scene_24
And without YUFFIE, there's no way we'll get our Materia back.	YUFFIEがいないとマテリアも取りもどせない	取	scene_24
…All right. Corneo stole YUFFIE from us as well.	……わかったわ。私たちもYUFFIEをコルネオにさらわれたの	私	scene_24
And without her, there's no way we'll get our Materia back.	あのコがいないとマテリアも取りもどせないもの	取	scene_24
That's just beautiful! And now that *#$^@'s walked off with YUFFIE too!	……ケッ、しかたねえか。こっちもYUFFIEのやつをあのヤロウに持ってかれちまったからな	持	scene_24
And without that brat, we can't get our hands on our Materia!	あのガキがいねえとマテリアも取りもどせねえってこった	取	scene_24
Don't misunderstand.	かんちがいするなよ、と		scene_24
We have no intention of joining you. We're only agreeing not to fight each other…for now.	お前らと手を組む気などない。ただ、たがいのジャマはしない。それだけのことだぞ、と	前手組気	scene_24
That's fine. We have no intention of cooperating with you, either.	けっこうだ。俺たちもタークスと協力するつもりはサラサラない	俺協力	scene_24
Now, uh, which direction did Corneo run off?	ところで、コルネオはいったいどこへ逃げたんだ？	逃	scene_24
The same goes for us. We don't want to make friends with the Turks.	ええ、私たちもそのつもり。タークスと仲良くあくしゅなんてえんりょしておくわ	私仲良	scene_24
Now, which direction did Corneo run off?	ところで、コルネオはいったいどこへ逃げたのかしら？	逃	scene_24
Of course! There ain't no way we'd wanna work with the Turks anyway!	あったりめえじゃねえか！タークスと手を組むなんざ、こっちからねがいさげでえ	手組	scene_24
Anyhow, which direction did that %^$*& run off?	にしてもよ、あのヤロウいったいどこへ逃げやがった？	逃	scene_24
Hmm, nice attitude. Here's a clue, it's the most obvious place.	フン、あの性格だ。だいたい想像つくぞ。ここらで一番めだつのは……と	性格想像一番	scene_24
Wutai‚Main Mtn.	ウータイ総本山	総本山	scene_24
Godo	ゴドー		scene_24
GOOGAH…what do you want?	グガーなにか用かな？	用	scene_24
Don't have…GAH…anything much but, you should be able to…GOO…rest yourselves here. GOGAH…make yourselves at home.	なにもンガーないが、旅のつかれをいやすことぐらいはグーできるだろう。ゴガーゆっくりしていきなさい	旅	scene_24
…YUFFIE? …Nope, never heard of her. …GOOGO…	……YUFFIE？…………知らぬな、そんな名は。グーゴー	知名	scene_24
…You again? I said it once, and I'll say it again, I don't know her.	……くどいな。知らぬものは、知らぬ	知知	scene_24
Listen, I said I didn't know her! There isn't anyone named YUFFIE here in Wutai!	知らぬと言ったら知らぬ！YUFFIEなどという者はこのウータイにはおらん！	知言知者	scene_24
…Never seen you around here before…	……見かけない顔だな……	見顔	scene_24
Lately, I've been seeing a lot of Shinra soldiers around here…You wouldn't know anything about that, would you?	このところ、この近くで神羅の兵をよく見かけるが……おぬしたちと関係があるのか	近神羅兵見関係	scene_24
I don't care about who you are.	おぬしたちが何者か。そんなことに興味はない	何者興味	scene_24
But, if you're in trouble with the Shinra, I'm going to have to ask you to leave.	ただ、神羅ともめごとを起こそうというのなら早々に出ていってくれ	神羅起早出	scene_24
I don't want the Shinra hanging around here looking over my shoulder.	神羅ににらまれたくはないのでな……	神羅	scene_24
What's with you, you coward?	なんだい、このいくじなし！		scene_24
YUFFIE!	YUFFIE……！		scene_24
You scared of the Shinra?	そんなに神羅がこわいの？	神羅	scene_24
Then why don't you just bow down and obey them like all the other towns?	だったら他の町みたいにさっさと神羅にしたがったらいいじゃないか！	他町神羅	scene_24
Those guys are the ones who are really fighting the Shinra!	そこにいる連中の方が神羅とまともにたたかってるよ！	連中方神羅	scene_24
Shut up! What would you know about this?	う、うるさい！お前のようなやつになにがわかる！	前	scene_24
You got beat once, so what? That's it? What happened to the mighty Wutai I used to know?	いちど戦にまけたらそれっきり？強いウータイはどうしたのさ！	戦強	scene_24
No kid like you's going to talk to me like that!	これはお前のような子供が口を出す間題ではない！	前子供口出間題	scene_24
You keep acting like that! You ought to be ashamed of yourself!	まだそんな格好をしおって！はずかしくないのか！	格好	scene_24
That's my style! And it's my business, not yours! Don't try and dictate what I should do!	アタシのセンスだもんそんなの勝手だろ！人のポリシーに口ださないでよ！	勝手人口	scene_24
Style? Dictate?	セ、センス……？ポリーシー……？		scene_24
Why all those fancy words? You're a rotten daughter!	そんなヨコ文字までつかいおって！この……この不良ムスメが！	文字不良	scene_24
Hmph! You're a sad excuse for a father!!	フンだ、このグータラ親父！！	親父	scene_24
…Take your things and get out of here now.	……やはり、早々にここから出ていってくれ	早出	scene_24
For the good of Wutai, we cannot stand up to Shinra.	ウータイを守るには神羅にさからうわけにはいかないのだ	守神羅	scene_24
Now listen up! They must be in the area! Find them no matter what!	いいか！　ヤツはかならずこのあたりにいるはずだ！なんとしても探しだせ！	探	scene_24
Hidden Passage	かくし通路	通路	scene_24
Received "Magic Shuriken"!	『風魔手裏剣』を手にいれた！	風魔手裏剣手	scene_24
Received "Hairpin"!	『かんざし』を手にいれた！	手	scene_24
Received "HP Absorb" Materia!	『ＨＰきゅうしゅう』のマテリアを手にいれた！	手	scene_24
Item/Accessory Store	武器・アクセサリー屋	武器屋	scene_24
Hey yo! Welcome!	アイヨ、らっしゃい！		scene_24
We got some of the best blades right out of the furnace! So strike while the iron's hot!	鉄は熱いうちに打てってな！できたてのキレモノがそろってるぜ！	鉄熱打	scene_24
You aren't tired of my rambling?	あんたらもまだあきらめてないクチかい？		scene_24
Great! Then come on in and start buying!	うれしいねえ！さあ、買った買った！	買買	scene_24
Sorry, but we're entirely sold out now.	すまないが、ウチの商品いまみんな売りきれなんだ	商品売	scene_24
What's this here? Ah, no…that's uh…	ここにあるの？あ、いや、これは……		scene_24
…A sample! Yeah, that's it…a sample. Sorry, but why don't you all come back later?	そう、見本！見本なんだ。わるいな、また後できてくれよ	見本見本後	scene_24
Listen, I'm sorry about last time. YUFFIE told me not to sell anything to you.	やあ。こないだは悪かったな。じつはYUFFIEちゃんにアンタらに売るの、止められててさ	悪売止	scene_24
[DOESN'T EXIST]	でももう解決したんだよな？さあ、買った買った！	解決買買	scene_24
This is a weapon store of hard cores, by hard cores, and for the hard cores! Come on and take a look, why doncha!?	ここは、あきらめない人間によるあきらめない人間のための武器屋！さあ、見てってくれ！	人間人間武器屋見	scene_24
Sorry, listen I… No, nothing…never mind.	すまないね。じつのところ……いや、なんでもない。また今度きてくれよ	今度	scene_24
Stole "MP Absorb" Materia!	『ＭＰきゅうしゅう』のマテリアを盗まれた！	盗	scene_24
Received "MP Absorb" Materia!	『ＭＰきゅうしゅう』のマテリアを手にいれた！	手	scene_24
We got a lot of different stuff here. Take what you want.	イロイロそろってるよ。自由にえらんでおくれ	自由	scene_24
You're still gonna sit here and buy stuff at a time like this?	こんな時だってのにまだ何か買うのかい？	時何買	scene_24
You're an odd one…	お客さん、変わってるね……	客変	scene_24
I'm sorry. The sign outside says "Materia", but there's almost no Materia left anywhere in Wutai.	ごめんなさいね。おもてには『マテリア』なんてかいてあるけど、今ウータイにはマテリアなんてほとんどないの	今	scene_24
Listen, this is just a backwoods town. We don't have much to do with Shinra, and besides…	ほら、ここはいなかだしそれに、神羅カンパニーともあまり、ね……	神羅	scene_24
If we had a lot of Materia, Wutai would be a much more exciting town, but we don't…	マテリアがいっぱいあればウータイももっとにぎやかになると思うんだけど……	思	scene_24
And now it's too late to be worrying about Materia at this stage of the game…	もうマテリアがどうのと言ってる場合じゃなくなったわね……	言場合	scene_24
If you see anything you need, buy it.	何かあなたの役に立つものがあったら、買っていってね	何役立買	scene_24
Huh? What? You DID?	え？なに？何かあったの？	何	scene_24
Oh, no, no, no! I'm just replacing these goods! You come back later.	ああ、ダメダメ。今、商品のいれかえをしているところなんだよ。あとでまた、来ておくれ	今商品来	scene_24
YUFFIE's House	YUFFIEの家	家	scene_24
I know, the Materia, right? I have it stored in a safe place. …Follow me.	わかってるよ、マテリアだろ？ちゃんとしまってあるよ。……こっちきて		scene_24
…I've been hearing that ever since I was little.	……小さいころから聞かされてた	小聞	scene_24
Before I was born, Wutai was a lot more crowded and more impressive.	アタシが生まれる前のウータイはもっとにぎやかでもっと強かったって……	生前強	scene_24
You see what it looks like now, right? …Just a tourist trap…	見たでしょ、今のウータイを。これじゃただの観光地だよ……	見今観光地	scene_24
After the war, we got peace, but we lost something else. Now look at Wutai…	戦に負けて、和平を手にいれてでも、それといっしょに何かをなくしちゃったんだ。今のウータイは……	戦負和平手何今	scene_24
That's why… if I had lots of Materia I could…	だからアタシは……マテリアがいっぱいあればきっと……だから、だから……		scene_24
Listen, YUFFIE. I don't care about the history of Wutai or your feelings.	……悪いがYUFFIE。ウータイの歴史にもおまえの感情にも興味はない	悪歴史感情興味	scene_24
You've got our Materia and I want it back…now.	俺たちに重要なのはいま俺たちのマテリアをおまえがもっているということだ	俺重要俺	scene_24
If you give it back now, we'll drop the whole thing.	マテリアさえ返してくれればそれ以上おまえを責めるようなことはしない	返以上責	scene_24
I'm sorry, YUFFIE. I know how you feel, but we need Materia, too.	ごめんなさいね、YUFFIE。あなたのキモチはわかるけど私たちにもマテリアは必要なの	私必要	scene_24
…We just can't let you have it. Please understand.	……このままあなたにあげてしまうことはできないのよ。わかってちょうだい		scene_24
YUFFIE	CID		scene_24
Dammit, YUFFIE. We ain't got time to be listening to your life story.	……ケッ、YUFFIEよ。おめえの身の上話をきいてるヒマは、こっちにゃねえよ	身上話	scene_24
If you want Materia, get it yourself. That's how you should do it.	マテリアが欲しかったらてめえの力で手に入れな。それがスジってもんだ	欲力手入	scene_24
I know. I know that…	わかってる。そんなのアタシだってわかってるよ……		scene_24
That…sniff…switch… the lever on the left…… Materia's…sniff, hic…in there.	そこにヒック……スイッチ……左のレバー……マテリア、ヒック……かくして……	左	scene_24
Don't make a mistake. The left lever…	まちがえないで。左のレバーを……	左	scene_24
I'm sorry, but……	かわいそう、だけど……		scene_24
Ain't nuthin' we can do about it…	ま、しかたねえよな……		scene_24
Now, the Materia…	さあ、マテリアを……		scene_24
Were we a little too harsh on her?	ちょっと言い過ぎたかな……	言過	scene_24
Well, let's get our Materia back.	まぁ、とりあえずはマテリア、返してもらいましょ	返	scene_24
Hmmph… I dunno.	ケッ……オレ様は知らねえよ	様知	scene_24
There was nothing else to do.	やむをえないな		scene_24
Wh…what the hell is this?	な、なんだコリャ！？		scene_24
Wh, what are you doing?	な、何するんだ！？	何	scene_24
Wh, what is this?	な、なんやねんなコレ！？		scene_24
Whoa!	オオッ！？		scene_24
!?	！？		scene_24
Ha, ha--! You should've listened!!	ハッハッハーッ！人の言うことは聞いとくもんだってこと！！	人言聞	scene_24
Ha, ha, ha--! Never trust anyone that easily!!	ハッハッハーッ！そうかんたんに人を信用するなってこと！！	人信用	scene_24
The Materia's mine! Tough!	マテリアはアタシのもの！ざんねんでした！		scene_24
You want your Materia? Then go find it yourself!	マテリア取りかえしたかったら自分たちでさがしてみれば？	取自分	scene_24
Yeah that's right. And when you're looking for the Materia, remember you gotta steel it.	そう、マテリアを見つけるにはカネにものを言わせなきゃ	見言	scene_24
Heh heh… Steel…steel! Get it?	エヘヘ……カネだよ、カネ。わっかるー？		scene_24
C'ya!!	じゃ～ね～！		scene_24
Y, yo, wait up!!	お、おい、助けてくれよ！	助	scene_24
Wait, don't leave us!	ね、おいてかないで！		scene_24
W..wait, don't leave us here!	ちょ、ちょっとおいてかないでよ！		scene_24
Help us first!	先にオイラたちを助けてよ～！	先助	scene_24
Hey, help us…please!	先に、こっちを助けて～なぁ～！	先助	scene_24
Hey! Help me first!	おい！オレ様を助けるのが先だろうが！	様助先	scene_24
Wait, don't go by yourself!	待て、ひとりで追うな！	待追	scene_24
Flip the Left Lever	左のレバーをさげる	左	scene_24
Flip the Right Lever	右のレバーをさげる	右	scene_24
No. 6	ナンバー６		scene_24
Drink at the "Turtle's Paradise" and talk about Wutai! To find "Turtle's Paradise", look for the big pot outside!!	『かめ道楽』で飲まずしてウータイを語るなかれ！居酒屋『かめ道楽』はでっかいツボが目印です！！	道楽飲語居酒屋道楽目印	scene_24
Hidden Room	かくし部屋	部屋	scene_24
Let go! I SAID let GO!	離せよ！　離せってば！ちょっと、イタ、イタタタタ！	離離	scene_24
Hey! Who do you think I… OW! What're you doin'? Jerk!	コラ、アタシをだれだと……あーっ！　何すんだよー！	何	scene_24
You!	おまえは……！		scene_24
Oh! You're…	あっ！　あなたは……！		scene_24
Ww, who are you!?	な、なんだテメエは！？		scene_24
…ho… …ho…	……ほ………………ほ……		scene_24
Hohi, hohi! Hohihi!	ほひ、ほひ！ほひひ～～～！！		scene_24
Corneo!?	コルネオ！？		scene_24
Don Corneo!?	ドン・コルネオ！？		scene_24
The hell are you doing!	テメエ、何してやがる！	何	scene_24
I've finally got a new chicky!	やっと新しいおなごが手にはいったぞ～！	新手	scene_24
Two for one, in fact! Heh, heh!	いちどにふたりも！ほひ～ほひ～！		scene_24
Two!?	ふたり！？		scene_24
Two!?	ふたりだと！？		scene_24
H…hey! Let go of me! You're gonna regret this!!	コ……コラ、離しなさい！後でこうかいするわよ！！	離後	scene_24
Received "Swift Bolt"!	『雷迅』を手にいれた！	雷迅手	scene_24
There he is! It's Corneo! Don't let him get away!	いたぞ、ヤツだ！コルネオだ！絶対に逃がすな！	絶対逃	scene_24
Attaaaack!	突撃ーーーッ！！	突撃	scene_24
Num, num…	ムニャムニャムニャ……		scene_24
Help me. Help me. Help me…	どうかお助けください。どうかお助けください。どうかお助けください……	助助助	scene_24
Num, num… I hope Meteor doesn't fall anywhere around here…	ムニャムニャムニャ……あの星がこのあたりに落ちてきませんように……	星落	scene_24
Oh, Great Da-chao… Please grant us your strength…	あ～ダチャオ様……今こそあなたのお力を……	様今力	scene_24
He's in the pagoda next to Lord Godo. Lord Godo says we're stuck…	ゴドー様はとなりにある五強の塔にこもりっきりじゃ。ゴドー様でもあんなものはどうにもならんて……	様五強塔様	scene_24
Wutai‚Da-chao Statue	ウータイ　ダチャオ像	像	scene_24
Wutai‚Godo's Pagoda	ウータイ　五強の塔	五強塔	scene_24
You're finally here. We're gonna split up.	やっと来たな。俺たちは二手に別れるぞ、と	来俺二手別	scene_24
You do whatever you want. But don't endanger Elena.	お前たちは、勝手に行動しろ。ただし、イリーナに危害は加えるなよ、と	前勝手行動危害加	scene_24
Don't worry. We won't do anything to that girl, YUFFIE.	心配するな。俺たちも、YUFFIEとかいう小娘には何もしやしない、と	心配俺小娘何	scene_24
For now…	今のところはな、と	今	scene_24
Stop fooling around. The enemy's not gonna wait for us, you know!	チンタラやってるヒマはねえ。敵さんは待っちゃくれないぜ、と	敵待	scene_24
You all thought they might be here too, huh?  We were way off.	お前たちも、ここがクサイと思ったか。あいにく、大ハズレ、と	前思大	scene_24
There's no way they could get this far.	そんなに遠くへは行けないはずだぜ、と	遠行	scene_24
Can't go through here… That flame would fry me in an instant.	これは無理だな。この炎じゃ、あっという間に黒コゲだ	無理炎間黒	scene_24
Eyaaaah!	キャアッ！		scene_24
There is no way past this!	とてもじゃないけど進めないわ！	進	scene_24
Damn, that's hot!	うあっちい！		scene_24
I like hot baths, but this is TOO hot!	フロは熱いにかぎるがこいつは、ちいとばかり熱すぎんぜ！	熱熱	scene_24
"The Scale of the Sea God" shines!	『水神様のうろこ』がきらめいた！	水神様	scene_24
LET…ME……GO!!!!	は～な～せ～よ～！		scene_24
Hmm! Delicious…scrumptious! I think I've just found a new HOBBY!	ほひ～！いいの～、いいの～！新たなシュミになりそ～じゃの～！	新	scene_24
Which shall it be? Hmm…Hmm…	どっちのおなごにしようかな？ほひ～ほひ～！		scene_24
He…hey, I'm a 'Turk'! Don't think you can get away with this!!	あ、あんた、私はタークスよ！こんな事をしてすむと思ってるの！？	私事思	scene_24
Oh GAWD! If I knew this was gonna happen, I would've taken those rope lessons more seriously!!	あ～ッ！こんなことなら、ナワ抜けの修行マジにやっとくんだったよ～！	抜修行	scene_24
Hmm!!! I've made my choice! My companion for the night will be…	ほひ～！！決めた決～めた！今夜の相手は……	決決今夜相手	scene_24
GROSS-NESS!	ゲゲッ！		scene_24
Don't mess with me old man! You don't even have any Materia!	ざけんな、ジジイ～！マテリアも持ってないクセによ！	持	scene_24
Oooooh! And she's saucy, too! Wheee! Wheee!	ほひ～！そのこばむしぐさがういの～、うぶいの～		scene_24
All right, that's it!!	そこまでだ！		scene_24
Hold it right there!	待ちなさい！	待	scene_24
Hey, hey, hey! That's as far as you go!	おうおうおう！そのヘンにしときな！		scene_24
Oh man! CLOUD……!	ゲッ！CLOUD……！		scene_24
Oh man! TIFA……!	ゲッ！TIFA……！		scene_24
Oh man! That old fart, CID!	ゲッ！CIDのオヤジ……！		scene_24
Wheeel…long time no see.	ほひひ、ひさしぶりだな		scene_24
Don't tell me you forgot…	忘れたとは言わせないぞ	忘言	scene_24
That fall into the trap really hurt!	痛かったんだから！あの落とし穴……！	痛落穴	scene_24
You just don't get it, do you…!?	こりない人ねこんなマネして……！	人	scene_24
Hmm…Who are you guys!?	ほひひ、なんだ、お前たちは！？	前	scene_24
Maybe God'd forgive an ugly ^#@# like you, but I won't!	てめーみてえな、ゲスやろう神さんが許しても、このオレ様が許さねえ！	神許様許	scene_24
 You damn Midgar hyena…!	このミッドガルのハイエナ野郎……！	野郎	scene_24
Hurry and let the two go!	早くふたりを放せ！	早放	scene_24
I don't care what you're doing, so much as the idiotic way you're doing it…	どうでもいいが、やり方がスマートではないな……	方	scene_24
Listen you stupid, slimy, sleazy old scab bag! If you want to get women, there's such a thing as the RIGHT way!	オッサン女にもてたいんやったらやり方ちゅうもんがあるやろ	女方	scene_24
Be quiet! None of you know how much I've suffered since then…	だまらっしゃ～い！あれから、俺がどんなに苦労したかお前らにはわかるまい……	俺苦労前	scene_24
It's a long story, but……	そう、話せば長くなるけれど……	話長	scene_24
We don't want to hear it! Just let them go!	話さなくていーの！早くふたりを降ろしなさい！	話早降	scene_24
I don't really give a damn! You're gonna let them go, or else I'm gonna break your arm!	んなこた、どーでもいーんだよ！ネエちゃんたちを、返してもらうぜ。腕ずくでもな！	返腕	scene_24
I don't really care! Let YUFFIE and Elena go!	興味ないね！YUFFIEたちを、返せ！	興味返	scene_24
Hmm…You guys are serious. …Good, good.	ほひ……おまえら……本気だな。……えらいえらい	本気	scene_24
Why did you kill my little Aps?	あの時は俺の可愛いアプスをよくも殺ってくれたな……	時俺可愛殺	scene_24
I'm gonna make you PLAY with my new pet, so you won't interfere in my search for a bride!	これ以上、俺の花ヨメ探しのジャマをさせんためにも、俺の新しいペットと遊んでもらうぜ！	以上俺花探俺新遊	scene_24
RAPPS---come here!!	ラプス　カムヒア！！		scene_24
Wait…	ちょ……		scene_24
You better say your prayers!	さあ、かんねんしなさい！		scene_24
Don't be such a poor loser, old man!	おうじょうぎわが、わりーぜ！とっつぁん！！		scene_24
Why do you think a bad guy like me would swallow his pride and plead for his life?	俺たちみたいな悪堂がこうやってプライドをすててまで命ごいするのは、どんなときだと思う？	俺悪堂命思	scene_24
Eyaaaah…	キャアーッ！		scene_24
It makes me so MAD!	あ、頭に血がのぼる～ッ！	頭血	scene_24
Once I push this button, they'll fall and we'll have SQUASHED TOMATOES!	このスイッチを押すと、このまま下に真っ逆さま……つぶれたトマトのでき上がり！	押下真逆上	scene_24
Damn!	クッ……！		scene_24
Coward!	ひきょうよ！		scene_24
So this is how a loser lives!	この、クサレ外道が……！	外道	scene_24
Damn tricky $#%@&T$*^%$ !	きったねえ手使いやがって……！	手使	scene_24
All right…	わ、わかった……		scene_24
Grrrrrgh…	グルル……！		scene_24
You sure are vulgar!	えぐいことすんの～！		scene_24
……!	……！		scene_24
Now, give me your women too!	では、そっちのおなごもわたしてもらおうか！		scene_24
Ha, ha, ha, ha! I guess I have the last laugh!	ほっひっひっひ！最後に笑うのは、俺だったな！	最後笑俺	scene_24
No, that would be us.	いや、俺たちだ、と	俺	scene_24
…The Turks!	タ、タークス！		scene_24
You knew this was gonna happen ever since you leaked that secret.	お前が秘密をもらした時から決まっていたのだ	前秘密時決	scene_24
We're going to take care of you… personally.	俺たちの手でほうむり去られるとな、と	俺手去	scene_24
DAMMIT! Then they're all comin' with me!	え、ええ～い！こうなれば、道づれだ！	道	scene_24
Ugh…!	グワッ……！		scene_24
Good timing, Rude.	いいタイミングだぜ。ルード、と		scene_24
…Let's get to work.	……仕事だ	仕事	scene_24
All right, Corneo. This'll be over quick, so listen up.	さーて、コルネオさんよ。すぐ終わるから聞いてくれ、と	終聞	scene_24
Why do you think we went to all the trouble of teaming up with those guys to get you…?	俺たちが、ヤツらと組んでまできさまを追いつめるのはなぜだと思う……？、と	俺組追思	scene_24
Two…Number two?	２……２番ですか？	番	scene_24
All wrong.	どれも不正解、と	不正解	scene_24
No! Wait, st…	や！　やめ……！		scene_24
Aaaaaaaaaa……p	ほひいいいぃぃぃぃぃ……		scene_24
The correct answer was…	正解は、と	正解	scene_24
…because it's our job.	……仕事だからだ	仕事	scene_24
Oh, thank you very much…!	あ、ありがとうございます。先輩……！	先輩	scene_24
I never thought you'd come…	まさか、助けに来てくれるなんて……	助来	scene_24
Elena, don't act so weak.	イリーナ。あまえるなよ、と		scene_24
You're a Turk!	お前もタークスの一員なんだぜ、と	前一員	scene_24
Y…Yes, sir!	は……はい！		scene_24
Th…Thanks.	あ……ありがとう		scene_24
Thanks for your help.	ありがと、助かっちゃった	助	scene_24
I uh, thanks for today.	ともかく、今日んとこは礼を言うぜ	今日礼言	scene_24
Never thought you'd ever help us…	お前らに救われるとはな……	前救	scene_24
You guys have some good in you.	あんたらもええトコあるやないか		scene_24
It would appear thanks are in order…	礼を言わねばならないのか……	礼言	scene_24
I'll just say you…helped.	助かった……と言っておくよ	助言	scene_24
Yes…this is Reno.	はい……レノです、と		scene_24
Yes…Yes… I'll get on it right away.	はい……はい……ただちに、かかります、と		scene_24
Was that the company?	か、会社からですか？先輩……	会社先輩	scene_24
Yeah, they want us to find CLOUD…	そう、CLOUDたちを探せとな、と……	探	scene_24
Are we on?	仕事か……？	仕事	scene_24
No, today's our day off.	いや、今日は非番だ、と	今日非番	scene_24
Hey---who cares about that!? Get----me-----down----!	ど～でもい～けどお～ろ～し～て～～ッ！		scene_24
Freeze!	待たれいッ！	待	scene_24
You aren't from Wutai, are you?	それがしたち、ウータイの者ではござらぬな？	者	scene_24
Only those from Wutai may enter the tower!	ウータイの者でなければこの塔に立ち入る事まかりならんッ！	者塔立入事	scene_24
I'll have to ask for you to leave!	お引き取りいただこう！	引取	scene_24
Hey! I can't stand liars! Leave this tower at once!	ええい！　正体をいつわるとはふとどきせんばん！即刻この塔から出ていかれよ！	正体即刻塔出	scene_24
Oh, Miss YUFFIE! Will you be climbing the pagoda today?	おお、YUFFIE様！この五強の塔を登られる気になられたのですな？	様五強塔登気	scene_24
Yeah	ま、そんなトコかな		scene_24
No way!	ま～さか～！		scene_24
Then I, Sacred Gorky, will be your opponent on the first floor!	では、この１階の相手はこの力の強聖ゴーリキーがつとめさせていただきます！	階相手力強聖	scene_24
Miss YUFFIE! You cannot go on to the second floor unless you defeat me!	YUFFIE様！私を倒さねば、２階に上がる事まかりなりませんぞ！	様私倒階上事	scene_24
Yo! They call me Shake! I'll be watchin' your fight with Gorky!	いよ！　オラ、シェイクってんだ！ゴーリキーと、あんたの手合わせはオラが見届けさしてもらうよ！	手合見届	scene_24
Gorky	ゴーリキー		scene_24
Then, begin!	では、参る！	参	scene_24
Power Change!	力変化招来！	力変化招来	scene_24
Here I am, Miss YUFFIE!	参りましたぞ、YUFFIE様！	参様	scene_24
Shake	シェイク		scene_24
Hmm, I thought you were just a girl, but you handled that pretty good!	へー、ただのはねッ返り娘かと思ってたけど、その程度は出来んじゃん！	返娘思程度出来	scene_24
Let's see how you do on next one…	ま、次はどーかな？	次	scene_24
In my opinion, you need more training! Gorky is disappointed!	お言葉ですが、修行が足りませんぞ！このゴーリキー、がっかりしましたぞ！	言葉修行足	scene_24
No good! You have to beat Gorky! Are you mocking this Pagoda?	だ～めだって！ゴーリキーをやらなきゃ！五強の塔、ナメてんじゃない？	五強塔	scene_24
Of course!	と～ぜ～ん！		scene_24
Shut up! Shut up! SHADDUP!	るさい！　るさい！　るさ～い！		scene_24
Who's next?	次は誰よ？	次誰	scene_24
Are you blind? I'm right here!	あんたの目はふし穴か？ここに、いんじゃん！	目穴	scene_24
What? I gotta fight a punk?	は～？ガキが相手～？	相手	scene_24
Heh! Punk. I'm more of an adult than some bimbo girl!	ヘン、何を言うかね！どこぞのバカ娘よりはオラの方が、よっぽど大人よ！	何言娘方大人	scene_24
Wh, what did you say!?	な、なんだって～！？		scene_24
See what I mean? That kind of anger's what makes you so immature!	ヘッヘ！　そうやってムキになるのがガキたるゆえんよ！		scene_24
Don't pat yourself on the back until you beat me!	のうがきは、速の強聖のオラに勝ってからにしな！	速強聖勝	scene_24
Now watch…!	見てなよ……！	見	scene_24
'bout the only thing you do really good is breathe! Are you sure you wanna fight?	ハナいきだけは一人前だね！ホントにやる根性あんの？	一人前根性	scene_24
Stop yappin'!	おしゃべりは、もういい！		scene_24
I'll forgive you	許してやるよ	許	scene_24
Hm, so someone finally got past Gorky.	ほう、ついにゴーリキーを倒した者が出たようじゃの	倒者出	scene_24
I guess it's Chekhov's turn…	では、このチェホフが立ち合いましょうぞ……	立合	scene_24
Here I go, brat! Speed Change!	行くぜ、ガキんちょ！速変化招来！	行速変化招来	scene_24
URRGRAAAAGH! So you CAN fight a bit!	うわっちゃ～！ちったーやるみたいじゃん！		scene_24
HYAAAAAAH! BRATBRATBRATBRAT!!	ひゃ～っはっは！ガキガキガキガキ～！		scene_24
You don't belong here! This is the Wutai Temple of Martial Arts!	あんたらじゃダ～メ！ここはウータイ武闘術五強聖の塔だぜ！	武闘術五強聖塔	scene_24
Hey, you there! Don't ignore me!	コラコラ、そこの～！オラをムシすんなって！		scene_24
So you're just talk after all. Brat!	あ～らら、いざとなると口だけなんて、ガキもガキ大～ガキ～！	口大	scene_24
Chekhov	チェホフ		scene_24
You can't go to the next floor unless you beat Shake.	シェイクを倒さずして階上に上がることあいなりませんぞ……	倒階上上	scene_24
Ho, ho, ho… It's been a while since I felt pain…	ホッホッホ……ひさかたぶりに、うずきますぞ……		scene_24
So even Shake's been defeated. It's been a while since you had to fight, eh Chekhov?	なんとシェイクまで、敗れたか。チェホフ、そなたの出番もひさしぶりだな	敗出番	scene_24
Unfortunately, this is as far as it goes.  Staniv, you watch over there.	残念ながら、わらわでおしまいじゃ。スタニフ、そなたは、そこで見ているがいい	残念見	scene_24
That ain't going to happen! I'll teach you about the strength of youth!	そんなワケにはいかないのよね～！若さが強さってとこ教えたげるよ	若強教	scene_24
Keep mouthing off like that, little girl, and you're going to get burned.	小娘が、いきがっておるとやけどくらいですまぬぞえ	小娘	scene_24
I got insurance.	あいにく火遊びは大好きなの	火遊大好	scene_24
Let's get this over, ya' old geez.	オバさんは相手にしてらんない	相手	scene_24
Ho, ho, ho. We'll see if you still talk like that after you taste some of my Sacred Magic…	ホッホッホ。魔の強聖のわらわと試合った後でも、そのへらず口きけるといいが……	魔強聖試合後口	scene_24
Ho, ho, ho. What do you expect from a child barely out of diapers!?	ホッホホ。ケツの青い小娘ならではのへらず口だこと	青小娘口	scene_24
Magic Change!	魔変化招来！	魔変化招来	scene_24
I can't believe…you beat me.	わ、わらわの術を破るとは……	術破	scene_24
Staniv	スタニフ		scene_24
This should be interesting! It's been too long since I've had a chance to use my full power…	面白い……！ひさびさに我が腕、ぞんぶんにふるえそうだな……	面白我腕	scene_24
Ho, ho, ho! What does a immature child know…?	ホッホッホ！年はもいかぬ子娘に何がわかろうて……	年子娘何	scene_24
This is the average person's limit?	やはり常人では、ここまでが限度か……	常人限度	scene_24
That being the case, we have nothing further to discuss.	そなたらでは、話にならぬぞえ	話	scene_24
How dare they mock us, thinking they could sneak past us.	ここを素通りしようとはわらわも、なめられたものよ	素通	scene_24
First, Chekhov will keep you company…	まずは、そちらのチェホフがお相手いたす……	相手	scene_24
So you're here…	来ましたな……	来	scene_24
Huh? Who am I supposed to beat?	あれ？　立ち合い人ってのは？	立合人	scene_24
HAAAAH!	はあーッ！		scene_24
The rule is the best fighter on each floor will be your opponent… This is a five-storied pagoda,but the fourth floor is the highest…	ここ、４階までは階上の者が立ち合うのが、ならわし……。しかし、ここは五強の塔４階にして最上階の意味を持つ……	階階上者立合五強塔階最上階意味持	scene_24
In other words, no one has ever defeated me--Master of Weaponry!	すなわち！武の強聖の、私を敗った者はかつてないということだ	武強聖私敗者	scene_24
You still want to try…?	それでも、戦うかね……？	戦	scene_24
Just come on!!	もっちろん！		scene_24
I'll pass!	パス、パ～ス！		scene_24
I like you! Now watch…	気にいった！見るがいい……	気見	scene_24
Weapon Change!	武変化招来！	武変化招来	scene_24
How unfortunate! It was over before I could even put all my strength into it…	無念！今回も力をすべて出せずに終わってしまった……	無念今回力出終	scene_24
Wh, what…!?	な、何だと……！？	何	scene_24
Splendid! You have definitely improved…	お見事！かくも腕を上げられたとは……	見事腕上	scene_24
Oh, ho! You might not be as much of a child as we thought you were!	おっほ！思ったよりガキじゃないみたいじゃん！	思	scene_24
Of course. If WE lost to her…	当然であろう。わらわが敗れた者なれば……	当然敗者	scene_24
You have defeated four of our best, but now you will have to face HIM!	最上階の立ち合いは我ら４人！あの方と相まみえていただきましょうぞ……！	最上階立合我人方相	scene_24
If it were not for Miss YUFFIE, I wouldn't be facing him…	YUFFIE殿でなければ私が相まみえるわけには参りませぬな……	殿私相参	scene_24
You didn't seem like someone who could get to the fourth floor so easily…	労せずして実をえようとはこの４階まで来た者とも思えん所業……	労実階来者思所業	scene_24
D,…Dad!?	お、オヤジイ！？		scene_24
I'm glad you made it this far, YUFFIE!	よくぞ来た、YUFFIE！	来	scene_24
Why, why are you……	な、なんでアンタが……		scene_24
I'll answer you by having you try your skills against me!	聞きたい事は、ワシの体におのれの技で聞くが良い！	聞事体技聞良	scene_24
Hold nothing back. Come as if you're trying to kill me! If you don't…then I'll have to kill you!	手をぬくなよ。　ワシを殺すつもりで、来い！でなければ、私がお前を殺す！	手殺来私前殺	scene_24
Dammit……	ち、ちっくしょ～……		scene_24
Ohhh! And what was that!? Come back when you get more training!	ええい！　なんたるざまだ！腕をみがいて、出直して来い！	腕出直来	scene_24
I'll show you this time, you old Fart-meister!	今度こそ見てなよ。この、なまぐさボウズ！	今度見	scene_24
Hmm? A slight improvement.	ほう、少しは腕を上げたか？	少腕上	scene_24
Come at me with all you have! OMNI-Change!!	全力で来い！総！　変！　化！　招！　来……ッ！！	全力来総変化招来	scene_24
H…hey!	ちょ、ちょっと！		scene_24
What are you doing! OMNI-Change!!	何をしておる！総！　変！　化！　招！　来……ッ！！	何総変化招来	scene_24
…heave…heave…	ハッ……　ハッ……		scene_24
…huff…puff…	ゼエ……　ゼェ……		scene_24
O…old coot… not…bad…	おっ……　オヤジ……やるじゃ……ねーか……		scene_24
You've…also…improved…	お前も……　腕を……あげたな……	前腕	scene_24
Hah…Ha, ha…	ハ……　ハハッ……		scene_24
…Heh, heh…	……ふ　ふッ……		scene_24
Ha ha haaaaaa!	アハハハハハ……ッ！		scene_24
Waha haaaaa!	うわっはっはっは……！		scene_24
It's time I gave this to you, YUFFIE…	やるようになったなYUFFIE……		scene_24
This is Leviathan Materia. Take it.	この水神様のマテリアを持って行くがいい	水神様持行	scene_24
…I thought I'd give it to you, but you have no room for it.	と、思ったら、持ちきれんほどマテリアを持っているな	思持持	scene_24
Then, come back for it later. And don't forget!	ならば、後ほど受け取れい。忘れぬようにな！	後受取忘	scene_24
Leviathan Materia? Oh! So you DID remember.	水神様のマテリアか？ぬうッ！　きっちり覚えておったか	水神様覚	scene_24
Well it's yours, go ahead and take it!	やむをえん、受け取るがよい！	受取	scene_24
You have too much Materia!	そなたら、おびただしいほどのマテリアを持っておるではないか！	持	scene_24
But, Lord Godo. Leviathan Materia should only be given to the person who conquers and takes over this Pagoda. That is our custom…	しかし、ゴドー様。水神様のマテリアは、五強の塔を制覇し、新たに五強聖をおさめる者が持つのが、ならわし……	様水神様五強塔制覇新五強聖者持	scene_24
CUSTOM, CUSTOM, CUSTOM… I'm so sick of hearing that!	ならわし、ならわしってもー聞きあきたよ！	聞	scene_24
It's so stupid!	バッカじゃない！？		scene_24
Silence, Miss YUFFIE!	口がすぎますぞ！YUFFIE様！	口様	scene_24
Then what 'bout all of you? With all your power…	じゃ、あんたらは、い～の？ それだけの力があって……	力	scene_24
Are you satisfied being cooped up in this tower?	こんな塔にこもってるだけで満足なのかよ！？	塔満足	scene_24
You too, Dad! Just because you lost the war,	オヤジもそーさ……！ 前に戦に負けたからって！	前戦負	scene_24
You turned Wutai into a place like this!	このウータイを、こんなにしちまってさ！		scene_24
What do you mean?	……何が言いたいんだい？	何言	scene_24
You turned Wutai into a cheesy resort town peddling to tourists…	ウータイを、こんな、ひなびた観光地にして、ヨソ者にこびて……	観光地者	scene_24
How dare you!? Da-chao Statue and Leviathan are ashamed!!	そんなんで、いーのかよ！ダチャオ像も、水神様も泣いてるよ！！	像水神様泣	scene_24
She IS a kid.	やれやれ、やっぱガキだな		scene_24
YUFFIE!!	YUFFIEッ！！		scene_24
Forgive me… It's all my fault…	許してくれ……すべてワシの責任だ……	許責任	scene_24
What are you saying, Lord Godo!	何をおっしゃいます！ゴドー様！	何様	scene_24
Losing the war…turning Wutai into this. It was all my fault…	戦に負け……ウータイをこのようにしてしまったのは、ワシなのだ……	戦負	scene_24
Lord Godo!	ゴドー様！	様	scene_24
Silence!!	お前たちは黙っておれ！！	前黙	scene_24
YUFFIE……	YUFFIE……		scene_24
I am the same now as I was before when I wanted war.	かつて、戦にのぞむ前のワシも今のお前と同じじゃった	戦前今前同	scene_24
But, after losing, I began to think…	だが戦に負け、考えた……	戦負考	scene_24
Is strength for beating enemies	強さとは、相手をたおすためのものなのか？	強相手	scene_24
…or just something to show-off?	他者に対し見せつけるものなのかとな……	他者対見	scene_24
Might begets might.	力を見せつける強者は、強者を呼ぶ。それが戦になる……	力見強者強者呼戦	scene_24
The same as Shinra.	それでは神羅と同じではないか……	神羅同	scene_24
I knew you were looking for Materia for the good of Wutai.	お前がウータイのため、マテリアを探しているのは、わかっていた	前探	scene_24
But, the reason I hide my strength now, is also for the good of Wutai…	だが、ワシが、力を封じているのもまたウータイのためなのだ……	力封	scene_24
And now, I realize both are necessary…	今、わかったぞ。必要なものは両方なのだ……	今必要両方	scene_24
Strength without determination means nothing. And determination without strength is equally useless…!	志のない力では、意味がない。力のない志では、それもかなわぬ……！	志力意味力志	scene_24
Lord Godo…	ゴドー様……	様	scene_24
You there, please take YUFFIE with you!	そなたたち、YUFFIEを同行させてやってくれい！	同行	scene_24
I perceive that you all have both determination and strength!	そなたたちは、志と力その２つを持っている！	志力持	scene_24
Well, just tell yourself you're on a big ship, and leave the rest to ol' CID!	ま、大船に乗ったつもりでこのCID様にまかせときなって！	大船乗様	scene_24
If you put it that way, we can't refuse…	そ、そこまで言いはるんならかまへんけど……	言	scene_24
As long as she doesn't interfere!	オイラたちにめいわくをかけないっていうならね……！		scene_24
All right. We'll take her with us.	わかりました。娘さん、おあずかりします	娘	scene_24
…after that, how can we refuse?	……そうまで言われたらことわれないわね	言	scene_24
Hmm… You may come if you want to …	フッ……勝手について来るがいい……	勝手来	scene_24
Jus' don't do nothin' funny to our Materia…!	もうマテリアに、みょうなマネしねえならな……！		scene_24
All right, I don't mind.	ということさ。俺はかまわないよ	俺	scene_24
Go, YUFFIE!	行けい、YUFFIE！	行	scene_24
For the sake of Wutai!	ウータイに真の強さを根づかせるためにもな！	真強根	scene_24
Dad…	オヤジ……		scene_24
I'll take care of the Five Sacred Gods until you return!	お前がもどるまでは、ワシが五強聖をおさめる！	前五強聖	scene_24
Go! And come back alive!	行ってこい！そして生きて帰って来い！	行生帰来	scene_24
Duh!	と～ぜんだよ！		scene_24
YUFFIE, wait a minute.	YUFFIE、ちょっと待て	待	scene_24
After their battle is over…	あの連中の持っているマテリアな……	連中持	scene_24
Do you think they'll still want all their Materia?	戦いが終われば、たぶん用ずみになるんではないかな？	戦終用	scene_24
Dad…!	オヤジ……！		scene_24
Go! Fight till the end! But come back!	行ってこい！ 最後まで生き残れ！ そして帰って来るのだ！	行最後生残帰来	scene_24
With the Materia!	マテリアを持ってな！	持	scene_24
Heh, heh…you bet!	ヘヘ……あったりまえよ！		scene_24
Miss YUFFIE. Your feelings for Wutai are the same as Lord Godo's. Always remember that…	YUFFIE殿。ウータイを思う気持ちはそなたもゴドー様もいっしょ。それだけはお忘れなきよう……	殿思気持様忘	scene_24
Please take care of Miss YUFFIE.	YUFFIE殿を、なにとぞよろしくおたのもうしますぞ	殿	scene_24
Never bring shame on Wutai.	ウータイの名にはじぬ戦をしてまいれ	名戦	scene_24
She's always like this. It'll be rougher on you.	あの小娘はあいかわらずじゃろうて。そなたらも大変じゃのう	小娘大変	scene_24
You say there's some unusual Materia where the underground pipe is!?	海底パイプってとこにめずらしいマテリアがあるって！	海底	scene_24
But, first you gotta get if from a monster and unless you use your head, you won't be able to do it.	モンスターが持っているらしいけどちょっと頭をつかわないとゲットできないってさ。	持頭	scene_24
Did that kid mature at all?	あのガキ、ちっとは成長したかい？	成長	scene_24
Miss YUFFIE. We pray for your success!	YUFFIE様。ご武運を、おいのりしております！	様武運	scene_24
Oh, you there! How is Miss YUFFIE doing?	おお、そなたら！YUFFIE様は、お元気ですかな？	様元気	scene_24
Winning Miss YUFFIE's heart must mean you have tremendous skill.	YUFFIE様に見そめられるとはそれがしたちも、かなり腕にはおぼえがあられますな	様見腕	scene_24
Compared to me, all of you are nothin' but a buncha babies.	あんたらも、オラにくらべりゃまだまだヒヨッコだね		scene_24
Managing that girl must be exceedingly rough on you.	そなたらも、あの小娘相手にたいぎなことじゃのう	小娘相手	scene_24
I would like to fight you, however the Five Sacred Gods can only compete with those from Wutai…	そなたらとも、お手合わせねがいたいところだが、五強聖はウータイの者としか、試合うことはゆるされない……	手合五強聖者試合	scene_24
Sh…	しー……ッ！		scene_24
…Hm. You can do it…	……ほう。出来るな、そなたら……	出来	scene_24
Mat-…	マテ……		scene_24
Take care of the Materia!!	マテリアを大事になッ！！	大事	scene_24
Your Mat-…	そなたら、マテ……		scene_24
I mean, please look after YUFFIE…!	いや、YUFFIEをよろしく頼みますぞ……！	頼	scene_24
Received "Dragoon Lance"!	『ドラグーンランス』を手にいれた！	手	scene_24
Received "Oritsuru"!	『折り鶴』を手にいれた！	折鶴手	scene_24
Received "Leviathan" Materia!	『リヴァイアサン』のマテリアを手にいれた！	手	scene_24
Received "Steal As Well" Materia!	『ついでにぬすむ』のマテリアを手にいれた！	手	scene_24
Yeah, let's get some rest	休んでいこうかな	休	scene_24
I'm all right	今はつかれてないわね	今	scene_24
Well…	ヤレヤレ……		scene_24
I could take a short nap	ちょっくら休んでくか	休	scene_24
No time to waste	グズグズしてられねえ		scene_24
Phew, perfect. Now the Materia is back in its rightful place.	フー、これでバッチリ。マテリアはもとどおり！		scene_24
Hey…the order is all messed up.	おい……マテリアのつけかたがメチャクチャだ		scene_24
Hey, what is this? The order of it's all messed up!	ちょっと、なにコレ……マテリアのつけかたメチャクチャじゃない！		scene_24
What the hell's goin' on!? The order of the Materia's all messed up!	なんだコリャ！？おい、マテリアのつけかたメチャクチャじゃねえよ！		scene_24
Huh? Oh, it'll be all right…	あん？ああ、いいのいいの		scene_24
Don't be so picky!	こまかいこといちいち気にしない！	気	scene_24
Anyways, that sure was close.	いや～、それにしてもアブないところだったよね～		scene_24
No, normally I would kick their butts, Boom, Bang!!	ううん、いつものアタシならあんなやつら、バシバシバシッ！！とかたづけちゃうんだけどさ		scene_24
That Corneo guy's a real pain.	ホント、あのコルネオってのとんでもないやつだね		scene_24
I'd rather deal with my dad than with that guy.	あれならアタシの親父のほうがずっとマシだよ	親父	scene_24
You know, some of those Turk guys are pretty good, huh?	そうそう、そう言えばあのタークスの連中けっこうイイところあるよね	言連中	scene_24
At least, after all that, we got the Materia back.	ま、なにはともあれマテリアはぶじに戻ってきたし	戻	scene_24
Now come on everybody, let's continue our journey…	さ、はりきってみんなで旅をつづけ……	旅	scene_24
Hey!! W…Wait!	……って、ちょっと！！ま、待ってよ！	待	scene_24
Oh, all right. Here, I'll give this to you guys.	わ、わかったよ、ホラこれもアンタたちにあげちゃう！		scene_24
…No, forget it. Besides, they have lots of Materia anyway.	……いや、やっぱりやめとこ。あいつら、いっぱいマテリア持ってるしな	持	scene_24
Here, look, look!	ホラ、見て見て！ジャジャーン！！	見見	scene_24
Received "MP Absorb" Materia!	『ＭＰきゅうしゅう』のマテリアを手にいれたー！	手	scene_24
Come on, wait!	あ～もう、待ってよ～！	待	scene_24
No matter what you think, I'm going with you!	誰が何と言おうとアタシはアンタたちについてくからね～！	誰何言	scene_24
…Next time…	……そんでもってつぎこそかならず……		scene_24