I thought about what I was going to say, but, it's kinda embarrassing…	セリフ、考えてきたんだけどなんだかてれちゃうな……
Hey, CLOUD! Why don't the two of us sneak out of here and spend some time together?	ね、CLOUD！ふたりでこっそり遊びにいかない？
Come on, let's go!	ね、行きましょ！
Hey.	お、おい
Hee, hee!	エヘヘ！
Let's go on a date!	デート、しない？
A D-A-T-E! Or haven't you ever gone on one?	デ・ー・ト！したことないの？
Don't take me for a fool	バカにするな
Well, not a real one…	正式には、ない
Hey…a little touchy, aren't we?	あ、ムキになるの、あやしい
No, just a mixed-up kid…	う～ん、不幸な青年、ね
Oh well. Come on, let's go!	まぁ、いいわ。さ、いきましょ
Yo, CLOUD. You still up?	よう、CLOUD。起きてるな？
Uh, I was jus' thinkin' of goin' for a walk…	いや、散歩でもしねえかと思ってよ
What, just the two of us?	２人でか？
What's wrong with that? Don't gimme no lip!! Just c'mon!	いいじゃねえかよ！さ、グダグダ言ってねえで行くぞ！
CLOUD you up?	CLOUD　起きてる？
Would you…keep me company for a bit.	ちょ、ちょっとアタシに付き合ってくれよ
Huh? Keep you company where?	？付き合うってどこへ？
Just come on.	いいから
Hotel	客室
Terminal Floor	ターミナルフロア
Tonight's Enchantment Night! All the attractions are free.	さあ、今夜はマジカルナイト！すべてのアトラクションは無料になってるよ
How 'bout it you two? There's going to be an entertaining show in Event Square!	あっ、どうです、そこのお２人さん。今から、こちらイベントスクェアで楽しいショーが始まりますよ！
Congratulations!!	おめでとうございます！！
You are our 100th couple today!!	あなた方が本日１００組目のカップルです！！！
You are our 100th couple today… Oh, wait…no you're not…  Sorry.	あなた方が本日１００組目のカップル……じゃないみたいですね……しつれい
You two will play the leads in tonight's show!!	あなた方がこれから始まるショーの主人公です！！！！
Oh, now, it's not hard. Just play it however you want to and the rest of the cast will cover up for you.	難しいことはありませんあなたは好きにしてくださればショーのプロが話をまとめますので
Come this way.	ささ、こちらへ
This sounds like fun. Come on CLOUD, let's do it.	わぁ、おもしろそうはやく行きましょ、CLOUD
Sounds like fun. Come on CLOUD, let's give it a try.	へぇ、なんかおもしろそう。行きましょう、CLOUD
I don't know what it's all about but sounds kind of cool. Wanna try it, CLOUD?	なんだか、わからないけど行こうよ、CLOUD
Narration	ナレーション
Long, long ago…	むか～し、昔のそのまた昔の物語
An evil shadow appeared over the peaceful kingdom of Galdia…	和平なガルディア王国にとつじょとして襲いかかる、邪悪な影…
Princess Rosa was kidnapped by the Evil Dragon King, Valvados. What will become of her?	ああ、悪竜王ヴァルヴァドスにさらわれた姫君ルーザの運命はどうなってしまうのでありましょうか…
Just then, the legendary hero, Alfred, appears!!	しかし、その時！伝説の勇者アルフリードがガルディア王国にあらわれたのであります！！
Oh……You must be the legendary hero…Alfred!	おお～、あな～たこそ～伝説の勇者～、アルフリ～ド！
Hey, it's your line.	ちょっと、アンタだよ
Yeah, you.	そう、アンタ
Ahem!	オホン！
By my soul, please…please save Princess Rosa!	なぜかわかりま～す、わかるので～す。どうか～、どうか、ルーザ姫をお救い、くださ～～～い
Now…please talk… to the King!!	さあ～、王様に～おはな～しを～～！！
King	王様
Oh…legendary hero, Alfred. You have come to save my beloved Rosa…	おお～、勇者アルフリ～ド私の愛しいル～ザを救うために～やってきた～
On the peak of a dangerous mountain… dwells the Evil Dragon King, Valvados… who's kidnapped Princess Rosa…	悪竜王ヴァルヴァドスのすみかは～はるか険しい山の上～。あわれル～ザは捕われの身～
But… you can't beat the Evil Dragon King now! Talk to one who can help you…	しか～し今のお前では悪竜王には勝て～ん！お前の力とな～る者に語りかけよ～
Who will you talk to?	どっちに話しかけようかな？
The wizard	魔法使い
I am the great wizard, Vorman. What do you wish to know?	わた～しは大魔法使いボーマン～。お前～は何を知りたいの～？
The Evil Dragon King's weakness	悪竜王～の～弱点
The Princess' measurements	ル～ザ姫の～スリ～サイズ
I am…a lowly…knight. How…can I help you?	わたし～は名もなき～兵士～。わたし～に何のごようでしょ～う？
Defeat the Evil Dragon King	悪竜王～を～倒せ～
Defeat the King	王様を～倒せ～
Ahh, the weakness of the Evil Dragon King. It must be, it must be…	ああ～悪竜王の弱点それは～、それは～
Yes, it must be… True love!	そう！それは真実の～愛！
The power of love… Is the only weapon that can withstand the fangs of the Evil Dragon King…!	愛しあ～う２人の力こそが～悪竜王の邪悪な～る牙に打ち勝つただひとつの武器～！
Oh what is going to happen next? Oh…legendary hero…look!	なんということで～ありましょう～！おお！勇者よ～、あれを見よ～！
EDK	悪竜王
Gaaaaaaaah!	ガハハハハ～！
I am the Evil Dragon King…Valvados! I have not harmed the Princess… I have been expecting…you!	我こそは～、悪竜王ヴァルヴァドス～！さらった姫に～何もしないで待っていたぞ～！
Princess	姫
Please help me… legendary hero!	お助け～ください～勇者さま～！
How was that?	……こんな感じ？
How was that?	……こんな感じかな？
…Was that good?	……これでいいのか？
Gaaaaaah! Here I come, legendary hero…Alfred!	ガハハハハ～！いくぞ勇者アルフリ～ド～！
I already know… your name!	なんで～名前を知っているかは気にするな～！
And now…legendary hero…! Here is what will happen…to your beloved…	さあ～勇者よ～！今こそなんじの～愛するものに～
A kiss! The power of True Love!!	口づけを～！真実の愛の～力を～！！
Kiss the Princess	姫にする～
Kiss the King	王様～にする～
Kiss the Evil Dragon King	悪竜～王にする～
What ho! You dare ignore the Evil Dragon King!?	コラァ～！この悪竜王様を無視するな～！
Gaaaaaaahh! Prepare yourself…legendary hero Alfred!	ガハハハハ～！いいか勇者アルフリ～ド～！
Who is your enemy…? Say it!	お前の敵は誰ださあ～言ってみろ～！
The Evil…Dragon King…	悪～竜王～～
The King	王～様～
That Knight	兵～士～
Uuuuuurrrrrgh!	ウ、ウワ～アアア～！
Gaaaaaaaaaaahh! What now…legendary hero!?	ガハハハハ～！さあ～どう～する勇者よ～！
To the Princess	姫のもと～へ
To the King	王様のもと～へ
To home	スタコ～ラ逃げ～る
… Someone…help…	……………だれか、助けて……
Oh…Alfred…! In truth…I too…	おお～アルフリ～ド～！じつはワシも～お前のことがあ～
Arrggaahhh!! Curses… The power of…love!!	ウギャアア～俺は～愛の力に弱～いんだあ～！！
Oh…behold! Love has…triumphed!	おお見よ～！２人の愛の～勝利～だ～！
Now let's all return… and celebrate.	さあみなのもの～もどって～いわいのうたげを～
Yes let's…yes let's…!	そうしよ～　そうしよ～
Oh, how profound the power of love… And so the legendary hero Alfred and our story live on happily ever after.	ああ、何と強い愛の力でありましょう……伝説の勇者アルフリードの物語はこうしてめでたく棊を閉じるのであります
Wh, what?	ちょ、ちょっと何これ
You must be kidding!	こんなのイヤー！
H, hey, what is this?	ちょ、ちょっとなんなの？
That can't be the end!!	こ、これで、終わりなんていやーー！！
…That's it?	終わり？
CLOUD… I mean, Alfred…	CLOUD……じゃなかった、アルフリ～ド～
Come on! No more!	ヒ～エ～！もうダメ～だ～！
Stop it CLOUD!  What are you doing!?	コォ～ラ～！CLOUD～！さっきからなにやってんのよぉ！
The play's a disaster! Now I'm getting mad!	おしばい、だいなしじゃない！もう怒ったんだから！
CLOUD!! Be serious!! You really don't want to be in the play that much, do you?	CLOUD！！もっとまじめにやってよ！！そんなに、私とおしばいしてるのイヤなわけ！？
Now I'm mad!	もう怒ったわよ！
Come on, CLOUD!! I'm tryin' to be serious here and you…	コラ！　CLOUD！！せっかく、アタイがまじめにやってるのに…
Ok, now I'm pissed!	もう、怒った！
Gaaaaaahh! You dare ignore me!!	ガハハハハ～！俺を～無視するとは～いい度胸だ～！
Why don't you shut up, blabbermouth!!	何よアンタゴチャゴチャうるさいのよ！！
Shut up!!	うっるさいわね！！
Just shut up!!	うるっさい！！
Oh my…what an unusually strong Princess! And so the new legendary hero Rosa and our story ends happily ever after.	あ……ああ、何と強い……姫の力！伝説の勇者ルーザの物語はこうしてめでたく棊を閉じるのであります
What…?	なにを…
Urrrrrgh	うぎゃああ
Beautiful Girl	美女性
Thank…you. You've released me…from the spell and I am my normal self again…	ありがとう～ございます～。おかげで～のろいがとけて～元の姿にもどれま～した～
Oh, that was fun. Hey, let's go on the Gondola.	あ～、おもしろかった。ね、次はゴンドラ乗ろう
Hmm, that was funny. Hey, let's go on the Gondola next.	フフ、おかしかったね。ねぇ、次はゴンドラ乗りましょ
I didn't get it. CLOUD, let's go on the Gondola next.	なんだか、よくわかんなかったなぁ。CLOUD、次はゴンドラ乗ろうよ
Let's go somewhere where we can talk, in private.	ちょっと、静かに話せるとこ、行こうぜ
Two, please.	２人おねがいしま～す
Two, please.	２人おねがいします
Two.	２人でのるよ
Hey! You gotta be kiddin'! Just us two? …ok, that's cool, I guess…	おいおい、男２人で乗るのかよ……まぁ、いいけどな
Yo. Two.	おい、２人だ
Here you are, two tickets.	はい、お２人様ですね
Inside the Ferris Wheel	観らん車内部
Look, there.	あっ、あれ
Look, look.	見て、見て
Wow.	すっご～い
CLOUD!	CLOUD、ほら！
Geez!	すっげぇ
Oh my gawd!	ひょ～！
Oh, how pretty.	わあ、きれい
Look, CLOUD.	ねぇ、CLOUD見て
Oh, CLOUD.	CLOUD、ほら
Wow, how nice.	わあ、すご～い
Oh! Look, CLOUD.	あっ！　CLOUD見て
It's so pretty.	わあ、きれ～
Geez!!	わあ！！
Wait a minute.	もうちょっとまって。
…it's really pretty, isn't it?	……きれいね
Ok, I'm going to just go ahead and say it…	……言っちゃおうかな
…What?	……何を
AERIS would be able to just come out and say it, probably.	AERISなら、きっとハッキリ言うんだろうな
Sometimes being old friends is hard.	幼なじみってむずかしいよね
I mean, timing is everything.	タイミング、むずかしいのよ
CLOUD…?	あのね、CLOUD
I…	私ね……
…. ….	………………………………
…Beautiful, isn't it?	……きれいだね
……first off, it bothered me how you looked exactly alike.	……はじめはねそっくりだったから気になった
Two completely different people, but look exactly the same.	全然別人なんだけど、そっくり
The way you walk, gesture…	歩きかた、手の動かしかた……
I think I must have seen him again, in you…	あなたの中に彼を見ていた……
But you're different.	でも、ちがうの
Things are different…	いまは、ちがう……
CLOUD…	ね、CLOUD
I'm searching for you.	わたし、あなたをさがしてる
…?	……………？
I want to meet you.	あなたに会いたい
But I'm right here.	俺はここにいる
I know, I know…what I mean is…	（うんうん、わかってる……でも）
I want to meet…you.	あなたに……会いたい
Hey spike-head. What'd you wanna see fireworks with me for?	おめえよ～。オレと花火見て楽しいかあ？
Not having fun?	……楽しいと思うか？
You should've asked one of them!	それならよ、どっちか誘えば良かっただろうが！
Which would you have asked?	どっちか？
Oh man, there just ain't no choice!	決まってんだろ！
TIFA, AERIS.	TIFA、AERIS
Ah, YUFFIE?	おっ、YUFFIEか？
(hoo boy)	（やれやれ）
What the hell's that supposed to mean?	なんだよ、それ
Hey, you don't mean…Marlene?	おめえ、まさか……マリンを？
NO WAY! Forget it!	ダメだ！　許さねえ！
There ain't no way I'm lettin' a wacko like you anywhere near my little Marlene!	おまえみたいなワケがわからないヤツにマリンはやれねえ！
She's my baby. My prized possession.	マリンは、オレの宝物だからな
…Marlene.	…………マリン
Wish I could've brought Marlene here. She'd love the fireworks.	……マリンに見せたかったぜ。この花火よぉ
Why the hell do I gotta be here with a jackass like you!	どうしておまえなんかと……
…The more I think bout it the madder I get!	クソッ……なんだか腹が立ってきたぜ
Damn fireworks anyways.	うるせえ花火だ
Shut up!!	うるせ～～～！！
No I, uh…	いや、なんかさ～
I just felt like doing that.	そういうフンイキかなって思ったワケよ
That's all.	ん、そんだけ
H, hey!! Say something, why don't you!	お、おい！なんとか言いなよ！
…gawd, I could just die.	…………照れるよ
Say something, PLEASE!	なんとか言ってよ～～ッ！
…something.	………………ナントカ
There's no time for this! We have to go after CAIT SITH.	そんな場合じゃない、でしょ？はやく、CAIT SITH、追いましょう
There's no time to waste. Let's hurry and go after CAIT SITH!	ゆっくりしてるヒマは無いの。はやくCAIT SITHを追いましょ！
Should we be wasting time like this? Weren't we going after CAIT SITH?	そんな、ゆっくりしててい～の？CAIT SITHを追うんじゃないのか？
The hell're you doin'!? We're goin' after CAIT SITH!	何してんだ！はやくCAIT SITHを追うぞ
CLOUD I really had fun tonight.	CLOUD今日は楽しかったわ
By the way, what did you want to say a minute ago?	そういえばさっき何を言おうと…
N, nothing!	な、なんでも！
Nothing…	なんでもない…
?	？
Oh, look at the time. We should be getting back.	あっ、もうこんな時間そろそろもどりましょう
I had fun tonight. Let's do it again.	今日は楽しかったまた、いっしょにこようね
Don't you like being with me?	わたしとじゃイヤ？
That's not it	そんなことない
Oh, don't tease me like that!	もう、いじわる！
I'm glad.	よかった
Next time we come, let's take our time and go on more rides.	次に来たときはもっとゆっくりといろ～んなものに乗ろうね
Oh, look at the time. We'd better get going.	あっ、もうこんな時間そろそろ帰りましょ
Oh man I'm beat. Let's head back.	やれやれなんか、つかれちまった。そろそろもどろうぜ
I should sleep really well tonight.	アタイ今日はよく眠れそうだよ
Thanks… for coming with me.	つきあってくれてありがとな
You wanna go back, CLOUD?	じゃあそろそろもどろっかCLOUD
Hey? What's CAIT SITH doing?	あれっ？CAIT SITH、なにしてるのかな？
That's…CAIT SITH. He's acting strange.	あれ……CAIT SITHよね。なんだか様子がおかしいわよ
…it's CAIT SITH. What's he doin' so quietly?	……CAIT SITHだぜ。なにコソコソしてやがるんだ？
Hey, isn't that CAIT SITH? What's he doing?	あっ、CAIT SITHじゃないか？なにやってんだ？
Is that the…Keystone?	あいつが持ってるのはキーストーンじゃないのか？
Hey! CAIT SITH!	おい！　CAIT SITH！
Oh oh!	やばやば！
Come on, let's go.	ねぇ、行ってみよ
Come on, let's go.	ねぇ、行ってみましょう
CLOUD, let's go.	CLOUD、あそこいこうぜ
CLOUD, wanna take a peek?	CLOUD　チョットのぞいてみるか
We've got no time for this! Let's go after CAIT SITH!	そんな場合じゃない、でしょ！？はやく、CAIT SITH、追いましょ！
We've got no time to relax. Let's go after CAIT SITH!	ゆっくりしてるヒマは無いわよ。はやくCAIT SITHを追いましょ！
Is it all right to relax like that? Aren't we going after CAIT SITH?	そんな、ゆっくりしてていいのか？CAIT SITHを追うんじゃないのか？
We don't have time for this! We've got to go after CAIT SITH.	そんな、場合じゃないでしょ！はやく、CAIT SITHを追いましょう
There's no time for this. Let's hurry after CAIT SITH!	ゆっくり乗ってるヒマは無いわよはやくCAIT SITHを追いましょ！
Hey! Look here! The Key Materia!	ほら！　これや！キー・マテリアや！
Well done.	ごくろうさまです
W, w, wait a second. I won't run or hide.	ちょちょ、ちょっと待って～や。逃げも隠れもしませんから
Yes‚I was a spy. I was hired by the Shinra.	確かにボクは、スパイしてました。神羅のまわしモンです
Don't mess with us!	ふざけないでよ！
…I trusted you. I can't believe you!	……信じてたのにがっかり！
BARRET	バレット
Ya dirty &*$*%$!	うすぎたねえ野郎だぜ！
You think this's a big joke!?	ふざけるな！！
I can't help it. What's done is done. That's just the way it is.	しゃあないんです。すんでしもたことはどないしょうもあらへん
How 'bout if we go on like nothing ever happened?	なぁ～んもなかったようにしませんか？
You're pushin' it‚CAIT SITH! You gotta lot of nerve staying with us all the while being a spy!	ずうずうしいぞ、CAIT SITH！スパイだとわかってていっしょにいられるわけないだろ！
Then‚what are you goin' to do? Destroy me?	ほな、どないするんですか？ボクを壊すんですか？
You'd just be wastin' your time if you tried. This body's just a toy anyway.	そんなんしても、ムダですよ。この身体、もともとオモチャやから
My real body's at Shinra Headquarters in Midgar. I'm controlin' this toy cat from there.	本体はミッドガルの神羅本社におるんですわ。そっから、このネコのおもちゃ操っとるわけなんです
So you're from Shinra. Who are you?	それじゃあ正体は神羅の人間なのね。だれなのよ？
So you're from Shinra. Who? Who are you! Tell me!	正体は神羅の人、ね？だ～れ？　あなた！言いなさい！
Who the hell are ya!? What's your real name!?	だれだ、てめえ！本当の名前を教えろ！
Part of the Shinra! Who the *&$# are you!?	神羅の人間！おまえ、だれだ！？
Whoa‚I can't tell you my name.	おっと、名前は教えられへん
We're not gettin' anywhere.	話にならないな
Right? I told you! Talking won't do any good‚so can't we just continue our journey?	な？　そうですやろ？話しなんどうでもええからこのまま旅、続けませんか？
…Alright‚yes‚I am a Shinra employee.	……確かにボクは、神羅の社員や
But we're not completely enemies.	それでも、完全にみなさんの敵っちゅうわけでもないんですよ
…Something bothers me. I think it's you're ways of living	……ど～も、気になるんや。みなさんのその、生き方っちゅうか？
You don't get paid You don't get praised. And yet you still risk your lives and continue on your journey. Seeing that makes me…	誰か給料はろてくれるわけやないしだぁれも、ほめてくれへん。そやのに、命かけて旅しとる。そんなん見とるとなぁ……
It just makes me think about my life. I don't think I'd feel too good if things ended the way it is now.	自分の人生、考えてまうんや。なんや、このまま終わってしもたらアカンのとちゃうかってな
You're lying again.	またウソついてる
…And so on‚and so on…	～とかなんとか言ってぇ
Hmph! You ain't foolin' us this time!	へっ！　だまされないぜ！
Sounds fishy---	あやしい～
He won't come clean. And he won't quit being a spy.	正体はあかさない。スパイはやめない
We can't go on with someone like that. Pull your head out!	そんなヤツといっしょに旅なんてできないからな。冗談はやめてくれ
…I thought so. It won't do any good talking to you.	……まぁそうやろなぁ。話し合いにもならんわな
So‚I've prepared myself in case something like this happened.	ま、こうなんのとちゃうかとおもて準備だけはしといたんですわ
Why don't you listen to this.	これ、聞いてもらいましょか
Dad! TIFA!	父ちゃん！　TIFA！
Marlene!	マリン！
Hey! That's Marlene!	あっ！　マリンの声！
Ma…Marlene!?	マ、マリン！？
…Marlene?	……マリン？
Hey! It's dad! Dad! It's me‚Marlene!	あ！　とうちゃんの声だ！とうちゃん！　マリンね！
Hey! It's TIFA! TIFA! You know what!	あ！　TIFAの声だ！TIFA！　あのね！
Hey! It's the flower lady! Flower lady…	あ！　お花のお姉ちゃん！お姉ちゃん…
Hey! It's CLOUD!	あ！　CLOUDの声だ！
…So‚there's no other way but to listen to me.	……というわけです、みなさんはボクの言うとおりにするしかあらへんのですわ
You're the lowest…	……最低だ
I didn't want to do this either. Not by using dirty tricks and taking hostages…	そりゃ、ボクかってこんなことやりたない。人質とかヒレツなやりかたは……
So‚this is how it is. There's no room for compromises. So why don't we go on as we did.	まぁ、こういうわけなんですわ。話し合いの余地はないですな。今までどおり、仲ようしてください。
Tomorrow is the Temple of the Ancients‚right? I know where it is so I'll tell you later.	明日は古代種の神殿でしたな？場所知ってますから後で、教えますわ
Of course we'll get there after the Shinra‚ but you'll have to deal with that.	神羅のあとになりますけどまぁ、そんくらいはガマンしてくださいな
…Well‚we're stuck… We'll have to do what he says.	……仕方ないな。言うとおりにしよう
…Marlene.	……マリン
I wonder if Marlene is all right… I wonder what happened to Mom?	マリン、だいじょぶかな……お母さん、どうしたのかな
Sorry‚CLOUD.	すまねえ、CLOUD
Uh‚yup.	う、うん
Hey! Over here! The Keystone!	ほら！　これや！キーストーンや！
See? I told you! Talking won't do any good, so can't we just continue our journey?	な？　そうやろ？話なんてどうでもええからこのまま旅、続けませんか？
Hey! It's CLOUD!	あ！　CLOUDの声だ！CLOUD！　あ…
Tomorrow is the Temple of the Ancients, right? I know where it is so I'll tell you later.	明日は古代種の神殿でしたな？場所知ってますからあとで、教えますわ
Oh, you didn't seem to know this, but…	そういや、みなさんは知らんかったみたいやけど
The Keystone is the key to the Temple of the Ancients. Even so, you're all going, right?	キーストーンは古代種の神殿への鍵なんです。どちらにしろ、みなさんも行くんですよね？
I know where it is, so I'll show you later.	場所知ってますからあとで、教えますわ
I wonder if Marlene is all right… I wonder what happened to Mom?	マリン、だいじょうぶかな……お母さん、どうしたのかな