Temple of the Ancients	古代種の神殿	古代種神殿	scene_28
This is…the Temple of the Ancients…	ここ……古代種の神殿……	古代種神殿	scene_28
I…I know… I feel it… The knowledge of the Ancients…floating…	わたし、わかる……感じるの……ただよう……古代種の意識	感古代種意識	scene_28
You could become one with the Planet, but you're stopping it with the strength of will.	死んで、星とひとつになれるのに意志の力でとどまってる……	死星意志力	scene_28
For the future? For us?	未来のため？わたしたちのため？	未来	scene_28
What are you saying? Do you understand?	なんて言ってる？わかるのか？	言	scene_28
You're uneasy… But happy?	不安……でも、よろこんでる？	不安	scene_28
Because I'm here? I'm sorry…I don't understand.	わたし、来たから？ごめんね……わからない	来	scene_28
I want to go inside!	はやく、ねえ中に入りたい！	中入	scene_28
Black cape	黒マント	黒	scene_28
Key…stone…	キー……ストー……ン……		scene_28
Open…door…of the Temple…	神殿の……扉を……開いて……	神殿扉開	scene_28
Black…Materia…	黒……マテリア……	黒	scene_28
Look…	見て……	見	scene_28
Number 9. Another man with a tattoo.	ナンバー９。ここにもイレズミの男ね	男	scene_28
It says number 9. He has a tattoo on his neck.	ナンバー９だとよ。首にイレズミがある	首	scene_28
He's number 9. There's a tattoo.	ナンバー９だね。イレズミがあるよ		scene_28
Oh!? It's a number 9 tattoo.	おや！？ナンバー９のイレズミやな		scene_28
He has a tattoo too! Ummm, I think it's number 9.	この人もイレズミしてる！え～と、ナンバー９かな	人	scene_28
Hey, he's got a tattoo. It says number 9.	おい、イレズミしてやがるぜ。ナンバー９、だとよ		scene_28
It's a number 9 tattoo.	ナンバー９のイレズミだ		scene_28
CAIT SITH…	CAIT SITH……		scene_28
Hey! It's Tseng!	あっ！　ツォン！		scene_28
Tseng? Of the Turks!?	タークスのツォンか！？		scene_28
Oh, I've been tricked.	くっ……やられたな		scene_28
It's not the Promised Land… Sephiroth's searching for…	セフィロスが……捜しているのは……約束の地じゃない……	捜約束地	scene_28
Sephiroth? He's inside!?	セフィロス？中にいるのか！？	中	scene_28
Look… for yourself…	自分で……たしかめるんだな……	自分	scene_28
Damn…	くそっ……		scene_28
Letting AERIS go was the start… of my…bad luck…	AERISを…手放したのがケチ…の……つきはじめ…だ…	手放	scene_28
The President… was wrong…	社長は……判断をあや……まった……	社長判断	scene_28
You're wrong.	あなたたち、かんちがいしてる		scene_28
The Promised Land isn't like what you imagined.	約束の地、あなたたちが考えてるのとちがうもの	約束地考	scene_28
And, I'm not going to help.	それに、わたし、協力なんてしないから	協力	scene_28
Either way, there was no way Shinra could have won.	どっちにしても、神羅には勝ち目はなかったのよ	神羅勝目	scene_28
…Pretty harsh. Sounds like something… you'd say.	ハハ……きびしいな。AERIS……らしい……言葉だ	言葉	scene_28
The Keystone… Place it…on…the altar…	キーストーン……祭壇に……置いて……み……ろ	祭壇置	scene_28
Received Key Item "Keystone"!	キーアイテム『キーストーン』を手にいれた！	手	scene_28
You crying?	泣いてるのか？	泣	scene_28
…Tseng's with our enemy, the Turks, but I've known him since we were little…	……ツォンはタークスで敵だけど子供のころから知ってる	敵子供知	scene_28
There's not a lot of people I can say that about. In fact, there are probably only a handful of people in the world who really know me.	わたし、そういう人、少ないから。世界中、ほんの少ししかいないわたしのこと、知ってる人……	人少世界中少知人	scene_28
I am…still alive…	私は……まだ、生きている……	私生	scene_28
Let's put the Keystone in.	ここにキーストーンをつかえば……		scene_28
Damn! So this is the Temple of the Ancients!	ひゅ～！これが古代種の神殿かよ！	古代種神殿	scene_28
Oh man, you gotta be kiddin'. This is makin' me dizzy!	ウッ～　冗談じゃねえ。めまいがするぜ！	冗談	scene_28
Hey, Cloud! Don't get lost!	おう！　CLOUD！迷うんじゃねえぞ！	迷	scene_28
Words…feelings… So many of them here.	言葉が…　思いが…たくさん、ここにある	言葉思	scene_28
Geeeez! We got our work cut out for us.	うひゃ～！こりゃ、たいへんだよ		scene_28
This is starting to get me really dizzy…	目まわってきたよ…アタシ	目	scene_28
@#$%! @#$%! @#$%! What the hell's with this place!	クソッ！クソッ！クソッ！なんだってんだ、ここは！		scene_28
Wow, this place is huge! I'm starting to get bored.	へ～、ごっつう広いなぁ。なんや、気い遠なりそうやわ	広気遠	scene_28
No exits… We can't turn back.	出口なしか…。もうもどれないぞ	出口	scene_28
…sniff…sniff… This place smells good.	クンクン……ここいいにおいするよ		scene_28
It smells the same as Cosmo Canyon.	コスモキャニオンとおんなじ星のにおいするよ	星	scene_28
What a strange place. Do you think we're welcome here?	不思議な場所ね。私たち、歓迎されてるのかしら？	不思議場所私歓迎	scene_28
…CLOUD! I know it's going to be tough, but…	……CLOUD！ここ、いろいろ大変だと思うけど…	大変思	scene_28
Don't give up! We can do it!	なげださないで！がんばろう、ね！		scene_28
Sealed……? That sound brings back memories.	封印されている……？なんだか、なつかしい響きだな	封印響	scene_28
Received "Morph" Materia!	『へんか』のマテリアを手にいれた！	手	scene_28
Received "Luck Plus" Materia!	『ラッキー』のマテリアを手にいれた！	手	scene_28
Received "Trident"!	『トライデント』を手にいれた！	手	scene_28
Received "Rocket Punch"!	『ロケットパンチ』を手にいれた！	手	scene_28
Received "Ribbon"!	『リボン』を手にいれた！	手	scene_28
Temple of the Ancients	古代種の道具屋	古代種道具屋	scene_28
Nyum…nyum…	ねむねむ……		scene_28
Can I buy something?	買い物できるか？	買物	scene_28
Let me rest	休ませてくれ	休	scene_28
I want to save my game	記録したいが	記録	scene_28
Nothing	用はないな	用	scene_28
This is the Temple of the Ancients. You won't be able to go back easily.	ここは古代種の神殿だ。かんたんにはもどれない	古代種神殿	scene_28
Is that all right?	それでも、いいだろうか？		scene_28
Save	記録する	記録	scene_28
Welcome!	いらっしゃいませでぷ～		scene_28
Please come again!	またくるでぷ～		scene_28
HP/MP Restored!	ＨＰ／ＭＰが回復した！	回復	scene_28
Whew! We finally caught up to you.	うん！やっと、会えたね	会	scene_28
I'm sorry. You waited for me.	ごめんね。まっててくれたんだ		scene_28
Those are the spirit bodies of the Ancients.	彼らは古代種の精神体	彼古代種精神体	scene_28
They've been away from their Planet for a long time to protect this Temple.	ずっ～と長い間、星に帰らずこの神殿を守りつづけてる	長間星帰神殿守	scene_28
Over the many years, they've lost the ability to talk.	ながい年月は彼らから言葉を失わせた	年月彼言葉失	scene_28
Actually, they didn't need words from the beginning because there was only one objective for those left in the Temple.	ううん、最初から言葉はいらなかった。神殿にとどまったものたちの目的はひとつだったから	最初言葉神殿目的	scene_28
Please, talk to me!	ねえ、教えて！	教	scene_28
No good. I don't understand the rest. Are you afraid?	だめ、あとはわからない。おびえているの……？		scene_28
Is it because Sephiroth is in the Temple? Or something else?	セフィロスが神殿にいるから？それとも、ほかのこと？	神殿	scene_28
Received "Mop"!	『モップ』を手にいれた！	手	scene_28
Received "Silver Rifle"!	『銀玉鉄砲』を手にいれた！	銀玉鉄砲手	scene_28
…phew… We did it!	ふぅ～～やったね！		scene_28
Everyone all right? That was rough.	だいじょうぶか？さすがに、こたえたな		scene_28
Oh no…CLOUD. Come quick!!	あっ……CLOUD。たいへん！！		scene_28
Hurry, this way!	はやく、こっち！		scene_28
It's full of the knowledge of the Ancients.	古代種の知識がいっぱい	古代種知識	scene_28
No…not knowledge …consciousness…a living soul…	ううん、知識なんかじゃない。そう……意識……生きてる心……	知識意識生心	scene_28
It's trying to say something.	何か、言いたがってる	何言	scene_28
I'm sorry, I don't understand.	ごめんね、わからないの		scene_28
What?	えっ？		scene_28
…Danger? An evil…consciousness?	……危険？邪悪な……意識？	危険邪悪意識	scene_28
…show? You're going to show me?	えっ？　見せる？見せてくれるの？	見見	scene_28
Temple of the Ancients	壁画の間	壁画間	scene_28
What's going on?	……どうなってる？		scene_28
Wait! Look! It's showing us!	まって！ほら、見て…はじまるよ	見	scene_28
Test Play is up to here.	テストプレイはここまでです。		scene_28
Tseng, what's this? Can we find the Promised Land with this?	ツォンさん、これは？これで約束の地がわかるんですか？	約束地	scene_28
…I wonder. Anyway, we have to report to the President.	……どうかな。とにかく社長に報告だ	社長報告	scene_28
Be careful, Tseng.	気をつけてくださいね。ツォンさん	気	scene_28
Hey Elena, how 'bout dinner after this job's over?	イリーナ、この仕事が終わったらめしでもどうだ？	仕事終	scene_28
Th…Thank you very much.	あ、ありがとうございます		scene_28
If I may be excused…	それじゃおさきにしつれいします		scene_28
Is this the Promised Land? No, it can't be…	ここが約束の地？いや、まさかな……	約束地	scene_28
Sephiroth!!	セフィロス！！		scene_28
So you opened the door. Well done.	おまえが扉を開いたのか。ごくろうだった	扉開	scene_28
This place…what is it?	ここは……なんだ？		scene_28
A lost treasure house of knowledge. The wisdom of the Ancients….	失われた知の宝庫。古代種の知恵……知識	失知宝庫古代種知恵知識	scene_28
I am becoming one with the Planet.	私は星とひとつになるのだ	私星	scene_28
One with the Planet?	星とひとつに？	星	scene_28
You stupid fools. You have never even thought about it.	愚かなる者ども。考えたこともあるまい	愚者考	scene_28
All the spirit energy of this Planet. All its wisdom…knowledge…	この星のすべての精神エネルギー。この星のすべての知恵……知識……	星精神星知恵知識	scene_28
I will meld with it all. I will become one with it… it will become one with me.	私はすべてと同化する。私がすべて……すべては私となる	私同化私私	scene_28
…You can do that?	……そんなことができるというのか？		scene_28
The way…lies here.	その方法が……ここに	方法	scene_28
Only death awaits you all. But do not fear.	おまえたちには死あるのみ。しかし、悲しむことはない	死悲	scene_28
For it is through death that a new spirit energy is born. Soon, you will live again as a part of me.	死によって生まれる新たな精神エネルギー。やがて私の一部として生きることができる	死生新精神私一部生	scene_28
Did you see it?	見えた？	見	scene_28
Yeah, I saw it.	おう、しっかり見たぜ	見	scene_28
…I saw it.	……見えたわ	見	scene_28
I…I saw it.	見、見た	見見	scene_28
…I saw it. Tseng was in bad shape.	よう見えましたわ。ツォンも、災難やったなぁ	見災難	scene_28
Oh grossness!	キモチワリィな～！		scene_28
An illusion the Ancients showed.	古代種が見せた幻影か……	古代種見幻影	scene_28
Hey hey! Wh, what's the catch?	おいおい！どんなシカケになってんだぁ？		scene_28
…Where is the room with the pictures on the walls?	……壁画の部屋はどこだ？	壁画部屋	scene_28
Almost there…	もうすぐ、ね		scene_28
Sephiroth is here, right?	セフィロスがいるんだな？		scene_28
No matter what he thinks, it's going to end here.	あいつが何を考えようとここで終わりだ	何考終	scene_28
I'm taking him out!	俺が倒す！	俺倒	scene_28
You mean WE are, right?	オレたちが、だろ？		scene_28
We're here too, you know.	私たちだっているわ	私	scene_28
Don't forget about us!	オイラを忘れるなよ！	忘	scene_28
I wonder if he'll go down that easy?	簡単に倒せんのやろか……	簡単倒	scene_28
I have nothing to do with it. But, I guess I'll lend a hand.	アタシは関係ないけどね。でも、ま、手をかしてやるよ	関係手	scene_28
All right! Guess you youngsters gotta be enthusiastic like that!	おっ、いいねえ！若いやつはそうじゃなきゃいけねえ	若	scene_28
Save	記録	記録	scene_28
Temple of the Ancients	時の大穴	時大穴	scene_28
I am the Time Guardian. Ye who seek the knowledge of the Ancients. I control the time, select your path.	我、時の番人なり。古代種の知識を求めるものよ。我が時を制し、道をきずけ	我時番人古代種知識求我時制道	scene_28
What is it you wish, seeker of knowledge?	知識求めるものよ、何をねがう？	知識求何	scene_28
Speed up time	時を進める	時進	scene_28
Go back in time	時をさかのぼる	時	scene_28
How fast would ye move time?	時の流れは、いかほどをのぞむ？」	時流	scene_28
Just a bit	ほんの少し	少	scene_28
A little more	そこそこに		scene_28
Plenty	たっぷりと		scene_28
Cancel	とりけし		scene_28
…It is time… You may proceed.	……時は満ちた……進むがよい	時満進	scene_28
[MENU]: Leave it up to the Guard	△ボタン：番人にまかせる	番人	scene_28
[OK]: Spin	○ボタン：ルーレット回転	回転	scene_28
[CANCEL]: Proceed now!	×ボタン：いまを進む！	進	scene_28
[OK]: Stop!	○ボタン：ストップ！		scene_28
[MENU]: Move it myself	△ボタン：自分で動かす	自分動	scene_28
[MENU]: Go back in time	△ボタン：時をさかのぼる	時	scene_28
[OK]: Speed up time	○ボタン：時を進める	時進	scene_28
This atmosphere…	このふんいきは……		scene_28
Feels like a battle!	バトルだな！		scene_28
Here it comes!	くるわ！		scene_28
It's a battle!	バトルやで！		scene_28
A battle…	戦いか……	戦	scene_28
Oh man! I should've stayed at home.	あ～あ！くるんじゃなかったよ		scene_28
I'm tingling with excitement.	オイラ、ムシャぶるい		scene_28
Let's do it!	やったるでい！		scene_28
Received "Nail Bat"!	『釘バット』を手にいれた！	釘手	scene_28
Received "Princess Guard"!	『プリンセスガード』を手にいれた！	手	scene_28
Received "Trumpet Shell"!	『法螺貝』を手にいれた！	法螺貝手	scene_28
Received "Megalixir"!	『ラストエリクサー』を手にいれた！	手	scene_28
Hey! It's locked.	あ！鍵かかってる	鍵	scene_28
No good. We have to catch it!	だめね。つかまえなきゃ！		scene_28
You must be tired.	いろいろ大変ね	大変	scene_28
I want to go home	帰りたいな	帰	scene_28
Just hang in there. Someday we'll look back on these hard times and laugh.	がまんがまん。こんな苦労話、笑って話せる時がくるよだから、がんばろ！	苦労話笑話時	scene_28
Yeah. But it'll all be over soon!	そうだね。でも、もうすぐだから！		scene_28
Received "Work Glove"!	『軍手』を手にいれた！	軍手手	scene_28
Door Unlocked!!	扉の鍵が開いた！！	扉鍵開	scene_28
The Guard that escaped with the key to the door moves on a set course.	扉の鍵を持ち逃げした番人は一定のルートを移動しています	扉鍵持逃番人一定移動	scene_28
Memorize the doors he enters and exits to figure out the pattern and catch him at an exit.	入る扉と出る扉の関係を覚え番人の出現位置をすいりしてつかまえてください	入扉出扉関係覚番人出現位置	scene_28
Oh yeah, oh yeah… you can jump down to the ramp below and to the left of the screen.	それからそれから画面左の段差からは下の段に飛びおりることができます	画面左段差下段飛	scene_28
It probably won't hurt if I jump from here...	ここなら飛び降りても痛くなさそうだな……	飛降痛	scene_28
Jump	ジャンプ		scene_28
Jump to the lower level with [OK]!	【○ボタン】で下の段へジャンプ！	下段	scene_28
This is the room with the murals…	ここが壁画の間……	壁画間	scene_28
Where are you!? Sephiroth!!	どこだ！？セフィロス！！		scene_28
So cold.	つめたいな		scene_28
I am always by your side.	私はいつでもおまえのそばにいる	私	scene_28
Come.	くるがいい		scene_28
Splendid.	まったく、素晴らしい	素晴	scene_28
A treasure house of knowledge…	知の宝庫……	知宝庫	scene_28
I don't understand what you're saying!	おまえが言ってることは意味不明なんだよ！	言意味不明	scene_28
Look well.	よく見ておくがいい	見	scene_28
At what!?	なにを！！		scene_28
At that which adds to the knowledge of…	古代種の知のあたえるもの	古代種知	scene_28
…Mother… …it's almost time.	……かあさん…。…もうすぐだよ		scene_28
Hey!! CLOUD!!	おい！！CLOUD！！		scene_28
Hey, CLOUD!	ねえ、CLOUD！		scene_28
CLOUD!	CLOUDっ！		scene_28
CLOUD! What are you doing?	CLOUD！なにやってんだ？		scene_28
CLOUD! What's going on with you?	CLOUDさん！どないしたんや！		scene_28
What the hell is going on?	どうなっちまってんだよ！		scene_28
What are you doing?	なにをしているのだ？		scene_28
Ha ha ha… Black Materia	クックックッ……黒マテリア	黒	scene_28
CLOUD!! Get a hold of yourself!	CLOUD！！しっかりしなさい！		scene_28
I… CLOUD…	俺……CLOUD……	俺	scene_28
Is this Meteor?	これがメテオか？		scene_28
Looks like we're locked in.	閉じこめられたようだ	閉	scene_28
Soon… we will become one.	もうすぐ……ひとつになれる		scene_28
How do you intend to become one with the Planet?	星とひとつになるってどうするつもり？	星	scene_28
It's simple.	簡単なことだ	簡単	scene_28
Once the Planet is hurt, it gathers Spirit Energy to heal the injury.	星は傷ができると治療のために傷口に精神エネルギーを集める	星傷治療傷口精神集	scene_28
The amount of energy gathered depends on the size of the injury.	傷の大きさに比例して集まるエネルギーの大きさが決まる	傷大比例集大決	scene_28
…What would happen if there was an injury that threatened the very life of the Planet?	……星が破壊されるほどの傷ができたらどうなる？	星破壊傷	scene_28
Think how much energy would be gathered!	……どれほどのエネルギーが集まる？	集	scene_28
Ha ha ha. And at the center of that injury, will be me.	フッフッフッ。その傷の中心にいるのが私だ。	傷中心私	scene_28
All that boundless energy will be mine.	エネルギーはすべて私のものだ	私	scene_28
By merging with all the energy of the Planet, I will become a new life form, a new existence.	星のすべてのエネルギーとひとつになり私は新たなる生命、新たなる存在となる	星私新生命新存在	scene_28
Melding with the Planet… I will cease to exist as I am now…	星とまじわり……私は…… 今は失われ、かつて人の心を支配した存在……	星私今失人心支配存在	scene_28
Only to be reborn as a 'God' to rule over every soul.	『神』として生まれ変わるのだ	神生変	scene_28
An injury powerful enough to destroy the Planet?	星が破壊されるほどの傷？	星破壊傷	scene_28
Injure…the Planet?	傷つける？　星を？	傷星	scene_28
Behold that mural. The Ultimate Destructive Magic…Meteor.	壁画を見るがいい。最高の破壊魔法……メテオ	壁画見最高破壊魔法	scene_28
That'll never happen!	そうはいかない！		scene_28
Wake up!!	目をさませ！！	目	scene_28
Where are you!? Sephiroth!!	どこだ！　セフィロス！-		scene_28
CLOUD! What's wrong!	CLOUDっ！どうしたんだよぅ！		scene_28
Ha ha ha… Call Meteor.	クックックッ……メテオよぶ		scene_28
How should I?	どうやるんだ…		scene_28
…I remember! I remember my way.	……思い出した！俺のやりかた	思出俺	scene_28
Mm? What's wrong? Is something wrong?	ん？　どうした。なんか変か？	変	scene_28
…It's nothing so don't worry about it.	……なんでもないから気にしないで	気	scene_28
It's nothing.”	なんでもないよね」		scene_28
Sephiroth got away.	逃げちゃったね、セフィロス	逃	scene_28
…Don't worry about it. I understood what he was saying.	……気にするな。あいつの言ってることはわかった	気言	scene_28
So this must be Meteor, right?	これがメテオだな？		scene_28
Is it some sort of a disaster?	なんかの災害か？	災害	scene_28
It looks like something's gonna fall from the sky.	空から何か降ってくるみてえだな	空何降	scene_28
Is something going to fall from the sky?	空から何か降ってくるの？	空何降	scene_28
Something's going to fall down?	何かおちてくるのかい？	何	scene_28
Oh, so something's going to fall from the sky?  It's going to be something big.	なんや空から、ふってくんねんな？そりゃ、えらいことや	空	scene_28
Something huge is falling from the sky?	空から巨大なものが落ちてくるのか？	空巨大落	scene_28
I don't know what it is but…	なんだか知らないけど	知	scene_28
It looks like it's going to make a mess…	ま、メチャクチャなことになりそうだね		scene_28
I don't know what the hell it is but it's falling from the sky?	なんだか知らねえが空から落ちてくるってことか？	知空落	scene_28
Hmpf! It's not even an omen.	ケッ！　縁起でもねえ	縁起	scene_28
…This must be magic. Just what Sephiroth was saying.	……魔法ね、これは。セフィロスが言ってたとおり	魔法言	scene_28
The Ultimate Destructive Magic, Meteor.	究極の破壊魔法メテオ	究極破壊魔法	scene_28
It finds small drifting planets with its magic.	宇宙をただよっている小さな星を魔法の力で呼びよせるの	宇宙小星魔法力呼	scene_28
And then collides with them. This Planet might get wiped out entirely…	そして……衝突。この星、完全に壊れちゃうかも……	衝突星完全壊	scene_28
Sephiroth!?	セフィロスか！！		scene_28
Ha ha ha… It is not me.	クックックッ……私ではない	私	scene_28
During the time when the Ancients prospered there existed beings that grew up bathed in abundant Mako.	かつて古代種がさかえたころ豊富な魔晄の光をあびて育った種族がいた	古代種豊富魔晄光育種族	scene_28
They were pure creatures of natural shape. Several remain even now.	自然な形の純すいなモンスターたちだ。いまでもいくつかの種族は残っている	自然形純種族残	scene_28
These beings sealed their consciousness within materia, altering their lives for eternity.	ある種族は、マテリアのなかに自らの命を封じこめ、生を永遠に変えた	種族自命封生永遠変	scene_28
The summon materia…	召喚のマテリア……	召喚	scene_28
Correct. Such a clever girl.	然り。理解のはやい娘だ	然理解娘	scene_28
The creatures that protect this temple have lived long, relics from the age of the Ancients.	この神殿を守るものは古代種の時代から時をこえ生きながらえてきたモンスター	神殿守古代種時代時生	scene_28
They belong to this planet even more than you do.	おまえたちよりもこの星にふさわしい種族たちだ-	星種族	scene_28
Heh heh heh… Keep that in mind.	クックックッ……思い知るがいい	思知	scene_28
Any sign of Sephiroth?	セフィロスの気配は？	気配	scene_28
He disappeared.	消えちゃったね	消	scene_28
Received "Bahamut" Materia!	『バハムート』のマテリアを手にいれた！	手	scene_28
What is this?	これはなんだ？		scene_28
…There's something written on it.	……何かかいてある	何	scene_28
B.l.a.c.k…M.a.t.e.r.i.a.	……ク・ロ・マ……テ・リ・ア		scene_28
Black Materia!!	黒マテリア！！	黒	scene_28
…Black Materia.	……黒マテリア	黒	scene_28
What should we do, CLOUD?	どうするの、CLOUD？		scene_28
Shake it	ゆらす		scene_28
Take it	とる		scene_28
Leave it	ほうっておく		scene_28
Wait a minute. I'll ask!	ちょっと待って。わたし、聞いてみる！	待聞	scene_28
I don't understand…	わからない……		scene_28
Really!?	そうなの！？		scene_28
They said that the Temple itself is the Black Materia.	この神殿そのものが黒マテリアだって	神殿黒	scene_28
If we could only move this, we could take the Black Materia.	これを動かせば黒マテリアを持ち出せる	動黒持出	scene_28
But, the Temple would collapse.	でも、神殿、くずれちゃうの	神殿	scene_28
Then just leave it.	おう！それならほっとこうぜ		scene_28
If we can't take it, then neither can Sephiroth, right?	誰にも持ち出せないならセフィロスだっておなじだろ？	誰持出	scene_28
Let's just leave it, OK?	そっとしておこうよ、ね？		scene_28
That'll be safer. If no one else can take it…	それなら安全だね。だれにも持ち出せない	安全持出	scene_28
Then Sephiroth can't either, right?	セフィロスだって同じなんだよね？	同	scene_28
The Ancients were a mean bunch. This way, no one'll be able to get it.	古代種さんも、イジワルやなぁ。まぁ、これやったらだぁれも持ち出されへんやろ	古代種持出	scene_28
I guess that means it's safe here.	ここにあれば安全というわけか	安全	scene_28
Let's just leave it and get the hell out of here!	こ、こんなもんほっといてはやく出よっ！	出	scene_28
Guess stuff this dangerous is best left alone?	こんな物騒なもんはほっとくに限るってやつじゃねえのか	物騒限	scene_28
No. We've got to think of a way to get it out.	ダメだ。持ち出す方法を考えよう	持出方法考	scene_28
Because Sephiroth has lots of different flunkies.	だって、そうだろ？セフィロスにはたくさんの分身がいるじゃないか	分身	scene_28
It's nothing to him to throw their lives away to get the Black Materia.	あいつら、命を投げ出して黒マテリアを手に入れるくらいなんでもない	命投出黒手入	scene_28
This place isn't safe.	この場所はもう安全じゃないんだ	場所安全	scene_28
So what are we going to do?	でも、どうするの？		scene_28
I heard your situation!	話、聞かせてもらいましたよ！	話聞	scene_28
Hi, CLOUD. This is CAIT SITH.	もしもし～　CLOUDさん。ボクです、CAIT SITHです～		scene_28
Don't forget about me.	ボクのこと忘れんといてほしいなぁ	忘	scene_28
Everything you said makes perfect sense!	CLOUDさんの言うてることはよぉ、わかります	言	scene_28
You can use my stuffed body for the future of the Planet.	この作りモンの身体星の未来のために使わせてもらいましょ	作身体星未来使	scene_28
We can't let Sephiroth get his hands on the Black Materia. And we can't let the Shinra get theirs on it either.	セフィロスに黒マテリアは渡せない。でも、神羅にも渡せない	黒渡神羅渡	scene_28
So that means you don't trust me?	ようは、信用でけんってことですな？	信用	scene_28
But CLOUD. There's really nothing else you can do.	でもなぁ、CLOUDさん。どないしようもないんとちゃうか？		scene_28
Everyone, please trust me.	まぁ、信じてみいな	信	scene_28
I guess we have no choice	わかった……仕方ない	仕方	scene_28
No way	信用できない	信用	scene_28
All righty then! Leave it all to me!	よっしゃ！ほんな、まかせてもらいましょか！		scene_28
You sure are stubborn, CLOUD.	CLOUDさん。あんたも、ガンコやなぁ～		scene_28
Everyone, hurry up and get outside!	みなさん、はよう外へ！	外	scene_28
I'll go with you to a safe place.	安全なとこまでいっしょに行きますから	安全行	scene_28
Please hurry, you've got to get out of here!	ほんな、みなさんはよう脱出してください！	脱出	scene_28
I'll be waiting at the exit!	出口のとこでまってますから！	出口	scene_28
Please believe me, CLOUD.	CLOUDさん、信じて～や	信	scene_28
Hmmm, I guess I have to	う～ん、仕方ないな	仕方	scene_28
How can I?	やっぱり信用できない	信用	scene_28
This must be it!	これやな！		scene_28
The Ancients sure did a great job making this.	古代種さんたちこんなシカケよう作りはったなぁ～	古代種作	scene_28
I can protect the Planet too! I'm kinda embarrassed…	ボクも、この星を守るんや！なんや、照れるなぁ……	星守照	scene_28
There's plenty of stuffed toys like my body around, but there's only one me!	このおんなじボディのんがようさんおるんやけどこのボクは、ボクだけなんや！		scene_28
Don't forget me even if another CAIT SITH comes along.	新しいCAIT SITHがなかまになってもわすれんといてな	新	scene_28
Good bye, then! I guess I'm off to save the Planet…	ほんな、行きますわ！しっかり、この星すくうんやで～！！	行星	scene_28
So, this whole building is the Black Materia?	だから、この大きな建物自体が黒マテリア、なんだって	大建物自体黒	scene_28
This huge Temple? This is the Black Materia!?	この、でかい神殿が？これが黒マテリア！？	神殿黒	scene_28
Then no one could take it.	それじゃあ、誰にも持ち出せないな	誰持出	scene_28
Hmm, it's pretty hard. You see this is a model of the Temple.	う～ん、むずかしいところね。ここにあるのは神殿の模型なの	神殿模型	scene_28
And inside it is a device, which gets smaller each time you solve a puzzle.	この模型には、しかけがあってパズルをといていくとどんどん模型が小さくなるんだって	模型模型小	scene_28
As the model becomes smaller, you become smaller too. Until it's small enough to fit in the palm of your hand.	模型、小さくなると、神殿自体も小さくなる。どんどん、おりたたまれていって、最後には手のひらにのるくらいにまで小さくなるの	模型小神殿自体小最後手小	scene_28
So, if we solve the puzzles, the Black Materia will get smaller and smaller and we can take it out?	つまり、この模型のパズルを解けば黒マテリアは小さくなって持ち出せるようになるわけだな？	模型解黒小持出	scene_28
Yes, but there's one thing…	そう、でもね……		scene_28
You can only answer the puzzles inside the Temple.	パズルを解くのは、この場所でしかできないの	解場所	scene_28
So, anyone who solves the puzzle will be crushed by the Temple.	だから、パズルを解くと、その人はこの神殿、いいえ、黒マテリア自体に押しつぶされちゃうの	解人神殿黒自体押	scene_28
I see… the Ancients didn't want dangerous magic to be taken out of the Temple so easily…	なるほど……危険な魔法を簡単に持ち出させないための古代種の知恵か……	危険魔法簡単持出古代種知恵	scene_28
I guess there's no way we can open it… We'll come back later.	開くわけないか…。あとまわしだな	開	scene_28
It's warm…	なまあたたかい…		scene_28
This isn't good…	やばいな……		scene_28
CLOUD… …behind you.	CLOUD…………うしろ		scene_28
Sorry to keep you waiting!! It's Me!!	おまちどうさん！！CAIT SITHです～！		scene_28
I'll handle the rest!	あとのことはまかせてもらいましょ！		scene_28
Well, everyone… Take care of yourselves!	ほんな、みなさんお元気で！	元気	scene_28
Come on, CLOUD… Say something.	ほら、CLOUD…。なにかいってあげなきゃ		scene_28
I'm not good at this.	……にがてなんだ		scene_28
Mmm, I understand. I feel the same too.	ん～、ようわかりますわ～ボクも同じような気持ちですわ	同気持	scene_28
Why don't you read our fortunes?	そうだ！ねえ、うらなってよ		scene_28
Say, that's right… I haven't done it in a while, huh?	そうやな～。それも、ひさしぶりですねぇ		scene_28
I'm so exited. Right or wrong, I'm still the same 'ol me	わくわくしますなぁ～当たるも～CAIT SITH当たらぬも～CAIT SITH	当当	scene_28
Now, what should I predict?	ほんな、なに占いましょ？	占	scene_28
Hmm, let's see how compatible CLOUD and I are!	そうねえ……。CLOUDとわたしの相性！	相性	scene_28
That'll cost ya. Exactly one date!	そりゃ、たこうつくで。デート１回やね！	回	scene_28
Here I go!	ほんな、やりまっせ！		scene_28
This isn't good. I can't say it.	こりゃあかんわちょっと、言えませんわ	言	scene_28
Poor TIFA.	TIFAさんにわるいわ		scene_28
No! Tell me!	ダメ！教えて！	教	scene_28
I promise I won't get mad!	ぜっ～たいおどろかないから		scene_28
Is that so? Then I'll tell you.	そうですか？ほんな、いいますよ		scene_28
Looks good. You are perfect for each other!	ええかんじですよ。おふたりの相性、ぴったりですわ！	相性	scene_28
AERIS's star and CLOUD's star! They show a great future!	AERISさんの星とCLOUDさんの星！すてきな未来が約束されてます！	星星未来約束	scene_28
CLOUD, I'll be your matchmaker, preacher… I'll do whatever you want me to!	CLOUDさんボク、司会でも仲人でもスパイでもなんでもしますわ～	司会仲人	scene_28
You just call me when it all happens!	そんときにはきっと、よんでくださいね		scene_28
Thank you for believing in me, knowing that I was a spy.	スパイのボクのこと信じてくれて、おおきに！	信	scene_28
This is the final, final farewell!	ほんまに、ほんまに……いってきます！		scene_28
Be strong CAIT SITH!!	がんばってCAIT SITH！！		scene_28
She told me to 'Be strong.' I feel so happy.	がんばって、やって。なんや、うれしいなぁ～		scene_28
Owwww…	いててて……		scene_28
What happened?	どないなったんやろ？		scene_28
I can still move more.	まだ動けるようやな	動	scene_28
That's the Black Materia…	あれが、黒マテリア……	黒	scene_28
Hey! I'll keep watch here!	おう！オレはここでみはってるぜ！		scene_28
I'll wait here.	私、ここでまってるね	私	scene_28
I'll be sittin' out here.	おいら、ここでおすわりしてるよ		scene_28
Heh heh…this looks majorly boring, so I'll stay here.	エヘヘ……興味ないからここにいるよ	興味	scene_28
I'm gonna have a smoke out here!	ここでいっぷくしてるぜ！		scene_28
Ahhh!! It's really something, having a smoke at a place like this.	クッ～！！こういうとこでいっぷくすんのはたまんねえ～！		scene_28
I'll be looking around here.	私はここで見物していよう	私見物	scene_28
Got Key Item "Black Materia!"	キーアイテム『黒マテリア』を手にいれた！	黒手	scene_28
As long as we have this, Sephiroth won't be able to use Meteor.	これを俺たちが持ってるかぎりセフィロスはメテオを使えないってわけだ	俺持使	scene_28
Can you guys use it?	俺たちは使えるのか？	俺使	scene_28
Nope, we can't use it right now. You need great spiritual power to use it.	ダメ、今は使えない。とっても大きな精神の力が必要なの	今使大精神力必要	scene_28
You mean lots of spiritual energy?	たくさんの精神エネルギーってことか？	精神	scene_28
That's right.	そう、ね		scene_28
One person's power alone won't do it.	ひとりの人間が持ってるような精神エネルギーじゃダメ	人間持精神	scene_28
Somewhere special. Where there's plenty of the Planet's energy…	どこか特別な場所。星のエネルギーが豊富で……	特別場所星豊富	scene_28
The Promised Land!!	約束の地！！	約束地	scene_28
The Promised Land!!	約束の地だな！！	約束地	scene_28
No, but…	いや、しかし……		scene_28
Sephiroth is different. He's not an Ancient.	セフィロスは、ちがう。古代種じゃない	古代種	scene_28
He shouldn't be able to find the Promised Land.	約束の地は見つけられないはずだ	約束地見	scene_28
…Ah, but I have.	……が、私は見つけたのだ	私見	scene_28
I'm far superior to the Ancients.	私は古代種以上の存在なのだ	私古代種以上存在	scene_28
I became a traveler of the Lifestream and gained the knowledge and wisdom of the Ancients.	ライフストリームの旅人となり古代の知識と知恵を手に入れた	旅人古代知識知恵手入	scene_28
I also gained the knowledge and wisdom of those after the extinction of the Ancients.	古代種滅びし後の時代の知恵と知識をも手に入れた	古代種滅後時代知恵知識手入	scene_28
And soon, I will create the future.	そしてまもなく未来を創り出す	未来創出	scene_28
I won't let you do it! The future is not just yours!	そんなこと、させない！未来はあなただけのものじゃない！	未来	scene_28
Ha, ha, ha…I wonder?	クックックッ……どうかな？		scene_28
Wake up!	さあ、目をさませ！	目	scene_28
Sh…shut up!	だ、だまれ！		scene_28
The…noise…	う……うるさ……い……		scene_28
No!	『だ～めだよぅ！』		scene_28
Don't be afraid--!	『こわがっちゃだめー！』		scene_28
Waaaa~!!	『うわ～ん！！』		scene_28
What are you doing!?	『なにすんだよぅ～！！』		scene_28
There, CLOUD…good boy.	さあ、CLOUD……良い子だ	良子	scene_28
Wa…aaaa…aaa…	う……あ……ぁ……		scene_28
Gave "Black Materia" to Sephiroth!	『黒マテリア』をセフィロスに手わたした！	黒手	scene_28
…Well done.	……ごくろう		scene_28
CLOUD, are you all right?	CLOUD、だいじょぶ？		scene_28
…I gave the Black Materia to Sephiroth?	……俺はセフィロスに黒マテリアを……？	俺黒	scene_28
Wha…what did I do? Tell me, AERIS.	お、俺はなにをしたんだ……AERIS、教えてくれ	俺教	scene_28
CLOUD…be strong, OK?	CLOUD……しっかり、ね？		scene_28
Urrrrrrgh… What have I done!?	ウヘヘヘヘ……俺はなにをした！	俺	scene_28
CLOUD… you haven't done anything.	CLOUD……あなた、なにもしていない		scene_28
It's not your fault.	あなたのせいじゃない		scene_28
I…I'm---!	俺は！　俺はーーーっ！	俺俺	scene_28
CLOUD!!	CLOUDー！！		scene_28
CLOUD, what are you doing!?	CLOUD、何してるの！？	何	scene_28
Urrggggggh!!!! CLOUD!!	んがーー！！！CLOUD！！		scene_28
HEY! CLOUD, you #$#&@!	おい！　CLOUDてめえ！		scene_28
CLOUD!!	CLOUDっ！！		scene_28
AERIS, are you all right!?	AERIS、だいじょうぶ！？		scene_28
What!? CLOUD!	おろっ！？CLOUD！		scene_28
AERIS! CLOUD, what're you doing!?	AERIS！CLOUD、なにやってんだよっ！		scene_28
…!!	……！！		scene_28
Hey, EY!!	おいおいっ！！		scene_28
CLOUD! What the hell are you doing!?	こらっ、CLOUD！なんてことしてんだよ、てめえは！		scene_28
Oops! This looks like a bad time!	こりゃあかん！えらいときにきてしもた！		scene_28
I'm CAIT SITH No. 2. Right pleased to meet you all!	ボク、CAIT SITH２号機です～。よろしゅうたのんます～！	号機	scene_28
I'm CAIT SITH No. 2. Pleased to meet you all!	ボク、CAIT SITH２号機です～。なかようしてください～！	号機	scene_28
CLOUD!! What are you doin'!!	CLOUDさん！！なにしとんや！！		scene_28
Everything is white…	まっしろだ……		scene_28
What did I do? I don't remember anything…	俺はなにをした？おぼえていない…	俺	scene_28
My memory…since when? If everything's a dream, don't wake me.	記憶…いつからなのか…？すべてが夢ならさめないでくれ	記憶夢	scene_28
I'm far superior to the Ancients.	私は古代種以上の存在なのだ。	私古代種以上存在	scene_28
CLOUD… you haven't done anything.	CLOUD…… あなた、なにもしていない。		scene_28
Oops! This looks like a bad time!	あかん！　こりゃ たいへんなときにきてしもたわ！		scene_28
I'm CAIT SITH No. 2. Pleased to meet you all!	ボク、CAIT SITH>２号機です～。ほな、よろしゅうたのむわ～！	号機	scene_28
I'm CAIT SITH No. 2. Pleased to meet you all!	ボク、CAIT SITH２号機です～。なかよくしてな～！！	号機	scene_28
CLOUD!! What are you doin'!!	CLOUDさん！！なにしてまんねん！！		scene_28
CLOUD, can you hear me?	CLOUD、わかる？		scene_28
Yeah, I hear you. Sorry for what happened.	ああ、わかるよ。さっきはすまなかったな		scene_28
Don't worry about it.	気にしないほうがいいよ	気	scene_28
…I can't help it…	……そんなのムリだ		scene_28
Oh…	そっか……		scene_28
Then, why don't you REALLY worry about it?	じゃ、思いっきり気にしちゃえば？	思気	scene_28
And let me handle Sephiroth.	セフィロスのこと、わたしにまかせて		scene_28
And CLOUD, you take care of yourself.	そして、CLOUDは自分のこと考えて	自分考	scene_28
So you don't have a breakdown, okay?	自分が壊れてしまわないように、ね？	自分壊	scene_28
What is this place?	ここは……どこだ？		scene_28
This forest leads to the City of the Ancients… and is called the Sleeping Forest.	この森は【古代種の都】へつづく……【眠りの森】と呼ばれている	森古代種都眠森呼	scene_28
It's only a matter of time before Sephiroth uses Meteor.	セフィロスがメテオを使うのは時間の間題	使時間間題	scene_28
That's why I'm going to protect it. Only a survivor of the Cetra, like me, can do it.	だから、それを防ぐの。それはセトラの生き残りのわたしにしかできない	防生残	scene_28
The secret is just up here.	その秘密、この先にあるの	秘密先	scene_28
At least it should be. …I feel it. It feels like I'm being led by something.	ううん……あるはず。そう、感じるの。何かに導かれている感じ、するの	感何導感	scene_28
Then, I'll be going now. I'll come back when it's all over.	じゃ、わたし、行くね。全部終わったらまた、ね？	行全部終	scene_28
AERIS?	AERIS？		scene_28
Hmm… So she's going to interfere? She'll be a difficult one, don't you think?	おやおや……私たちの邪魔をする気のようだ。困った娘だと思わないか？	私邪魔気困娘思	scene_28
We must stop that girl soon.	そろそろあの娘にも…	娘	scene_28
[Empty Entry]	万年前の地層	万年前地層	scene_28
[Empty Entry]	ルナハープゲット		scene_28
You look like you was havin' a nightmare.	うなされていたみたいだな		scene_28
How are you feeling?	調子はどうだ？	調子	scene_28
I seem to be OK	いいみたいだ		scene_28
Not good	わるい		scene_28
Don't really know	よくわからない		scene_28
That's good. Man, I didn't know what was gonna happen.	そりゃ、良かったな。まったく、どうなることかと思ったぜ	良思	scene_28
Oh… Better keep it to yourself.	そうか……でもよ、そうも言ってらんねえぜ	言	scene_28
I guess that's right. Well, don't worry too much about it.	そんなとこだろうな。ま、あんまり悩まねえこった	悩	scene_28
You know, CLOUD. AERIS is gone.	あのね、CLOUD。AERISがいなくなっちゃったの		scene_28
Everyone's out looking for AERIS.	みんなはAERISを探しに行ってる	探行	scene_28
…The City of the Ancients. AERIS is headed there.	……古代種の都。AERISはそこに向かっている。メテオを防ぐ手段があるらしいんだ	古代種都向防手段	scene_28
By herself!? Why did she go by herself!?	AERISが一人で！？なんだって一人で行っちまうんだよ！	一人一人行	scene_28
Hey, we're goin' too.	おい、オレたちも行くぞ	行	scene_28
Only the Ancients, only AERIS can save us from Meteor…	メテオを防ぐことができるのは古代種……AERISだけだ	防古代種	scene_28
Then we must go. What'll we do if something happens to AERIS? If Sephiroth finds her, she's in trouble.	それならなおさらよ。AERISにもしものことがあったらどうするの？セフィロスが気づいたら大変よ	気大変	scene_28
Sephiroth…already knows.	セフィロスは……もう、知っている	知	scene_28
Hey! Why are you still sittin' around?	おい！おまえ、なんだってチンタラしてるんだ？		scene_28
No.	いやだ		scene_28
I might lose it again.	俺、またおかしくなるかもしれない	俺	scene_28
If Sephiroth comes near me I might…	セフィロスがそばに来ると俺はまた……	来俺	scene_28
Yeah, godammit! It's because of you that Sephiroth got the Black Materia in the first place. It's your damn fault!	ああ、そうだよ。おまえのせいでセフィロスは黒マテリアを手に入れたんだ。責任を取れ！	黒手入責任取	scene_28
My fault?	責任？	責任	scene_28
I know you got problems… Hell, we all do. But you don't even understand yourself.	おまえはよ、なるほどいろんな間題を抱えてるんだろうさ。自分のことよくわかんねえんだもんな	間題抱自分	scene_28
But you gotta understand that there ain't no gettin' offa this train we're on, till we get to the end of the line.	でもよ、CLOUD。オレたちが乗っちまったこの列車はよ、途中下車はナシだぜ	乗列車途中下車	scene_28
CLOUD, we came this far… Aren't you going to settle up with Sephiroth?	CLOUD、ここまで来たのよ……セフィロスと決着をつけるんでしょ？	来決着	scene_28
Goddamn jackass, that's what you are…	しょうがねえやつだぜ……		scene_28
Just think about it… How many people in this world do ya think really understand themselves?	あのな、考えてみろよ。自分のこと、全部わかってるやつなんて世の中に何人いると思ってんだ？	考自分全部世中何人思	scene_28
People get depressed in life because they don't know what's up.	誰だって、わけわかんねえからあ～だこ～だ、なやむんだろ？	誰	scene_28
But, they go on living. They don't run away… That's just how it is.	それでもみんななんとか生きてる。逃げ出したりしないでよう。そういうもんじゃねえのか？	生逃出	scene_28
CLOUD…you'll come with us, right? I believe in you.	CLOUD……来てくれるよね。私、信じてるから	来私信	scene_28
No…	いやだ……		scene_28
I'm afraid. If this keeps up, I may go crazy!	俺は、怖いんだ。このままじゃ、俺は俺でなくなってしまうかもしれない	俺怖俺俺	scene_28
I'm afraid…	怖いんだ……	怖	scene_28
What…am I supposed to do?	俺は……どうしたらいい？	俺	scene_28
Just pull out of here?	ここから引き返す？	引返	scene_28
To where?	引き返す？　……どこへ？	引返	scene_28
Wait a minute, TIFA. give him a little time.	待ちな、TIFA。しばらく時間をやろうぜ	待時間	scene_28
He has to decide this on his own.	これは、あいつが自分自身で決着をつけなきゃならねえことだ	自分自身決着	scene_28
You believe in CLOUD… right?	信じてるんだろ、CLOUDを	信	scene_28
You awake?	気がついたのかい？	気	scene_28
Those people were so worried that they stayed by your side until you woke up.	あの人たち、えらく心配してあんたが気づくまで、ずっとそばにいたよ	人心配気	scene_28
You sure do have good friends.	いい友人を持ったね	友人持	scene_28
Hey, how are you?	よう、どうだ？		scene_28
I just wanna know, which is it gonna be?	ちょっと、聞いときたいんだけどよおまえはどっちなんだ？	聞	scene_28
You wanna find out about yourself? Or are you afraid to find out?	自分のこと、もっと知りたいのか？それとも、知るのが怖いのか？	自分知知怖	scene_28
Either way, if you stay around here all you're gonna do is worry about it.	ま、どっちにしても、ここにいたってなやんで頭かかえてるしかねえぞ	頭	scene_28
Even if you do go nuts again when you see Sephiroth… If it happens, it happens.	もし、セフィロスと会ってよまた、おまえがおかしくなっちまったらそん時はそん時だぜ	会時時	scene_28
I'll go upside your spikey head and bring you back to normal!	オレがぶんなぐって正気にもどしてやるからよ！	正気	scene_28
CLOUD, it'll be all right. We're all with you.	CLOUD、大丈夫よ。みんながついてるじゃない	大丈夫	scene_28
But…	……でも		scene_28
If it happens, it happens. Don't worry 'bout it.	ま、なるようにしかならねえぜ。ウジウジなやむな		scene_28
…You're…right. He's right, isn't he?	……そう……だな。……そう……だよな？		scene_28
Come on, let's go and find AERIS.	さあ、AERISを探しに行きましょう？	探行	scene_28
…I'm afraid to find out the truth. But…why?	……俺は、真実を、知るのが、怖い……？でも……それは……なぜだ？	俺真実知怖	scene_28