Welcome to Bone Village, a town for nature lovers.	ようこそ、自然主義者の村。ボーンビレッジへ	自然主義者村	scene_29
What do you want?	何か用かな？	何用	scene_29
Where is the City of the Ancients?	古代種の都はどこだ？	古代種都	scene_29
Do you know where AERIS is?	AERISを知らないか？	知	scene_29
What are you doing?	何をしている？	何	scene_29
Have you seen Sephiroth?	セフィロスを見かけたか？	見	scene_29
Oh, the man in a black cape. He was looking for the Temple of the Ancients.	ああ、黒い服の男か。古代種の神殿をさがしていたな	黒服男古代種神殿	scene_29
The Temple of the Ancients?	古代種の神殿？	古代種神殿	scene_29
Thanks	ありがとう		scene_29
It's way down south. It's on the other side of this town and the inland sea.	ずうっと南に行ったところだ。ちょうどこの村と内海をはさんで反対がわだよ	南行村内海反対	scene_29
It's the pyramid rising out of the forest.	森の中にそびえるピラミッドさ	森中	scene_29
How do you get in?	どうやって中にはいる？	中	scene_29
That's enough	もういい		scene_29
You'll need the Keystone.	キーストーンがないとダメさ		scene_29
What's a Keystone?	キーストーンって？		scene_29
Oh, yeah, I know	ああ知っている	知	scene_29
Just like it sounds. A rock that's a key. I heard that some rich guy has it.	文字通りカギとなる石さ。どこかの金持ちが持っているって話だな	文字通石金持持話	scene_29
Are you going to run away??	逃げないのか？？	逃	scene_29
Through fossils, we already know everything that happened on this Planet since the beginning.	僕たちはこの星の始まりから今にいたるまでを化石を通して知ってきた	僕星始今化石通知	scene_29
Now, we want to see the rest on to the end of the Planet… It's a mixed feeling…	そして今、この星の終わりを見届けようとしている……なんだか複雑な気持ちだよ	今星終見届複雑気持	scene_29
The City of the Ancients? Oh, you must mean the Forgotten City.	古代種の都？ああ、忘らるる都のことだな	古代種都忘都	scene_29
Are you talking about that girl? I warned her, but she went into the Sleeping Forest anyway.	あの女の子のことか？俺はやめろと言ったのに【眠りの森】に入っていったんだ	女子俺言眠森入	scene_29
Excavating is great. It's like a history of the Planet told in the land.	化石をほっているのさ。大地が語る、この星の歴史……	化石大地語星歴史	scene_29
This town's motto is not to think about anything.	この村のルールは何も考えないこと	村何考	scene_29
Just live. Eat, work, and sleep.	ただ、生きる。喰って、畑仕事して、ねる	生喰畑仕事	scene_29
It's pretty hard not to think about anything.	何も考えないのはけっこう、むずかしい	何考	scene_29
Want to buy something?	なにか買ってくかい？	買	scene_29
I want the Lunar Harp	ルナ・ハープが欲しい	欲	scene_29
Don't want anything	何もいらない	何	scene_29
Thanks! Now, the forest will awaken.	まいど！これで森の目もさめるよ	森目	scene_29
The Lunar Harp is somewhere in the ground here. We could excavate it for you if you want us to.	ルナ・ハープはこの土地の地下にねむっている。ハックツして欲しいのならうけおうぜ	土地地下欲	scene_29
Start diggin'	ハックツをたのむ		scene_29
I want to buy something	かいものをしたい		scene_29
Not right now	今は用はない	今用	scene_29
Other than the Lunar Harp, What else do you want us to dig for?	ルナ・ハープだけがハックツ対象じゃないぜ。どれをハックツする？	対象	scene_29
Lunar Harp	ルナ・ハープ		scene_29
Good treasure	ちょっといい宝	宝	scene_29
Normal treasure	普通の宝	普通宝	scene_29
This has already been excavated.	そりゃもうハックツずみさ		scene_29
All right! Then I'll lend you some of my staff. Show us where you want us to dig!	よし！じゃあ、俺のスタッフをかしてやろう。ハックツポイントを指定してくれ！	俺指定	scene_29
Everything already excavated is in the box next to the tent.	ハックツ品は上のテントわきのハコの中にあるぜ	品上中	scene_29
The memory of this planet is buried layer by layer in this geological stratum. Kind of romantic, don't you think?	この地層に星の記憶が積み重ねられているのよ。ロマンを感じるでしょ？	地層星記憶積重感	scene_29
The forest just beyond here is called the Sleeping Forest. Right now the forest is asleep. Anyone who wanders in while it's asleep, gets confused. You can go in, but you may never come out…	この先の森は【眠りの森】とよんでる。森が眠り、まどろんでいる間はそこに迷いこんだ人間を惑わすと言われています。入ったら二度と出られないとも……	先森眠森森眠間迷人間惑言入二度出	scene_29
But just now, a girl in pink and a man in a black cape went in. You think they'll be all right?	でもさっき、ピンクの女の子と黒い男の人が入っていったわ。だいじょうぶかしら？	女子黒男人入	scene_29
You can awaken the Sleeping Forest if you have the Lunar Harp.	ルナ・ハープという楽器があれば【眠りの森】は目をさますはず	楽器眠森目	scene_29
Once awake, they say the forest will open a road for you.	目をさませば、森は道をひらくと言われています	目森道言	scene_29
The girl in pink who just went in used a Lunar Harp to get through.	さっききたピンクの女の子もルナ・ハープをつかって森を抜けたんだ	女子森抜	scene_29
I want a Lunar Harp	ルナ・ハープがほしい		scene_29
Ask the guy in the tent below.	下のテントにいる男に聞いてな	下男聞	scene_29
We use the newest system to find buried treasure. We use bombs to make earthquakes, and then check the sound waves given off by the tremors.	私たちは最新のシステムで地下に埋まっているものを発見するの。爆弾で人工的に地震をおこしその振動の反射をそくていするのね	私最新地下埋発見爆弾人工的地震振動反射	scene_29
Please push [SWITCH] to set staff in position.	□ボタンを押してスタッフの配置場所を決めてください。	押配置場所決	scene_29
Order a search (100 gil)	調査を指示（１００ギル）	調査指示	scene_29
Could not position the staff, due to a lack of funds.	お金がたりないので配置しませんでした。	金配置	scene_29
Press [SWITCH] to ignite the bomb for the search.	□ボタンを押せば調査用の爆弾が 地中で爆発します。	押調査用爆弾地中爆発	scene_29
The staff member will calculate the tremors and dig up the buried item.	各スタッフは爆発の反動を計算し 目的のまいぞう物の方向を指し示します。	各爆発反動計算目的物方向指示	scene_29
The dig point is where the staff's line of vision meets.	つまりスタッフの視線が交わった ポイントがハックツポイントです。 	視線交	scene_29
Move to the dig point and press [SWITCH] to select. The staff will dig for the item.	地下調査する地点まで移動し□ボタンで 決定してください。穴をほって調査します。 ？？？	地下調査地点移動決定穴調査	scene_29
Now, the staff will dig here. The result will be placed in the treasure box overnight.	ではこの地点をほります。一晩ねれば、結果が村のたからばこに入れられます	地点一晩結果村入	scene_29
Excavating is a slow process. The treasures we excavate are stored in the box next to the tent. Remember that.	ハックツってのは地道な作業だよ。俺たちがほりおこした宝物はテントの横のハコにしまっておくんだ。おぼえておきな	地道作業俺宝物横	scene_29
It, it's scary…	や、やっぱりコワイ……		scene_29
Just a while ago, a young girl asked me the same things.	すこし前に、若い娘さんがこうやってなんか話してたんだ	前若娘話	scene_29
Then the entrance to the forest made a funny sound, like 'Grrrrrrgh!'.	そしたらどうだい森の入り口がガーッって開いたんだよ	森入口開	scene_29
I thought that maybe I could do it, too.	おれにもできないかと思ってさ	思	scene_29
Please, let me in!	おねがい、わたしを入れて！	入	scene_29
While ago, a man in black came and said this as he went into the forest.	すこし前にな、黒い服の男がこうやって森の中に入っていったんだよ	前黒服男森中入	scene_29
Nnnnnnghaah!	ぬぉぉぉおおお！		scene_29
The Sleeping Forest awoke…	眠りの森がめざめた……	眠森	scene_29
This place…!	ここは……！		scene_29
So that's……the capital of the Ancients The Forgotten City'.	あれが……古代種の都『忘らるる都』なのか	古代種都忘都	scene_29
AERIS is in that 'City'.	あの『都』にAERISはいる……	都	scene_29
…Ugh.	……ウッ		scene_29
…Words of the Ancients?	……古代種の言葉？	古代種言葉	scene_29
…No good. I can't understand.	……ダメだ。おれには、わからない		scene_29
…Ugh, again?	……ウッ、またか		scene_29
This stream of consciousness… Could this be the words of the Ancients…?	意識に流れこんでくる…………古代種の言葉なのか？	意識流古代種言葉	scene_29
Eyaaaa!	キャッ！？		scene_29
…Consciousness of the Ancients?	……古代種の意識？	古代種意識	scene_29
…I'm sorry. …I can't…understand.	……ごめんなさい。……私には……わからない	私	scene_29
Eaayy!? Again?	キャッ！？また？		scene_29
It speaks directly to my mind… Is this the Consciousness of the Ancients?	頭に直接語りかけてくる……これは、古代種の意識？	頭直接語古代種意識	scene_29
Whoa…!	おわっ！		scene_29
What the hell's this?	なんでぃ、こりゃ？		scene_29
Hey Ancients, I don't even have a clue what you're trying to say to me.	古代種さんよぉオレ様には、あんたが何言いたいのかさっぱりわかんねえぜ	古代種様何言	scene_29
Whoa, @#$%! Not again!	うわっち！またかよ、おい		scene_29
Who is it? Who's trying to peek into my mind?	誰だ？　オレ様の頭を のぞこうとするのは？	誰様頭	scene_29
Is it the Consciousness of the Ancients?	まさか、古代種の意識が？	古代種意識	scene_29
Hey, there's a bed.	おっ、ベッドがあるぜ		scene_29
Do you think the people who used to live here used it?	ここに住んでいた人たちが使っていたものかしら？	住人使	scene_29
Look, there's a bed here.	あっ、ベッドがあるよ		scene_29
Yeah, and it looks pretty comfortable.	おっ、意外と心地よさそうなベッドじゃねぇか	意外心地	scene_29
How COOL! I can't believe we found such a soft bed in a dive like this.	ラッキ～、こんなところにベッドがあるなんて～		scene_29
We're in luck. There's a bed in here.	こら、運がええですわ。ええとこにベッドがあります	運	scene_29
I wonder if the owners used this?	ここの住人が使っていたものか？	住人使	scene_29
Yo, CLOUD. Let's take a break here.	よぉ、CLOUD。ここいらで一服しようぜ	一服	scene_29
Shall we take a break here?	ひと休み、していきましょうか？	休	scene_29
Hey, let's rest a bit. I'm tired…	ねぇ、休んでいこうよ。オイラ、つかれちゃった	休	scene_29
I'm beat. Why don't we get some rest?	つかれもたまってきたしちっと休んでいかねぇか？	休	scene_29
Come on--, let's rest for a while--- I don't want to walk anymore…	ねぇ～、休もうよ～あたい、もう歩きたくな～い	休歩	scene_29
Why don't we catch some ZZZs?…	CLOUDさん、ひとねむりしませんか？		scene_29
Maybe we should take a short nap?	ひとねむり、するか？		scene_29
Here's a bed.	ベッドがある。		scene_29
Get some rest?	休んでいきますか？	休	scene_29
I feel it…	感じる……	感	scene_29
AERIS is here. …and so is Sephiroth.	ここに、AERISがいる……そしてセフィロスも		scene_29
…It's not an excuse. I feel it in my soul.	……りくつじゃない。感じるんだ、おれの心が	感心	scene_29
CLOUD, what is it?	CLOUD、どうした？		scene_29
CLOUD…what's wrong?	CLOUD……どうしたの？		scene_29
What's wrong? Are you sick?	どうしたんだい？気分でも悪いの？	気分悪	scene_29
Do you know what TIME it is!?	おい、何時だと思ってんだよ！	何時思	scene_29
Hey---, CLOUD. What's your problem?	あれ～、CLOUD。どしたの？		scene_29
What's wrong? What time is it…?	どないしたんですかぁ～。こないな時間に～	時間	scene_29
…What's wrong?	……どうした？		scene_29
Wh, what! Sephiroth!?	な、なんだって！セフィロスが！？		scene_29
You're saying it's not just AERIS, but Sephiroth, too?	AERISだけではなくセフィロスまでいるというの？		scene_29
What! Sephiroth's here too!?	え！　セフィロスまでいるの！？		scene_29
Wa, wa, wait a minute. You serious!?	おいおい、ホントかよ！		scene_29
No way---! Sephiroth wasn't invited!	うっそ～！セフィロスなんてお呼びじゃないのに～	呼	scene_29
Are you serious, CLOUD!?	ほ、ほんまですか？CLOUDさん！？		scene_29
…If that's true, then we're in for it.	……それが本当なら、まずいな	本当	scene_29
How do you know that?	しかし、なんでそんなことがわかるんだ？		scene_29
But how can you tell?	でも、どうしてそんなことがわかるの？		scene_29
How did you find out?	どうしてわかったんだい？		scene_29
Hey, how do you know!?	でもよぉ、なんでそんなことがわかるんだ！？		scene_29
Wh…why? How can you tell that kind of stuff?	ど、どーして？どーしてそんなことがわかっちゃうわけ？		scene_29
But how can you tell that?	でも、なんでそんなんがわかるんですか？		scene_29
…How did you find that out?	……なぜわかった？		scene_29
Then, we better get up offa our lazy asses!!	まずいぜ、それじゃ！のんきにねてる場合じゃないぞ	場合	scene_29
If that's true, then we've got to hurry! We've got to get to AERIS!	それが本当なら、急がなきゃ！はやくAERISを！	本当急	scene_29
Wh,…what should we do? We must hurry to her!	ど、どうしよう？急がないと、大変なことになるよ！	急大変	scene_29
@#$$, CLOUD. We can't be sittin' around on our asses.	やべぇぞ、CLOUD。のほほんとしてる場合じゃ、ねぇな	場合	scene_29
That means it's pretty bad …doesn't it?	それって、ちょーマズいんじゃない？		scene_29
If that's true, then we're in for it! We have to find AERIS fast!	それが、ほんまやったらえらいことや！はよAERISさん見つけんとあかんわ	見	scene_29
If that's true, we should hurry. Something terrible could happen at any moment.	それが本当なら、急ぐべきだ。取り返しのつかないことになる。	本当急取返	scene_29
…Right. Let's hurry and find AERIS.	……ああ。はやくAERISをさがそう		scene_29
No time to be sleeping.	ねている場合じゃない	場合	scene_29
No time to think about it.	調べているヒマはない	調	scene_29
AERIS's voice…… Coming from there?	AERISの声の聞こえた方向……あっちか？	声聞方向	scene_29
We have to find AERIS.	AERISをさがさなくては		scene_29
Hey yo! Wait up.	お、おい。ちょっと待ってくれ	待	scene_29
I hate to say it, but I'm beat. Isn't there anywhere to rest.	情けねぇが、つかれちまった。どっかひとねむりできる場所をさがそうぜ	情場所	scene_29
Hey, hey CLOUD.	ち、ちょっとCLOUD		scene_29
I'm…I'm so tired. Can't we find somewhere to rest?	わ、わたし、つかれちゃった。どこか、休める場所を探さない？	休場所探	scene_29
Wait!	ま、待ってよ	待	scene_29
I'm exhausted. Let me get some rest somewhere.	おいら、もうヘトヘトだよ。どっかで、ひとやすみさせてよ		scene_29
H…ey, CLOUD	お……おい、CLOUD		scene_29
I gotta get some more rest. Let me catch a snooze somewhere around here.	はずかしながら、つかれちまったぜ。どっかで、ちょいと眠らせてくれや	眠	scene_29
Ahhh--- I can't go another step!!	あ～、もーっ嫌っ！！	嫌	scene_29
I'm so----o tired! If you don't get me to a bed, I'm not taking another step!	アタイ、つかれちゃったよ～！あたたかいベッドで眠らせてくんないともう、一歩も動かないからね！	眠一歩動	scene_29
Wa------it!	ち、ちょっと待ってぇ～な	待	scene_29
I'm exhausted. I'm sorry, but please let me rest somewhere.	わて、つかれてしまいましたわ。すまんけど、どっかで休ませておくれな	休	scene_29
Wait, CLOUD.	待て、CLOUD	待	scene_29
…I'm tired.	……つかれた		scene_29
That way goes to the Mountains up north. Let's hurry and find AERIS.	そっちの方角へ行くと北の山に出ちまうぜ。はやくAERISをさがそうぜ	方角行北山出	scene_29
If we continue this way, we'll end up in the Northern Mountains. AERIS isn't over there, right?	そのまま進むと、北の山に出るわ。AERISはそっちにはいないんじゃないの？	進北山出	scene_29
That road leads to the Northern Mountains. We have to go the other way to find AERIS.	そっちは、北の山に行く道だよ。AERISさがすの、方向ちがうよ	北山行道方向	scene_29
You thinkin' of going skiing? If we wanna find AERIS, we go THAT way!	雪山でスキーでもするつもりか？AERISさがすんならそっちじゃないだろ、え！	雪山	scene_29
We're looking for AERIS, right! Then why are you heading for the mountains!? What a dork!	AERISさがすんでしょ！雪山の方行って、ど～すんの！サイテ～！	雪山方行	scene_29
CLOUD, uh that's the road to the Northern Mountains.	CLOUDさんそっちは北の山へ行く道やで	北山行道	scene_29
AERIS is waiting, let's go find her.	AERISさんが待ってますんや。はよ、さがしにいきましょ	待	scene_29
This is the road to the Northern Mountains. Don't you want to find AERIS?	これは北の山へ向かう道。AERISをさがすのはもうあきらめたのか？	北山向道	scene_29
Stop!	やめて！		scene_29
Please stop that!	何をするんだ！	何	scene_29
What're you doing!	なにしとんや！！		scene_29
Sto----p!	ストーーップ！		scene_29
Dumb #^%@!	バカッ！		scene_29
Stop it!	やめろ！		scene_29
Ugh…what are you making me do?	クッ……俺に何をさせる気だ	俺何気	scene_29
…stay…back…	……来ない……で	来	scene_29
…AERIS.	……AERIS		scene_29
This can't be real!	……ウソだろ？		scene_29
Do not worry. Soon the girl will become part of the Planet's energy.	気にすることはない。まもなくこの娘も星をめぐるエネルギーとなる	気娘星	scene_29
All that is left is to go North. The 'Promised Land' waits for me over the snowy fields.	私の寄り道はもう終わった。あとは北を目指すのみ。雪原の向こうに待っている『約束の地』	私寄道終北目指雪原向待約束地	scene_29
There, I will become a new being by uniting with the Planet. As will this girl…	私はそこで新たな存在として星と一体化する。その時はその娘も…	私新存在星一体化時娘	scene_29
…Shut up.	……だまれ		scene_29
The cycle of nature and your stupid plan don't mean a thing.	自然のサイクルもおまえのバカげた計画も関係ない	自然計画関係	scene_29
AERIS is gone.	AERISがいなくなってしまう		scene_29
AERIS will no longer talk, no longer laugh, cry…or get angry…	AERISは、もうしゃべらないもう……笑わない泣かない……怒らない……	笑泣怒	scene_29
What about us…what are WE supposed to do?	俺たちは……どうしたらいい？	俺	scene_29
What is this pain?	この痛みはどうしたらいい？	痛	scene_29
My fingers are tingling. My mouth is dry. My eyes are burning!	指先がチリチリする。口の中はカラカラだ。目の奥が熱いんだ！	指先口中目奥熱	scene_29
What are you talking about? Are you trying to tell me you have feelings now?	何を言っているのだ？おまえに感情があるとでもいうのか？	何言感情	scene_29
Of course! What do you think I am!?	あたりまえだ！俺がなんだというんだ！	俺	scene_29
Ha, ha, ha…… Stop acting as if you are sad.	クックックッ……悲しむふりはやめろ	悲	scene_29
And there's no need to act as if you're angry either.	怒りにふるえる演技も必要ない	怒演技必要	scene_29
Because, CLOUD. You are…	なぜなら、CLOUD。おまえは……		scene_29
Jenova	ジェノバ		scene_29
Because, you are…a puppet.	なぜなら、おまえは……人形だ	人形	scene_29
You are…	おまえは……		scene_29
I'm…a puppet?	俺が……人形？	俺人形	scene_29
Everyone‚listen to me.	みんな、聞いてくれ	聞	scene_29
I'm CLOUD‚ex-SOLDIER‚ born in Nibelheim.	俺はニブルヘイムで生まれた元ソルジャーのCLOUDだ	俺生元	scene_29
I came to settle up with Sephiroth.	セフィロスとの決着をつけるためにここまでやってきた	決着	scene_29
What're ya tryin' to say?	……何が言いてえ？	何言	scene_29
…Hmm?	……あん？		scene_29
I heard that before.	まえにも聞いたぜ	聞	scene_29
Why now?	こんな時に、どして？	時	scene_29
Why're you being so formal? Is something wrong?	なんや、いきなりあらたまって。どないしたんですか？		scene_29
I came here by my own free will… Or so I thought.	俺は自分の意志でここまでやってきた……そう思っていた	俺自分意志思	scene_29
However…	しかし……		scene_29
…To tell the truth, I'm afraid of myself.	……正直に話す。俺は自分が怖い	正直話俺自分怖	scene_29
…There is a part of me that I don't understand.	……俺の中には俺の知らない部分がある	俺中俺知部分	scene_29
That part that made me give the Black Materia to Sephiroth.	俺はセフィロスに黒マテリアを渡してしまった	俺黒渡	scene_29
If you hadn't stopped me, AERIS might have been…	みんなが止めてくれなければAERISをこの手で……	止手	scene_29
…There's something inside of me. A person who is not really me.	……そういう自分が俺の中にいる。俺ではない自分が	自分俺中俺自分	scene_29
That's why I should quit this journey.	だから俺はもうこの旅をやめた方がいいのかもしれない	俺旅方	scene_29
Before I do something terrible.	とんでもないことをしてしまうかもしれない		scene_29
But I am going.	でも、俺は行く	俺行	scene_29
He destroyed my hometown five years ago, killed AERIS‚and is now trying to destroy the Planet. I'll never forgive…Sephiroth.	５年前、俺の故郷を焼き払いたった今AERISを殺しそしてこの星を破壊しようとしているセフィロスを……俺は許さない	年前俺故郷焼払今殺星破壊俺許	scene_29
I… I must go on.	俺は……俺は、行かなくてはならない	俺俺行	scene_29
…I have a favor to ask of you.	……頼みがある	頼	scene_29
Will you all come with me?	みんなも来てくれ……るよな？	来	scene_29
…to save me from doing something terrible.	……俺がおかしなまねをしないように見張っていてほしいんだ	俺見張	scene_29
…I dunno‚ man…	……でもよ、なんだかよ……		scene_29
…But‚CLOUD	……でも、CLOUD		scene_29
…All right‚CLOUD.	……わかった、CLOUD		scene_29
Well‚ we'll face it when it happens.	ま、なんだな。そん時は、そん時だ	時時	scene_29
Leave it to me!	アタシにまかせな！		scene_29
Watch you?…… We're all in this together!	見張るやなんて、そんな……おんなじ仲間やないですか～	見張仲間	scene_29
I don't know how AERIS tried to save the planet from the Meteor.	AERISがどうやってメテオを防ごうとしたのかはわからない	防	scene_29
And I guess now, we'll never know.	今となっては俺たちにはそれを知る方法もない	今俺知方法	scene_29
We still have a chance. We must get that Black Materia back before Sephiroth uses it.	まだ、チャンスはある。セフィロスがメテオを使う前に黒マテリアを取り返すんだ	使前黒取返	scene_29
Let's go.	行こう	行	scene_29
Everyone, listen to me.	みんな聞いてくれ	聞	scene_29
What hit you so suddenly?	どしたの、急に？	急	scene_29
I've heard all this before.	前にも聞いたぜ	前聞	scene_29
I came here on my own will…… or at least that's what I thought. But…	俺は自分の意志でここまでやってきた……そう思っていた。でも……	俺自分意志思	scene_29
To be honest… I'm afraid of myself.	……正直に話す。俺は自分が恐い	正直話俺自分恐	scene_29
There's a part of me I don't understand.	俺の中には、俺の知らない部分がある	俺中俺知部分	scene_29
…It's something inside me.	……そういう自分が俺の中にいる	自分俺中	scene_29
Five years ago, he burned down my hometown, then he took AERIS.	５年前、俺の故郷を焼き払いたった今、AERISを奪った	年前俺故郷焼払今奪	scene_29
And now he's trying to destroy the Planet. I won't let him get away with it.	そしてこの星を破壊しようとしているセフィロスを……俺は許さない	星破壊俺許	scene_29
…I must go on.	……俺は行かなくちゃならない	俺行	scene_29
But…I have a favor to ask of you.”	それで……頼みがあるんだ	頼	scene_29
…Will you all still go with me?	みんなも……行ってくれるよな？	行	scene_29
…But, you know…	……でもよ、なんかだよ		scene_29
All right, we'll watch you.	よ～し、しっかり見張ってるよ	見張	scene_29
…I see.	……なるほど		scene_29
I wonder how AERIS was going to save this planet from Meteor. We have no way of finding out now.	AERISがどうやってメテオを防ごうとしたのかはわからない。俺たちにはそれを知る方法もない	防俺知方法	scene_29
We still have a chance. We need to get the Black Materia back before Sephiroth uses Meteor.	まだ、チャンスはある。セフィロスがメテオを使う前に黒マテリアを取り返せばいいんだ	使前黒取返	scene_29
( End of Disc 1 )	【　ディスク１が終了しました　】	終了	scene_29
Save the game to this point on your computer?	ここまでのゲームの状態をメモリーカードにセーブしますか？	状態	scene_29
Please change the disc.	ディスク交換が必要です。	交換必要	scene_29
Save the game to this point on your computer?	ここまでをメモリーカードにセーブしますか？		scene_29
Please insert disc two.	ディスク２に交換してください。	交換	scene_29
You still haven't saved your game.	現在はまだここでセーブできません。	現在	scene_29
Continue playing?	このままゲームをつづけてください。		scene_29
Which way'd that damn foo' Sephiroth go?	セフィロスは……どっちだ？		scene_29
Sephiroth… I wonder which way he went?	セフィロスは……どっちに行ったのかしら？	行	scene_29
Sephiroth… which way did he go?	セフィロスは……どっちに行ったのかな？	行	scene_29
…Which way did that creep Sephiroth go!?	……どっち行きやがったんだ？セフィロスの野郎はよ	行野郎	scene_29
Ummm… Which way did that Sephiroth guy go?	え～っと……セフィロス、どっち？		scene_29
I wonder which way Sephiroth went?	セフィロスはどっち行ったんやろ？	行	scene_29
Which way did Sephiroth head?	セフィロス……どこへ向かった？	向	scene_29
Hey, you alright?	おい、大丈夫か？	大丈夫	scene_29
CLOUD! Get a hold of yourself!!	CLOUD！しっかりして！！		scene_29
You all right?	だ、大丈夫？	大丈夫	scene_29
Ey, hey! You alright?	お、おい！大丈夫か？	大丈夫	scene_29
Wait! Get a hold of yourself!	ち、ちょっと！シッカリしてよ		scene_29
CLOUD! Are you all right?	CLOUDさん！大丈夫ですか？	大丈夫	scene_29
Sephiroth said to me… Head North…… ……past the Snow Fields……	セフィロスは言っていた……【北を目指す】……【雪原の向こう】と……	言北目指雪原向	scene_29
…ugh.	……うっ		scene_29