Icicle Inn	アイシクルロッジ	scene_30
What's down there?	この先に、何があるんだ？	scene_30
You mean Boss…Tseng? That wasn't us. Sephiroth did it.	ボス……ツォンのことか？あれは俺たちじゃない。セフィロスが、やったんだ	scene_30
I'm not lying… it was Sephiroth.	ウソなんかついてない……セフィロスなんだ	scene_30
Wa…wait! Get out of the way Stay put Elena	まっ、まて！ よける じっとしている イリーナ	scene_30
There they are, hurry!!	いたわ、いそいで！！	scene_30
CLOUD…huff…wheeze.	CLOUD……ハァ、ハァ	scene_30
I won't let you go any further!	ここから先へは進ませないわよ！	scene_30
It's a SE-CR-ET.	ヒ・ミ・ツ	scene_30
It really doesn't matter! You really got guts messin' my boss up like that!	そんなことは、どうでもいいの！よくも私のボスをやってくれたわね！	scene_30
No! Liar! Don't think you can fool me!	いいえ、だまされるもんですか	scene_30
Don't try to act innocent. I'll never forget it!!	いくら、しらをきってもムダよ。絶対、許せない！！	scene_30
Looks like just talking won't do. You're going to have to feel some pain!	口で言ってもムダなんだったら体に聞いてもらおうじゃないの！	scene_30
No, I can handle him! There's no way he can avoid my punch.	いえ、私１人で十分よ！私のパンチをよけられるはずがないわ	scene_30
Eyaaaah!	キャー！	scene_30
Why? Why didn't you try to duck?	なぜ？わざと、よけなかった……	scene_30
There's no way they can climb the Great Glacier anyway.	どうせ、あの大氷河を越えられるはずがないわ	scene_30
Put them in some house in the village.	どこかの家にほうりこんでおいて！	scene_30
Yes ma'am!!	ハイッ！！	scene_30
Just you…and me!!	わたしたちが、コイツを！	scene_30
What?  Yeah…	えっ？　ええ……	scene_30
This village is now under martial law!	この村は、しばらく閉鎖だ！	scene_30
(Do as you're told)	（すなおに、したがう）	scene_30
(Kick his butt)	（こいつをぶっとばす）	scene_30
Don't be angry. I'm just doing my job.	悪く思うな、これも仕事なんだ	scene_30
Stop it, there're kids around!	やめるんだ、子供たちがいるだろ！	scene_30
Listen, I probably shouldn't tell you, but I hear something big's going down up North.	う～む……お前には、関係ないがここよりさらに北で何かが始まるらしいんだ	scene_30
The President's gonna be there. So, would you please just lay low for a while?	本社から社長もいらっしゃる。混乱をさけるためだ。ガマンしてくれんか？	scene_30
Ele…Elena!?	イッ、イリーナさん！？	scene_30
Who--a!!	うわーっ！！	scene_30
No, don't!! There's a steep grade, past here.	ダメダメ！！この先は、すごい下り坂なんだ	scene_30
It's dangerous, please don't go!	キケンだから、入らないでくれ！	scene_30
I'm still going	それでも行く	scene_30
Thanks for your kindness	親切に、ありがとう	scene_30
Damn, I was just being nice…	なんだよ、人が親切に……	scene_30
What the? Who are those people over there? Looks like trouble!	な、なんだ向こうのヤツらは？ヤバそうだぜ！	scene_30
No, no. I just did what came natural.	いやいや。当然のことをしたまでさ	scene_30
I guess I'm not too busy now. Do you want to learn how to ride a snowboard?	よし、ヒマだからスノーボードの乗り方を教えてやろうか？	scene_30
Maybe I should	たのもうかな	scene_30
Do you want me to explain again?	もう一度説明しようか？	scene_30
No thanks	えんりょする	scene_30
You're so boring!	つまんねぇヤツだな！	scene_30
Sorry I ran off a while ago… I thought there was going to be trouble.	さっきは、逃げ出してしまって……何かヤバそうな感じだったんでな	scene_30
Anyhow, you'll need a snowboard to get down that hill. Want to learn how to ride one?	それより、向こうの坂を下るにはスノーボードでもなければ無理だぜ。乗り方を教えてやろうか？	scene_30
All right, fat-head… But don't blame me if you get hurt.	わかんねぇヤツだな……ケガしてもしらねぇぜ	scene_30
What the? They sure were weak for Shinra.	なんだアイツら？神羅なのに弱かったな	scene_30
I told you, you can't!	ダメだって言っただろ！	scene_30
You won't make it without a snowboard and a map!!	スノーボードと地図がなければきっと、この先で行き倒れになってしまうぞ！！	scene_30
Be careful!	気を付けろよ！	scene_30
There's a steep hill past here. You shouldn't go any further.	この先は、すごい下り坂なんだ。行っちゃダメだよ	scene_30
There's a barrier at the North end of the crater! You shouldn't go any further.	北の果てのクレーターにバリアが、はられているんだ！この先は、行かないほうがいいぜ	scene_30
A bright light shattered the barrier at the crater! What in the world's goin' on!?	とっても、まぶしい光がクレーターのバリアを突き破ったんだ！いったい、何が起こっているんだ！？	scene_30
When I first moved here, I saw a man with a black cape heading North.	この村に引っ越してきていきなり、黒マントの男が北に向かうのを見たんだ	scene_30
It seemed strange seeing the black cape in the snowy white.	なんだか、白い雪の中で黒いマントが動くのが不気味だったな	scene_30
Sledding's fun!	ソリすべりは、たのしいよ	scene_30
Who is that man?	あの、おじさんたちだ～れ？	scene_30
I'm gonna try snowboarding after this!	次はスノボーにちょうせんするんだ！	scene_30
Next time, I'm gonna make an even bigger one.	次は、もっと大きなのを作るんだ	scene_30
What's a barrier? You mean that light on the top of the mountain?	バリアってな～に？お山のてっぺんの光のこと？	scene_30
A sad voice is getting louder every second!	かわいそうな声がだんだん大きくなっていくんだ！	scene_30
The mountain must be crying. Is it hurt?	お山さんが泣いているんだね、きっと。どこか、ケガしてるのかな？	scene_30
It's almost finished!	もうすぐ完成なのよ！	scene_30
I heard that there's a barrier on top of the mountain.	お山のてっぺんにバリアがはられているんだって	scene_30
Once the barrier's gone, I can hear cries from beyond the mountain…	バリアがなくなったらお山の向こうから悲鳴がきこえるの……	scene_30
Dodge that punch!	パンチをかわせ！	scene_30
[up]	【方向キーの上】	scene_30
[left]  [right]	【方向キーの左】　【方向キーの右】	scene_30
Directional button [up]  Move forward	【方向キーの上】　止まった時に地面をける	scene_30
Directional button [left] Move left	【方向キーの左】　左移動	scene_30
Directional button [right]Move right	【方向キーの右】　右移動	scene_30
Directional button [down]Brake	【方向キーの下】　　ブレーキ	scene_30
[SWITCH]Brake	□ボタン　　ブレーキ	scene_30
[CANCEL]Jump	×ボタン　　ジャンプ	scene_30
Directional button [left] + [PAGEDOWN]Edge Left	【方向キーの左＋Ｒ１ボタン】　　エッジをきかせる	scene_30
Directional button [right] + [PAGEDOWN]Edge Right	【方向キーの右＋Ｒ１ボタン】　　エッジをきかせる	scene_30
I got hurt on my snowboard, and now I can't go out for a while…	スノーボードで遊んでいたらケガをしちゃってしばらく外へ出れないんだ……グスン	scene_30
Hey, I'll give you my snowboard.	おにいちゃんにスノーボードをあげるよ	scene_30
…whimper…weep…	…グスン、グスン	scene_30
Tell me if you get good at it.	上手になったら教えてね	scene_30
I wanted to get a lot better at snowboarding…	スノーボード…上手になりたかったな…	scene_30
My boy got hurt right about the time we moved here…	あの子ったら、引っ越してすぐにケガしちゃうんだから……	scene_30
I never shoulda got him that snowboard.	スノーボードなんか買ってあげるんじゃなかったわ	scene_30
Teach me too, OK!?	私にも教えてねっ！おねがいよ	scene_30
I can't live in this town anymore. It gets so cold here!	気温がとても下がってしまってもう、この町には住めそうにないの	scene_30
I have to move again… I don't know where to start.	また、引っ越ししなくちゃ……でも、何から手をつけていいのやら？	scene_30
The reason for the drop in temperature must be because of that dome of light at the Northern limits…	こんなに気温が下がったのは北の果てにできた光のドームのせいにちがいないんだ……	scene_30
You all should get away from here and go to a place like Mideel Island in the south.	きみたちも早くここから離れて【南の島ミディール】にでも行ったほうがいいと思うよ	scene_30
Received Key Item "Snowboard"!	キーアイテム『スノーボード』を手にいれた！	scene_30
The master is an experienced climber, you know.	この家のおじぃさんは登山家だそうなの	scene_30
I've heard that he knows every corner of that Great Glacier!	なんでも、あの広い大氷河を全て見てまわったそうなのよ！	scene_30
Grandma, don't sleep so close to the fire!	おばぁちゃん火の近くで眠っちゃダメよ！	scene_30
Grandma's been sick for a while and doesn't have much energy…	おばぁちゃん、カゼぎみでねこのごろ元気がないのよ……	scene_30
I just get SO comfortable.	ついつい、イイ気持ちになってね	scene_30
My husband left 20 years ago and still hasn't come back.	私のダンナは２０年前にでかけたきりでまだ帰ってこないのよ	scene_30
He should at least be at the foot of Gaea's Cliff. It's marked with a check on the map…	地図に書いてあるペケ印のガイアの絶壁のふもとまで行っているばずなんだけど	scene_30
…cough…cough… I've been living in this town for 60 years. And I STILL caught a cold…	ゲホゲホ……この寒さじゃ、この町に６０年住んでいる私でもカゼぎみでね……	scene_30
I heard there's a doctor on a Southern island somewhere. I sure wish he'd come here…cough…cough…	南方の島にお医者さんがいるそうなんだけどこの町にも来てくれんかねぇ……ゴホゴホ	scene_30
It's nearly impossible to reach the Northern limits without a map.	北の果てに無事たどり着くためには地図がなければ不可能に近いんだ	scene_30
If you're thinkin' 'bout going to the Northern limits, you'd better take that map on the wall.	北の果てに行くつもりなら壁にはってある地図をもっていきな	scene_30
What nerve! You already tore down the map.	おっ、ちゃっかりしてるなあ！もう地図をはがしてるんだな	scene_30
I'm thinkin' 'bout taking that hill on my skis.	オレは、あの坂をスキーで挑戦してみようと思ってるんだ	scene_30
It's the first time that the temperature has dipped this low, this fast…	こんなに急に気温が下がったのは初めてなんだよ……	scene_30
There's also that mysterious light at the Northern limits, too. Does this mean it's the end of the world?	北の果てに不思議な光も見えるしこれが世界の終末っていうやつかね？	scene_30
Received Key Item "Glacier Map"!	キーアイテム『大氷河の地図』を手にいれた！	scene_30
Look at the Map	地図を見る	scene_30
Take the Map	地図をとる	scene_30
Received "Hero Drink"!	『英雄の薬』を手にいれた！	scene_30
Received "Vaccine"!	『ワクチン』を手にいれた！	scene_30
You'll have a hard time selecting from all the good things we have!	目うつりするほどイイものがそろっているゾイ！	scene_30
…smack…mff… Oh…welcome, glad you came.	フガフガ……おお、よう来なさった	scene_30
Grandpa, wake up! We have a customer!!	じぃちゃん起きて！お客さんだよ！！	scene_30
It's colder than usual today…	今日は、いちだんと寒いねぇ	scene_30
It's 200 gil , you wanna spend the night?	２００ギルだが、泊まっていくかい？	scene_30
You don't have enough money.	お金がたりませんよ	scene_30
Enjoy your stay!	ごゆっくり	scene_30
Please come again.	また来て下さいね	scene_30
You heard about the gnarly hill in this town? They tell me it's off limits!	この村の先に超デンジャラスな坂があるらしいんだけどさすべらせてくれないんだ	scene_30
What luck! We came all this way…crap!	こんな遠くまで来たのについてねぇぜ、まったく！	scene_30
We came from Costa del Sol to snowboard, but we're just about to leave!	あたしたちぃ～コスタ・デル・ソルから～スノボしにきたんだけどぉ～もう、帰っちゃうのよ！	scene_30
Whew, what is it? Don't get too close, or it'll burn ya.	フゥ、なんだい？ヤケドするから近よるんじゃねぇぞ	scene_30
Icicle Inn Bar	パブ	scene_30
Bartender	バーテン	scene_30
I've heard there's a snow woman at the Great Glacier that hates hot springs…	なんでも、この村の北の大氷河には温泉ぎらいの雪女がいるらしいとか……	scene_30
But I think it's just a myth to scare off visitors.	いやぁ、これは旅人を驚かせるためのたんなる迷信だと思うんですがね	scene_30
Do you know what a Cetra is?	セトラって知ってるか？	scene_30
Yeah, a Cetra lived in this town a long time ago.	そう、昔この村にはセトラの生き残りが住んでいたんだ	scene_30
Her name was Ifalna, and she knew about a lot of things…	イファルナっていう女の人でいろんなことを知ってたんだけどな…	scene_30
I heard she was abducted by the Shinra and was taken somewhere.	彼女はな、神羅に連れられてどこかに行っちゃったらしいんだ	scene_30
With all the strange things happening in the world, I kinda understand why people want to leave…	こうも、おかしな事が続くとみんなが町を出ようとする気もわかるような気がするよ……	scene_30
What were the Cetra? Oh yeah, they were the same as the Ancients, right?	セトラってのはえ～と、なんてたっけ？そうそう、古代種のことだよな	scene_30
Whadaya mean?	けどな、っていったいどうしたんだよ？	scene_30
Shinra and the Ancients… I smell somethin' fishy…	神羅と古代種…なんか、怪しいニオイがするよな	scene_30
Maybe we'd better leave town soon too.	おれたちも早くこの町を出た方がいいかもしれんな	scene_30
Let's go to that island in the South! What was it called?	いっそ南の島にでも行くか！なんてったけな……う～ん？	scene_30
Yeah, yeah, I heard that there's a town called Mideel on a southern island.	そうそう、南方の島にミディールっていう町があるらしいぜ	scene_30
I heard some guy went to the Great Glacier in the North.	この村の北の大氷河に向かったヤツがいるらしいぜ	scene_30
What an idiot. Is he thinkin' 'bout going to that hot spring?	バカだよな、あの温泉にでもつかりに行くつもりなのかな？	scene_30
He's probably gonna get lost in the glacier and freeze to death.	どうせ大氷河に迷いこんでのたれ死にするにきまってる	scene_30
No matter how well equipped he is, out there in that cold on the glacier, I give him two days at the most.	どんな重装備でも大氷河の寒さじゃ２日ともたないぜ	scene_30
You thinkin' of going North?	北へ行くつもりなのか？	scene_30
That's my plan	そのつもりだ	scene_30
No	ちがう	scene_30
Well…if you're going past this town you'll need a map.	そうかぁ…いや、この村より先に行くには地図でもなければムリだぜ	scene_30
Maybe there's one left at Mr. Holzoff's house. He used to be a mountain climber.	ホルゾフさんの家なら地図が残ってるかもなぁ？あの人、登山家だったんだよ	scene_30
Yeah, we really don't have anything here, but make yourself at home.	そうかそうか。ま、何もないところだけどゆっくりしていきな	scene_30
If you go further North, I heard there's a Huge Crater.	ず～っと北に行くと でっかいクレーターがあるらしいんだ。	scene_30
Something huge must've fallen from the sky a long time ago!	大昔に空から何かが降ってきたにちがいないよ！	scene_30
Am I boring you?	オレの話ってつまんないのかな～？	scene_30
Welcome! You look like a STRONG one…	いらっしゃ～い！あなたって強そ～	scene_30
If you want, I could lend you an ear?	ねぇ、よかったら話相手になってあげようか？	scene_30
What's with you!? You make me sick!	なによ、ツンとしちゃって感じ悪～い！	scene_30
I got bored listening to his stories.	あの人の話の相手とってもつまんなかったの	scene_30
Oh yeah?	へぇ～、そぉなの？	scene_30
WHAT YOU LOOKIN' AT!?	なに見てんだよ！？	scene_30
You're a real freakazoid, aren't you?	お前、変なシュミしてるな？	scene_30
Eyaaaaaaaaah!!!	キャー！！！	scene_30
I'm still in here! All right!?	入ってま～す	scene_30
Gast's House	ガストの家	scene_30
Play the Video?	ビデオを再生しますか？	scene_30
The Original Crisis	（昔の）星の危機について	scene_30
What is "Weapon?"	ウェポンとは？	scene_30
Confidential	プライベート	scene_30
Don't watch	見ない	scene_30
Daughter's Record: 10th Day after birth	娘の記録・生後１０日め	scene_30
Daughter's Record: 20th Day after birth	娘の記録・生後２０日め	scene_30
Then, Ifalna, please tell us about the Cetra.	では、イファルナさんセトラの話をおねがいします	scene_30
Tell us, Ifalna… Where is the land called 'Knowlespole'?	イファルナさん……ノルズポルという土地はどこにあるのです？	scene_30
Ifalna, what exactly does Planet-reading entail?	イファルナさん星読みとは、どういうことなのですか？	scene_30
Do the Ancients, rather, the Cetra, have special powers to heal the Planet?	古代種、いやセトラは星を治す特別な力を持っているのですか？	scene_30
Hmm, even here so close to the North Cave, the snow never melts. Is that because the Planet's energy is gathered here to heal its injury?	ふむ、北の大空洞に近いこの地に雪どけの時期がこないのは星の傷にエネルギーが集中しているからなのか	scene_30
Ifalna… Let's take a break.	イファルナさん……少し休みましょう	scene_30
Who is the person that appeared at the North Cave? I haven't any idea.	北の大空洞に現れた、その者とはいったい何者なのですか？まるで見当がつかないのですが	scene_30
You don't look well… Let's call it a day.	顔色があまりよくない……今日はこれで終わりにしましょう	scene_30
Camera's ready!	カメラは、これでよし！	scene_30
2000 years ago, our ancestors, the Cetra, heard the cries of the Planet.	およそ２０００年前わたしたちセトラの祖先はこの星の悲鳴を聞いたそうです	scene_30
The first ones to discover the Planet's wound were the Cetra at the Knowlespole.	最初に星の大きな傷口を見つけたのはノルズポルにいたセトラたちでした	scene_30
Knowlespole refers to this area. The Cetra then began a Planet-reading.	ノルズボルとは、このあたりのことです。そしてセトラたちは、星読みを始めました	scene_30
…I can't explain it very well, but it's like having a conversation with the Planet…	……うまく表現できませんけど星と対話することなのです……	scene_30
It said something fell from the sky making a large wound.	星は空から降ってきた何かと衝突して傷ついたと語ったそうです	scene_30
Thousands of Cetra pulled together, trying to heal the Planet…	何千人ものセトラが力を合わせました。星の傷をいやそうとしたのです……	scene_30
But, due to the severity of the wound, it was only able to heal itself over many years.	でも、その傷はあまりにも深く星自身が長い年月をかけて治す他はなかったのです	scene_30
No, it's not that kind of power. The life force of all living things on this Planet becomes the energy.	いえ、そういう力ではありません。星の上にあるもの全ての生命力がエネルギーになるのです	scene_30
The Cetra tried desperately to cultivate the land so as not to diminish the needed energy…	セトラたちは必要とされるエネルギーを絶やさぬために必死で土地を育てようとしたのですが……	scene_30
Yes, the energy that was needed to heal the Planet withered away the land…then the Planet…	ええ、傷の回復に費やすエネルギーは急速に土地を枯れさせ…そして星は…	scene_30
The Planet tried to persuade the Cetra to leave the Knowlespole, but…	星はセトラにノルズポルから離れるようにすすめたそうです…でも	scene_30
I'm all right… When the Cetra…were preparing to part with the land they loved…	だいじょうぶです…セトラたちが…長年親しんだ土地から旅立ちの準備をしていたとき……	scene_30
That's when the one who injured the Planet… or the 'crisis from the sky', as we call it, came.	それが星を傷つけた者です……空から来た厄災！わたしたちは、そう呼んでいます	scene_30
The Cetra were attacked by the virus and went mad… transforming into monsters.	ウィルスに侵されたセトラたちは心を失い……そしてモンスターと化しました	scene_30
That's when it appeared!	その時、そのものは現れたのです！その姿は、亡き母の…亡き兄のものでした。それぞれに過去の幻影を見せるのです	scene_30
It looked like…our…our dead mothers …and our dead brothers. Showing us specters of their past.	その者は親しげな顔でセトラたちに近づき…あざむき…そして……ウィルスを…ウィルスを与えたのです	scene_30
It first approached as a friend, deceived them, and finally… gave them the virus.	その者は、ノルズポルと同じように別のセトラの部族に近づき………そしてまた…ウィルスを……	scene_30
Then, just as it had at the Knowlespole.	では、イファルナさんウェポンという名の者の存在について語っていただけますか？	scene_30
It approached other Cetra clans… and infected them with…the virus.	では、ウェポンとは星の意志が生みだした兵器ということですか？	scene_30
Ifalna, can you comment on the thing called 'Weapon'?	もう、この星にウェポンは存在していないのですか？	scene_30
Back then, Weapon was a weapon the Planet produced by its own will?	ウェポンが眠っている場所はどこなのですか？	scene_30
So, Weapon no longer exists on this Planet?	……ありがとう、イファルナさん今日は、このくらいで……	scene_30
Where is Weapon?	はい、博士	scene_30
…Thank you, Ifalna, that will be all for today…	ええ、でも…実際にウェポンが使われた歴史がないのです	scene_30
Yes, Professor.	少数の生き残ったセトラたちがジェノバに討ち勝ち、そして封印したのです	scene_30
Yes, but… There is no record of Weapon ever being used.	星はウェポンを生みだしました……しかし、使う必要がなくなったのです	scene_30
A small number of the surviving Cetra defeated Jenova and confined it.	ウェポンが消えることはありません。…この星のどこかで眠っているのです	scene_30
The Planet produced Weapon… But it was no longer necessary to use it.	わたしには、わかりません……星の声は……もう、あまり聞こえないのです	scene_30
Weapon cannot vanish. …It remains asleep somewhere on the Planet.	時代は……変わりました。星は……きっと様子を見ているのだと思います	scene_30
I don't know… I can't hear the voice of the Planet well…	博士がセトラだと誤解した者……ジェノバと名づけた者こそが……空から来た厄災なのです	scene_30
Times…have changed. The Planet…is probably watching this situation closely.	その空から来た厄災を滅ぼすことを星が意識しはじめました……	scene_30
The one the Professor mistook for a Cetra…was named Jenova. That is the 'crisis from the sky'.	ジェノバが存在するかぎり星が自身の力で傷を完全に治すことができないからなのです	scene_30
The Planet knew it had to destroy the 'crisis from the sky'…	ジェノバを封印したといってもいつ、よみがえらないともかぎりません……	scene_30
You see, as long as Jenova exists, the Planet will never be able to fully heal itself.	星の傷は完全に治ってはいないのです。星はまだ、ジェノバを警戒しています	scene_30
Even though Jenova is confined, it could come back to life at some time…	………そう言わないでくださいよ	scene_30
The Planet has not fully healed itself yet. It's keeping watch on Jenova.	ワ、ワタシと……ア、アナタのとってもカワイイ娘なんですよ！	scene_30
… Please don't say it that way.	彼女のすくすくと育っていく姿を残しておきたいと思いませんか？	scene_30
It's our lovely daughter, both yours…and mine!	そんなこと言っちゃダメです！ワタシが、アナタとAERISをどんなことをしても守ります！！	scene_30
Don't you want to capture her childhood on videotape?	ア、アナタとAERISはワタシの宝なんです。何があってもはなしません！！	scene_30
Never say that! I will protect you and AERIS no matter what!!	もう、いったいダレなんですか！？イイところで……	scene_30
You and AERIS are my only treasures. I'll never let you go!!	！！！　あわわ……	scene_30
Who could that-? I was just about to…	我が家のくつろぎの時間にまったく……	scene_30
Damn!!	宝条くん……どうしてここが？	scene_30
How dare they intrude on our 'private time' together!	……新しいサンプル？まさか、AERISを！？	scene_30
Hojo… How did you know?	くっ……私は神羅とは手を切ったのだ	scene_30
A new sample? You don't mean AERIS!?	宝条くん、帰ってくれたまえ	scene_30
That's it! I'm severing all ties with the Shinra.	イファルナ！	scene_30
Hojo, please leave.	だいじょうぶだイファルナ！ワタシは、こんなヤツらには負けない！	scene_30
Ifalna!	イファルナ！AERISをつれて逃げるんだ！！	scene_30
Don't worry, Ifalna. I'll take care of this!	あなた、またビデオ？この前とったばかりじゃないの！	scene_30
Ifalna! Take AERIS and run!!	そんなにカワイがってばかりじゃ強い子に育たないかもしれない……	scene_30
Video again? You just got through taping!	AERISは、普通の子とは違うんだからこれから、どんな人生が待っているか……	scene_30
If you keep doting on her like that, she won't grow up to be strong…	あなた……わたし、今とっても幸せよ	scene_30
AERIS is different from the other children. I wonder what dangers await her…?	あなたに会わなければわたし……	scene_30
I feel so much better now, darling.	クスクス……ええ、そうね	scene_30
If I hadn't met you, I…	は～い、いますぐ！！	scene_30
I'll send them away.	だれかしらね？	scene_30
Yes, at once!!	あ、あなたたちは！！	scene_30
Who the devil?	おねがいAERISは、関係ないわ！わたしさえいれば、いいんでしょ？	scene_30
It, it's them!!	キャーあなた～！！	scene_30
Please, AERIS has nothing to do with it! All you want is me, right?	クックックッ……探しましたよイファルナ……いや、セトラ！	scene_30
Eyaaaaaah… Darling…!!	それから、本当に久しぶりですねガスト博士！	scene_30
Heh, heh, heh I've been searching for you, Ifalna… or should I say, Cetra!	いやぁ、骨をおりました。あなたたちが、ここにいることぐらいとうにわかってたんですよ	scene_30
Long time no see, Professor Gast!	でもね……２年間待ちました。私は新しいサンプルがほしかったんですよ……クックックッ	scene_30
Believe me, I had to turn over a stone or two to find you.	ほう、AERISちゃんですか？いい名前だ……クックックッ	scene_30
Two years I waited… That's how much I wanted this new sample. Ha, ha, ha.	私の実験にはあなたたち、みんなが必要なんですよ	scene_30
Hmm, AERIS? What a nice name. Ha, ha, ha.	ガスト博士、わかってくれますよね。この星の運命を変えることができるんですよ！	scene_30
I'll need all of you for my experiment.	ムダな抵抗はしないで下さいよ。大事なサンプルに傷をつけたくないですからね	scene_30
You understand don't you, Professor Gast? We can change the future of the Planet!	ん？　おかしなカメラがあるな。おい、壊してしまえ！	scene_30
Please don't put up a fight. I don't want any harm to come to my precious sample.	ていねいに運ぶんだぞ！！クックックッ……	scene_30
Mmm? What a funny looking camera. Guard! Destroy it!	な、なにをするんだ博士！？	scene_30
Be careful with her!! Ha, ha, ha…	まあいい……子供を忘れるんじゃないぞ！	scene_30
Wh…what are you doing, Professor!?	ほう、ビデオか？古代種…ウェポン！？	scene_30
Oh, and uh… don't forget the child!	クックックッ……宝の山だな！ありがとう博士……クックックッ	scene_30
Heh, heh, heh…a mountain of treasure! Thank you Professor…Ha, ha, ha	あっ、ビデオをとろうと思っているんですよ	scene_30
You understand don't you, Professor Gast? We can change the future of the Planet!	でも、なんだかビデオの調子が悪くて……	scene_30
Oh, I'm thinking of taping it on video.  But, the video's not working right…	いえ、そんなことではないです。カワイイわが子をとるんですよ	scene_30
No, that's not it. I'm going to record my beautiful daughter.	ワタシはもう決めてますよ！女の子だったらAERISこれしかありません！	scene_30
I've already decided! If it's a girl, then it'll be AERIS. That's that!	でしょ！？あっ、ビデオのテープがっ…………	scene_30
Right!? Oh, the video tape…	この、眠っている顔がまた、とてもカワイイ～んです	scene_30
And when she's sleeping, her face …looks like an angel.	博士……いえ、あなた何をしてるの？	scene_30
What are you doing, Profes-- I mean, honey?	何をとるの？まだ、話していないことがあったかしら？	scene_30
What are you going to tape? Is there still something I haven't mentioned?	もう、それならビデオより先にこの子の名前を決めなくちゃ！	scene_30
First, we have to figure out her name. We can take the video later!	もう、勝手な人ね……でも、AERISってイイ名前ね！	scene_30
You are SO selfish! But AERIS is a good name!	ウフフ……あなたのカタイ頭で考えたにしては上出来じゃないかしら	scene_30
Ugh…	う……	scene_30
I guess we're still in one piece.	なんとか、飛び越したようだな	scene_30
Everyone all right?	みんな大丈夫か？	scene_30
Yeah, I guess.	ええ、なんとか	scene_30
Of course.	あたりまえだ	scene_30
I'm sick of this.	も～、イヤ	scene_30
…Snow in my ear.	耳の中に雪が……	scene_30
God! I can't stand it!	だ～っ！たまんないよっ！	scene_30
I'm a little off.	ちと、ずれたかな	scene_30
Yeah, I'm all right.	ああ、大丈夫だ	scene_30
I'm too old for this! Damn!	やってらんねえぜ　まったくよー	scene_30
So where did we land?	いったいどこへ落ちたんだ？	scene_30
That didn't seem like such a big jump…	あまり、大きなジャンプにはならなかったようだが……	scene_30
In fact, it feels like we didn't even jump at all…	まったく、ジャンプをできなかったようだ……	scene_30
We've jumped pretty far…	かなりジャンプできたようだ……	scene_30
We've jumped pretty far…	かなり大きくジャンプできたようだ……	scene_30
Well, we've got a map, right? Look at the map by pressing [SWITCH].	そういえば、地図をもらったわよね？□ボタンで地図を見ましょうよ	scene_30
Hey. Let's take a look at the map. Press [SWITCH].	ねえねえ。□ボタンで地図、見ようよ	scene_30
We need the map, okay!? Let's see it with [SWITCH].	こういうときこそ地図！□ボタンで広げようよ	scene_30
Hey, what's that!? You just got something, right? Use [SWITCH] to see it.	おう、あれだ！なにかもらったろ？□ボタンで見ようぜ	scene_30
All right, let's look at the map. We use [SWITCH], right?	よし、地図を見よう。□ボタンで広げるんでしょ？	scene_30
Then, let's look at the map. Just push [SWITCH].	ほな、地図でも見よか。ええからはよひろげぇな。□ボタンや	scene_30
We should check it on the map. Press the [SWITCH].	地図で確認すべきだな。□ボタンで見てくれ	scene_30
Quick! The map, the map! Look at it with [SWITCH]!	地図だ、地図！□ボタンで見てみろよ！	scene_30
It sure is cold. We'll freeze if we stay here any longer.	それにしても、ものすごい寒さだあまり長くここにいるとこごえてしまうな	scene_30
This is the only place not frozen.	ここだけ凍っていないな	scene_30
Touch it	さわってみよう	scene_30
Hmm, a hot springs.	なるほど、温泉か	scene_30
…go.	……おかえりください	scene_30
Don't worry about me.	かまわないでください	scene_30
Now, I don't want to hurt any of you.	あなた方に危害を加えるつもりはありません	scene_30
And don't come back again.	もう近寄らないでください	scene_30
Please, stop it.	やめてください	scene_30
Please, that's enough.	いいかげんにしてください	scene_30
Yeeew… You got a lot of nerve trying to touch me with the same dirty hands that touched that filthy hot spring!	ああ……よくもあの汚い温泉にさわった手でこの私に触れたな	scene_30
I'll never forgive you.	おまえたちは許さないぞ	scene_30
Hah, just remember your place!	ほほほ、身のほどを知りなさい	scene_30
Still don't get it, eh?	あら、こりてないのかしら	scene_30
Why this?	なんてことに……	scene_30
Received "Alexander" Materia!	『アレクサンダー』のマテリアを手にいれた！	scene_30
The only way is to cross…	これを渡るしかなさそうだ……	scene_30
That's the way it goes…	しかたがないな	scene_30
I don't feel like it	その気にならないな	scene_30
Face the direction you want to jump in then press [OK].	ジャンプする方向を向いて○ボタンだ	scene_30
Received "Added Cut" Materia!	『ついかぎり』のマテリアを手にいれた！	scene_30
Looks like trouble.	なんだかマズそうだな	scene_30
We're outta here!	つっぱしる	scene_30
Wait a minute!	ちょっと待て！	scene_30
Base of Gaea's Cliff	絶壁のふもと	scene_30
Now, this is a surprise!!	オオッ、これは珍しい！！	scene_30
It's been years since I last saw anyone up here.	人に会ったのは 何年ぶりだろう……	scene_30
Oh, I'm sorry, my name is Holzoff. I've lived here for 20 years.	おっと失礼！　わたしの名は、ホルゾフ。この地に住みついて、もう２０年だ	scene_30
Do you mind hearing some stories from a lonely climber?	よければ、向こうの部屋でさびしい山男の独り言を聞いてくれんか？	scene_30
Why don't we go to the next room and sit down.	立ち話もなんだから向こうの部屋に行こう	scene_30
To climb this cliff, you must check your route	あの絶壁を登りきるには登山ルートをよく確認すること	scene_30
…And you have to keep your body temperature normal. Don't forget these 2 things.	下がった体温を回復させること。これらを忘れてはいけないぞ	scene_30
Like to rest a little?	ひと休みしていくかい？	scene_30
Don't overdo it.	むちゃをしてはいけないぞ	scene_30
You awake?	気がついたようだな？	scene_30
You collapsed at the Great Glacier. It's a miracle you're alive.	きみたちは、大氷河で倒れていたんだ。無事だったのはきせきだな	scene_30
My name is Holzoff. I've been living here 20 years now.	わたしの名は、ホルゾフ。この地に住みついて、もう２０年だ	scene_30
If you are planning to head north, you'd better listen to me.	これから先、北に向かうつもりならわたしの話を聞いていきなさい	scene_30
It's dangerous past the cliff because of the Barrier!	絶壁の向こうにバリアができて危険だ！	scene_30
It's better not to go anywhere near it!!	うかつに近づかんほうがけんめいだぞ！！	scene_30
You shouldn't go near the cliff unprepared, it's dangerous!!	やはり、絶壁にはうかつに近づかんほうがけんめいだぞ！！	scene_30
[OK]Confirm route.	【決定ボタン】　　登山ルートの確認	scene_30
[SWITCH]Push repeatedly to raise body temperature.	□ボタン　　　連打で体温回復	scene_30
Holzoff	ホルゾフ	scene_30
You ever hear about those who challenged the cliff?	君たちは絶壁に挑んだ男たちの話を聞いたことがあるかい？	scene_30
The first time my friend Yamski and I tried to climb the cliff was 30 years ago.	わたしと友人ヤマスキーが初めて絶壁に挑んだのは３０年前のことだ	scene_30
There's an old legend that says something fell from the sky here a long time ago.	この地には、大昔に何かが空から降ってきたという言い伝えが残っているんだ	scene_30
It's supposed to have pushed the land up and formed this cliff.	どうやら、その時に大地がもりあがってできたのがこの絶壁らしい	scene_30
20 Years ago, Yamski and I braved this cliff to see what was on the other side.	３０年前、わたしは友人ヤマスキーと絶壁の向こうを見るためにあのけわしいカベに挑んだ	scene_30
But, we weren't prepared for it. We never dreamed the temperature would be so low…	しかし、わたしらは無知すぎた。ある程度の寒さは予想していたが……	scene_30
That cliff has a biting cold wind that lowers your body temperature.	あの絶壁には、すさまじい寒気が嵐のようにうず巻いているんだ。寒気が体温をどんどん奪っていく	scene_30
Yamski was below me. He cut his own rope…	わたしの下を登っていたヤマスキーは自分でザイルを切って……	scene_30
…I didn't even notice…	わたしは、それに……気づきもしなかった……	scene_30
I've lived here ever since… challenging the cliff and providing warning and shelter to my fellow climbers.	以来わたしは、この地に移り絶壁に挑みつづけ、同じ仲間に注意と、ほんの少しの休息を提供しているんだよ	scene_30
If you're going to climb the cliff, you need to take 2 precautions.	もし、あの絶壁を登るつもりなら注意することが２つある	scene_30
First, check your route… It's hard to find because of all the snow.	１つめは雪におおわれて見つけにくくなっている登山ルートをよく確認すること	scene_30
Second, warm yourselves up once you get to a ledge.	２つめは絶壁の途中のタナに着いたら必ず下がった体温を回復させること	scene_30
Understand?	わかったかい？	scene_30
One more time	もう１回説明してほしい	scene_30
You must be tired coming all the way up here… Better get some rest before you head out.	ここに来るまで、かなり体力を使ったんじゃないのかい？少し休んでから出発しなさい	scene_30
Want to get some rest?	ひと休みしますか？	scene_30
We'll secure the route. You come up later.	俺たちがルートを確保する。あとから来てくれ	scene_30
You know, I've been thinkin'…	ちょっとよ、考えたんだけど聞いてくれねぇか？	scene_30
Save it for later	あとにしてくれ	scene_30
…Seein' a place like this, makes you realize how awesome nature is.	……こういう風景を見てるとよう自然ってやつはホント、すげぇんだなって思うんだ	scene_30
But, if anyone ever told me to live here, I'd tell them to…well, you know…	こんなところに住めって言われたらオレは、迷わずカンベンしてくれって答えるぜ……	scene_30
I tell you one thing though, If I did have to live here I'd change things around 'n' make it better.	でも、もし住むことになったらきっと、いろいろ工夫して居心地よくしようとすると思うんだ	scene_30
I guess Midgar is the total opposite of this place.	そんな人間の工夫の行き着いたところが…………ミッドガルなのか	scene_30
When you think of it that way, the Shinra don't seem so bad…	そんなふうに考えちまうと神羅の何もかもが悪いとは言えなくなっちまう……	scene_30
Uuuuuurrrrrgh!!	うぉぉぉおおお！！	scene_30
What the hell am I sayin'!? The Shinra, not bad!?	オレとしたことが、なんてこった！神羅が悪くないだぁ！？	scene_30
Y'know…standing here like this…	こんなところに立ってるとよう……	scene_30
Kinda makes you feel like the Planet's not really with us, y'know?	星はオレたちの味方じゃねえって気がしてこねえか？	scene_30
Of course we can't even compete. I mean… The Planet don't even notice us humans…	もちろん敵なんかじゃねえけどよ。なんつうか、人間なんか相手にしてねえっつうか……	scene_30
Gotta keep telling myself this blizzard's okay…brr	こんな吹雪なんて、へっちゃらよ！そうでも言ってないと……もう……	scene_30
I wonder what's at the top of that cliff? Well we shall see…	絶壁のぼりきったらどうなってんのかな？　見たいな～	scene_30
Brrrr, I can't take this cold!!	う～、こんな寒いところもう、たえられない！！	scene_30
Damn! If I was back in the air, this cliff would be nothing!	クッソ～ィ！空を飛べればよ、絶壁なんてヒュ～～ッなのによっ！	scene_30
I wonder what's on the other side of that cliff…	絶壁の向こうには何があるのか……	scene_30
This is secret info, but… Rufus's going to arrive here, too.	これ、ヒミツ情報ですけどな。ルーファウスさんもまもなく到着しまっせ	scene_30
Look we can't go to the cliff! So just give it up!!	もう絶壁には行けないぞ！あきらめるんだ！！	scene_30
Change members?	メンバーチェンジしますか？	scene_30
Gaea's Cliff	ガイアの絶壁	scene_30
Degrees	度	scene_30
Received "Protection Ring"!	『守りの指輪』を手にいれた！	scene_30
Inside of Gaea's Cliff	絶壁内部	scene_30
Received "Javelin"!	『ジャベリン』を手にいれた！	scene_30
You can not take on any more Materia. Please discard some Materia.	これいじょうマテリアは持てません。なにかマテリアをすててください	scene_30
Push the rock over?	岩を落としますか？	scene_30
Push	落とす	scene_30
Dead end.	行き止まりだ	scene_30
Go up	上に進む	scene_30
Go down	下に進む	scene_30
Go right	右に進む	scene_30
Received "Enhance Sword"!	『エンハンスソード』を手にいれた！	scene_30
Received "Fire Armlet"!	『烈火の腕輪』を手にいれた！	scene_30
Jump down to the room below?	下の部屋に飛びおりますか？	scene_30
Go left	左に進む	scene_30
Go down right	右下に進む	scene_30
Ugh… Errgaahh!!	うっ……うわ～～っ！！	scene_30