Oh, here!!	お！　あったあった	scene_41
Put this on.	これに着替えろよ	scene_41
It smells a little, but don't complain.	ちょっとにおうけど　ま、ぜいたくは言うな	scene_41
You look pretty good with that.	けっこう似合ってるぞ	scene_41
Yo! Old guy! We at Midgar yet?	おい！　おっさん！　ミッドガルはまだか？	scene_41
Shaddap! You're lucky I even gave you a ride!	うるさい！乗せてやっただけでもありがたく思え！	scene_41
Hah!	チッ…	scene_41
What're you gonna do once we get to Midgar?	なあ、ミッドガルに着いたらおまえ、どうする？	scene_41
I know what I'm gonna do.	俺はあちこちにあてがあるんだ	scene_41
I got a place I can crash for a while…	みんなの世話んなって……	scene_41
No wait, the mother lives there too.	あ、どの女の子も親といっしょに住んでるのか……	scene_41
Guess that's out.	そりゃマズいよな～あ？	scene_41
Yep…gotta change my plans!	ダメだ…作戦チェンジ！	scene_41
Hmm…	う～ん……New	scene_41
No matter what I do, I need some money first…	何をどうするにしてもとりあえず金だよな……	scene_41
…Hey, wanna start a business? Now what could we do?	……商売でもはじめるか	scene_41
Hey, CLOUD.	な、Cloud。	scene_41
Think there's anything I'd be good at?	俺にできる商売ってあると思うか？	scene_41
Hey old guy!	なあ、おっさん！	scene_41
What do you think I'd be good at?	なんか俺にできるような商売知らないか？	scene_41
What're you yappin' about? You're still young ain't ya?	なに言ってんだ。若いんだろ？	scene_41
Young folks should try everything!	何でもやってみろ！若いうちは何でもやってみるもんだ	scene_41
You gotta pay your dues while you're young. Go out and look for what you really want.	若いうちにいろいろ苦労してなぁ。自分の道ってやつを探すのよ	scene_41
Yeah, whatever…	……なんでもやってみろ？	scene_41
Find my own way?	……自分の道だぁ？	scene_41
Try everything… That's easy for him to say.	なんでも、だってよ。そんなこと言われたってな…	scene_41
Of course!	そうだよな！New	scene_41
I got more brains and skill than most other guys!	俺は他のやつらが持ってない知識や技術をたくさん持ってるんだよな！	scene_41
That settles it!	俺、決めたぞ！	scene_41
I'm gonna become a mercenary!	俺は『なんでも屋』を	scene_41
Hey…didn't you even hear a word I said?	あんた…オレの話、ちゃんと聞いてたのか？	scene_41
Yeah! Thanks Pops!	おう！ありがとよ、おっさん！	scene_41
No, wait…you got it all wrong.	だから…そうじゃなくて	scene_41
Listen, I'm gonna become a mercenary and that's that.	おい、俺はなんでも屋になるぜ	scene_41
Boring stuff, dangerous stuff, anything for money.	面倒なこと、危険なこと報酬しだいでなんでもやるんだ	scene_41
I'm gonna be rich!	こりゃ、もうかるぞ～	scene_41
So, CLOUD? What are YOU gonna do?	な、Cloud。おまえはどうする？	scene_41
U…uhhh…	う…ぁぁあ…	scene_41
Just kidding… I won't leave you hanging like that.	……冗談だよおまえを放り出したりはしないよ	scene_41
We're friends, right?	……トモダチ、だろ？	scene_41
Mercenaries. CLOUD. That's what you an' me are gonna be.	はははは……照れるぜ	scene_41
Mercenaries. CLOUD. That's what you an' me are gonna be.	なんでも屋だ、Cloud。俺たちはなんでも屋をやるんだ	scene_41
Understand, CLOUD?	わかるか、Cloud？	scene_41
What do you want to do with him?	こいつ、どうします？	scene_41
…Ah…ughhhh…	ああ……うあぁぁぁ……	scene_41
Commander	指揮官	scene_41
Forget it. Just leave him.	……これはダメだな。放っておけ	scene_41
uh…uhhh…Za…Zack…	うぅ……あぁああ……ザ……ザッ……クス	scene_41