<div class='jp'>アイテム</div>	<div class='jp'>アイテム</div> <div class='meaning'>Item</div> 
<div class='jp'>魔法</div>	<div class='jp'><ruby><rb>魔法</rb><rt>まほう</rt></ruby></div> <div class='meaning'>Magic Materia</div>  <br/> <div class='stroke'>魔法</div> 
<div class='jp'>マテリア</div>	<div class='jp'>マテリア</div> <div class='meaning'>Materia</div> 
<div class='jp'>装備</div>	<div class='jp'><ruby><rb>装備</rb><rt>そうび</rt></ruby></div> <div class='meaning'>Equip</div>  <br/> <div class='stroke'>装備</div> 
<div class='jp'>ステータス</div>	<div class='jp'>ステータス</div> <div class='meaning'>Status</div> 
<div class='jp'>隊形</div>	<div class='jp'><ruby><rb>隊形</rb><rt>たいけい</rt></ruby></div> <div class='meaning'>Order</div>  <br/> <div class='stroke'>隊形</div> 
<div class='jp'>リミット</div>	<div class='jp'>リミット</div> <div class='meaning'>Limit</div> 
<div class='jp'>コンフィグ</div>	<div class='jp'>コンフィグ</div> <div class='meaning'>Config</div> 
<div class='jp'>ＰＨＳ</div>	<div class='jp'><ruby><rb>ＰＨＳ</rb><rt>ぴーえいちえす</rt></ruby></div> <div class='meaning'>PHS</div> 
<div class='jp'>セーブ</div>	<div class='jp'>セーブ</div> <div class='meaning'>Save</div> 
<div class='jp'>しゅうりょう</div>	<div class='jp'>しゅうりょう</div> <div class='meaning'>Quit</div> 
<div class='jp'>リミットレベル</div>	<div class='jp'>リミットレベル</div> <div class='meaning'>Limit level</div> 
<div class='jp'>ちから</div>	<div class='jp'>ちから</div> <div class='meaning'>Strength</div> 
<div class='jp'>すばやさ</div>	<div class='jp'>すばやさ</div> <div class='meaning'>Dexterity</div> 
<div class='jp'>たいりょく</div>	<div class='jp'>たいりょく</div> <div class='meaning'>Vitality</div> 
<div class='jp'>まりょく</div>	<div class='jp'>まりょく</div> <div class='meaning'>Magic</div> 
<div class='jp'>せいしん</div>	<div class='jp'>せいしん</div> <div class='meaning'>Spirit</div> 
<div class='jp'>うん</div>	<div class='jp'>うん</div> <div class='meaning'>Luck</div> 
<div class='jp'>こうげきりょく</div>	<div class='jp'>こうげきりょく</div> <div class='meaning'>Attack</div> 
<div class='jp'>めいちゅうりつ</div>	<div class='jp'>めいちゅうりつ</div> <div class='meaning'>Attack%</div> 
<div class='jp'>ぼうぎょりょく</div>	<div class='jp'>ぼうぎょりょく</div> <div class='meaning'>Defense</div> 
<div class='jp'>かいひりつ</div>	<div class='jp'>かいひりつ</div> <div class='meaning'>Defense%</div> 
<div class='jp'>まほうこうげき</div>	<div class='jp'>まほうこうげき</div> <div class='meaning'>Magic atk</div> 
<div class='jp'>まほうぼうぎょ</div>	<div class='jp'>まほうぼうぎょ</div> <div class='meaning'>Magic def</div> 
<div class='jp'>まほうかいひりつ</div>	<div class='jp'>まほうかいひりつ</div> <div class='meaning'>Magic def%</div> 
<div class='jp'>じかん</div>	<div class='jp'>じかん</div> <div class='meaning'>Time</div> 
<div class='jp'>ギル</div>	<div class='jp'>ギル</div> <div class='meaning'>Gil</div> 
<div class='jp'>経験値</div>	<div class='jp'><ruby><rb>経験値</rb><rt>けいけんち</rt></ruby></div> <div class='meaning'>EXP</div>  <br/> <div class='stroke'>経験値</div> 
<div class='jp'>ＡＰ</div>	<div class='jp'><ruby><rb>ＡＰ</rb><rt>えいぴー</rt></ruby></div> <div class='meaning'>AP</div> 
<div class='jp'>ＧＰ</div>	<div class='jp'><ruby><rb>ＧＰ</rb><rt>じーぴー</rt></ruby></div> <div class='meaning'>GP</div> 
<div class='jp'>ＢＰ</div>	<div class='jp'>ＢＰ</div> <div class='meaning'>BP</div> 
<div class='jp'>炎</div>	<div class='jp'><ruby><rb>炎</rb><rt>ほのお</rt></ruby></div> <div class='meaning'>Fire (lit. 'Flame')</div>  <br/> <div class='stroke'>炎</div> 
<div class='jp'>冷</div>	<div class='jp'><ruby><rb>冷</rb><rt>れい</rt></ruby></div> <div class='meaning'>Ice (lit. 'Cold')</div>  <br/> <div class='stroke'>冷</div> 
<div class='jp'>雷</div>	<div class='jp'><ruby><rb>雷</rb><rt>かみなり</rt></ruby></div> <div class='meaning'>Lightning (lit. 'Thunder')</div>  <br/> <div class='stroke'>雷</div> 
<div class='jp'>土</div>	<div class='jp'><ruby><rb>土</rb><rt>つち</rt></ruby></div> <div class='meaning'>Earth</div>  <br/> <div class='stroke'>土</div> 
<div class='jp'>毒</div>	<div class='jp'><ruby><rb>毒</rb><rt>どく</rt></ruby></div> <div class='meaning'>Poison</div>  <br/> <div class='stroke'>毒</div> 
<div class='jp'>重力</div>	<div class='jp'><ruby><rb>重力</rb><rt>じゅうりょく</rt></ruby></div> <div class='meaning'>Gravity</div>  <br/> <div class='stroke'>重力</div> 
<div class='jp'>水</div>	<div class='jp'><ruby><rb>水</rb><rt>みず</rt></ruby></div> <div class='meaning'>Water</div>  <br/> <div class='stroke'>水</div> 
<div class='jp'>風</div>	<div class='jp'><ruby><rb>風</rb><rt>かぜ</rt></ruby></div> <div class='meaning'>Wind</div>  <br/> <div class='stroke'>風</div> 
<div class='jp'>聖</div>	<div class='jp'><ruby><rb>聖</rb><rt>せい</rt></ruby></div> <div class='meaning'>Holy</div>  <br/> <div class='stroke'>聖</div> 
<div class='jp'>１０番目の属性</div>	<div class='jp'>１０<ruby><rb>番目</rb><rt>ばんめ</rt></ruby>の<ruby><rb>属性</rb><rt>ぞくせい</rt></ruby></div> <div class='meaning'>Hidden* (lit. 'Tenth Attribute')</div>  <br/> <div class='stroke'>番目属性</div> 
<div class='jp'>斬る</div>	<div class='jp'><ruby><rb>斬</rb><rt>き</rt></ruby>る</div> <div class='meaning'>Cut</div>  <br/> <div class='stroke'>斬</div> 
<div class='jp'>殴る</div>	<div class='jp'><ruby><rb>殴</rb><rt>なぐ</rt></ruby>る</div> <div class='meaning'>Hit (lit. 'Strike')</div>  <br/> <div class='stroke'>殴</div> 
<div class='jp'>突く</div>	<div class='jp'><ruby><rb>突</rb><rt>つ</rt></ruby>く</div> <div class='meaning'>Punch (lit. 'Thrust')</div>  <br/> <div class='stroke'>突</div> 
<div class='jp'>射撃</div>	<div class='jp'><ruby><rb>射撃</rb><rt>しゃげき</rt></ruby></div> <div class='meaning'>Shoot (lit. 'Shot')</div>  <br/> <div class='stroke'>射撃</div> 
<div class='jp'>回復</div>	<div class='jp'><ruby><rb>回復</rb><rt>かいふく</rt></ruby></div> <div class='meaning'>Restorative (lit. 'Recovery')</div>  <br/> <div class='stroke'>回復</div> 
<div class='jp'>叫ぶ</div>	<div class='jp'><ruby><rb>叫</rb><rt>さけ</rt></ruby>ぶ</div> <div class='meaning'>Shout</div>  <br/> <div class='stroke'>叫</div> 
<div class='jp'>睡眠</div>	<div class='jp'><ruby><rb>睡眠</rb><rt>すいみん</rt></ruby></div> <div class='meaning'>Sleep</div>  <br/> <div class='stroke'>睡眠</div> 
<div class='jp'>怒り</div>	<div class='jp'><ruby><rb>怒</rb><rt>いか</rt></ruby>り</div> <div class='meaning'>Fury (lit. 'Anger')</div>  <br/> <div class='stroke'>怒</div> 
<div class='jp'>悲しい</div>	<div class='jp'><ruby><rb>悲</rb><rt>かな</rt></ruby>しい</div> <div class='meaning'>Sadness (lit. 'Sorrow')</div>  <br/> <div class='stroke'>悲</div> 
<div class='jp'>石化</div>	<div class='jp'><ruby><rb>石</rb><rt>せき</rt></ruby><ruby><rb>化</rb><rt>か</rt></ruby></div> <div class='meaning'>Petrify (lit. 'Petrification')</div>  <br/> <div class='stroke'>石化</div> 
<div class='jp'>徐々に石化</div>	<div class='jp'><ruby><rb>徐々</rb><rt>じょじょ</rt></ruby>に<ruby><rb>石</rb><rt>せき</rt></ruby><ruby><rb>化</rb><rt>か</rt></ruby></div> <div class='meaning'>Slow-Numb (lit. 'Gradual Petrification')</div>  <br/> <div class='stroke'>徐石化</div> 
<div class='jp'>混乱</div>	<div class='jp'><ruby><rb>混乱</rb><rt>こんらん</rt></ruby></div> <div class='meaning'>Confuse (lit. 'Confusion')</div>  <br/> <div class='stroke'>混乱</div> 
<div class='jp'>沈黙</div>	<div class='jp'><ruby><rb>沈黙</rb><rt>ちんもく</rt></ruby></div> <div class='meaning'>Silence</div>  <br/> <div class='stroke'>沈黙</div> 
<div class='jp'>マヒ</div>	<div class='jp'>マヒ</div> <div class='meaning'>Paralyzed (lit. 'Paralysis')</div> 
<div class='jp'>暗闇</div>	<div class='jp'><ruby><rb>暗闇</rb><rt>くらやみ</rt></ruby></div> <div class='meaning'>Darkness</div>  <br/> <div class='stroke'>暗闇</div> 
<div class='jp'>蛙</div>	<div class='jp'><ruby><rb>蛙</rb><rt>かえる</rt></ruby></div> <div class='meaning'>Frog</div>  <br/> <div class='stroke'>蛙</div> 
<div class='jp'>小</div>	<div class='jp'><ruby><rb>小</rb><rt>ミニマム</rt></ruby></div> <div class='meaning'>Small (lit. 'Minimum')</div>  <br/> <div class='stroke'>小</div> 
<div class='jp'>瀕死</div>	<div class='jp'><ruby><rb>瀕死</rb><rt>ひんし</rt></ruby></div> <div class='meaning'>Near-death (lit. 'Near Death')</div>  <br/> <div class='stroke'>瀕死</div> 
<div class='jp'>戦闘不能（死）</div>	<div class='jp'><ruby><rb>戦闘</rb><rt>せんとう</rt></ruby><ruby><rb>不能</rb><rt>ふのう</rt></ruby>（<ruby><rb>死</rb><rt>し</rt></ruby>）</div> <div class='meaning'>Death (lit. 'Unable to Fight (Death)')</div>  <br/> <div class='stroke'>戦闘不能死</div> 
<div class='jp'>死の宣告</div>	<div class='jp'><ruby><rb>死</rb><rt>し</rt></ruby>の<ruby><rb>宣告</rb><rt>せんこく</rt></ruby></div> <div class='meaning'>Death Sentence</div>  <br/> <div class='stroke'>死宣告</div> 
<div class='jp'>操る</div>	<div class='jp'><ruby><rb>操</rb><rt>あやつ</rt></ruby>る</div> <div class='meaning'>Manipulate (lit. 'Manipulation')</div>  <br/> <div class='stroke'>操</div> 
<div class='jp'>闘</div>	<div class='jp'>闘</div> <div class='meaning'>Berserk</div>  <br/> <div class='stroke'>闘</div> 
<div class='jp'>無敵</div>	<div class='jp'><ruby><rb>無敵</rb><rt>むてき</rt></ruby></div> <div class='meaning'>Peerless (lit. 'Invincible')</div>  <br/> <div class='stroke'>無敵</div> 
<div class='jp'>速い</div>	<div class='jp'><ruby><rb>速</rb><rt>はや</rt></ruby>い</div> <div class='meaning'>Haste (lit. 'Fast')</div>  <br/> <div class='stroke'>速</div> 
<div class='jp'>遅く</div>	<div class='jp'><ruby><rb>遅</rb><rt>おそ</rt></ruby>く</div> <div class='meaning'>Slow</div>  <br/> <div class='stroke'>遅</div> 
<div class='jp'>停止</div>	<div class='jp'><ruby><rb>停止</rb><rt>ていし</rt></ruby></div> <div class='meaning'>Stop</div>  <br/> <div class='stroke'>停止</div> 
<div class='jp'>バリア (物的)</div>	<div class='jp'>バリア(<ruby><rb>物的</rb><rt>ぶってき</rt></ruby>)</div> <div class='meaning'>Barrier (lit. 'Barrier (Physical)')</div>  <br/> <div class='stroke'>物的</div> 
<div class='jp'>バリア (魔法的)</div>	<div class='jp'>バリア(<ruby><rb>魔法的</rb><rt>まほうてき</rt></ruby>)</div> <div class='meaning'>MBarrier (lit. 'Barrier (Magic)')</div>  <br/> <div class='stroke'>魔法的</div> 
<div class='jp'>反射</div>	<div class='jp'><ruby><rb>反射</rb><rt>はんしゃ</rt></ruby></div> <div class='meaning'>Reflect (lit. 'Reflection')</div>  <br/> <div class='stroke'>反射</div> 
<div class='jp'>シールド（防衛）</div>	<div class='jp'>シールド（<ruby><rb>防衛</rb><rt>ぼうえい</rt></ruby>）</div> <div class='meaning'>Shield (lit. 'Shield (Defense)')</div>  <br/> <div class='stroke'>防衛</div> 
<div class='jp'>ブレイバー</div>	<div class='jp'>ブレイバー</div> <div class='meaning'>Braver</div> 
<div class='jp'>凶斬り</div>	<div class='jp'><ruby><rb>凶</rb><rt>きょう</rt></ruby><ruby><rb>斬</rb><rt>き</rt></ruby>り</div> <div class='meaning'>Cross-slash (lit. 'Evil Slash')</div>  <br/> <div class='stroke'>凶斬</div> 
<div class='jp'>破晄撃</div>	<div class='jp'><ruby><rb>破</rb><rt>は</rt></ruby><ruby><rb>晄</rb><rt>こう</rt></ruby><ruby><rb>撃</rb><rt>げき</rt></ruby></div> <div class='meaning'>Blade Beam (lit. 'Rending Light Attack')</div>  <br/> <div class='stroke'>破晄撃</div> 
<div class='jp'>クライムハザード</div>	<div class='jp'>クライムハザード</div> <div class='meaning'>Climhazzard (lit. 'Climb Hazard')</div> 
<div class='jp'>メテオレイン</div>	<div class='jp'>メテオレイン</div> <div class='meaning'>Meteorain (lit. 'Meteor Rain')</div> 
<div class='jp'>画龍点睛</div>	"<div class='jp'><ruby><rb>画龍点睛</rb><rt><span style=""color: rgb(34, 34, 34);"">が</span><span style=""color: rgb(34, 34, 34);"">りょう</span><span style=""color: rgb(34, 34, 34);"">てん</span><span style=""color: rgb(34, 34, 34);"">せい</span></rt></ruby></div> <div class='meaning'>Finishing Touch</div>  <br/> <div class='stroke'>画龍点睛</div> "
<div class='jp'>超究武神覇斬</div>	<div class='jp'><ruby><rb>超</rb><rt>ちょう</rt></ruby><ruby><rb>究</rb><rt>きゅう</rt></ruby><ruby><rb>武神</rb><rt>ぶしん</rt></ruby><ruby><rb>覇</rb><rt>は</rt></ruby><ruby><rb>斬</rb><rt>ざん</rt></ruby></div> <div class='meaning'>Omnislash (lit. 'Transultimate Wargod Supremacy Slash')</div>  <br/> <div class='stroke'>超究武神覇斬</div> 
<div class='jp'>ヘビーショット</div>	<div class='jp'>ヘビーショット</div> <div class='meaning'>Big Shot (lit. 'Heavy Shot')</div> 
<div class='jp'>マインドブレイク</div>	<div class='jp'>マインドブレイク</div> <div class='meaning'>Mindblow (lit. 'Mind Break')</div> 
<div class='jp'>グレネードボム</div>	<div class='jp'>グレネードボム</div> <div class='meaning'>Grenade Bomb</div> 
<div class='jp'>ハンマーブロウ</div>	<div class='jp'>ハンマーブロウ</div> <div class='meaning'>Hammer Blow</div> 
<div class='jp'>サテライトビーム</div>	<div class='jp'>サテライトビーム</div> <div class='meaning'>Satellite Beam</div> 
<div class='jp'>アンガーマックス</div>	<div class='jp'>アンガーマックス</div> <div class='meaning'>Angermax (lit. 'Anger Max')</div> 
<div class='jp'>カタストロフィ</div>	<div class='jp'>カタストロフィ</div> <div class='meaning'>Catastrophe</div> 
<div class='jp'>掌打ラッシュ</div>	<div class='jp'><ruby><rb>掌</rb><rt>しょう</rt></ruby><ruby><rb>打</rb><rt>だ</rt></ruby>ラッシュ</div> <div class='meaning'>Beat Rush (lit. 'Palm Rush')</div>  <br/> <div class='stroke'>掌打</div> 
<div class='jp'>サマーソルト</div>	<div class='jp'>サマーソルト</div> <div class='meaning'>Somersault</div> 
<div class='jp'>水面蹴り</div>	<div class='jp'><ruby><rb>水面</rb><rt>すいめん</rt></ruby><ruby><rb>蹴</rb><rt>げ</rt></ruby>り</div> <div class='meaning'>Waterkick (lit. 'Surface Sweep')</div>  <br/> <div class='stroke'>水面蹴</div> 
<div class='jp'>メテオドライヴ</div>	<div class='jp'>メテオドライヴ</div> <div class='meaning'>Meteodrive (lit. 'Meteor Drive')</div> 
<div class='jp'>ドルフィンブロウ</div>	<div class='jp'>ドルフィンブロウ</div> <div class='meaning'>Dolphin Blow</div> 
<div class='jp'>メテオストライク</div>	<div class='jp'>メテオストライク</div> <div class='meaning'>Meteor Strike</div> 
<div class='jp'>ファイナルヘヴン</div>	<div class='jp'>ファイナルヘヴン</div> <div class='meaning'>Final Heaven</div> 
<div class='jp'>癒しの風</div>	<div class='jp'><ruby><rb>癒</rb><rt>いや</rt></ruby>しの<ruby><rb>風</rb><rt>かぜ</rt></ruby></div> <div class='meaning'>Healing Wind</div>  <br/> <div class='stroke'>癒風</div> 
<div class='jp'>邪気封印</div>	<div class='jp'><ruby><rb>邪気</rb><rt>じゃき</rt></ruby><ruby><rb>封印</rb><rt>ふういん</rt></ruby></div> <div class='meaning'>Seal Evil (lit. 'Evil Spirit Seal')</div>  <br/> <div class='stroke'>邪気封印</div> 
<div class='jp'>大地の息吹</div>	<div class='jp'><ruby><rb>大地</rb><rt>だいち</rt></ruby>の<ruby><rb>息吹</rb><rt>いぶき</rt></ruby></div> <div class='meaning'>Breath of the Earth</div>  <br/> <div class='stroke'>大地息吹</div> 
<div class='jp'>怒りの烙印</div>	<div class='jp'><ruby><rb>怒</rb><rt>いか</rt></ruby>りの<ruby><rb>烙印</rb><rt>らくいん</rt></ruby></div> <div class='meaning'>Fury Brand (lit. 'Mark of Anger')</div>  <br/> <div class='stroke'>怒烙印</div> 
<div class='jp'>星の守護</div>	<div class='jp'><ruby><rb>星</rb><rt>ほし</rt></ruby>の<ruby><rb>守護</rb><rt>しゅご</rt></ruby></div> <div class='meaning'>Planet Protector (lit. 'Star Guardian')</div>  <br/> <div class='stroke'>星守護</div> 
<div class='jp'>生命の鼓動</div>	<div class='jp'><ruby><rb>生命</rb><rt>せいめい</rt></ruby>の<ruby><rb>鼓動</rb><rt>こどう</rt></ruby></div> <div class='meaning'>Pulse of Life</div>  <br/> <div class='stroke'>生命鼓動</div> 
<div class='jp'>大いなる福音</div>	<div class='jp'><ruby><rb>大</rb><rt>おお</rt></ruby>いなる<ruby><rb>福音</rb><rt>ふくいん</rt></ruby></div> <div class='meaning'>Great Gospel</div>  <br/> <div class='stroke'>大福音</div> 
<div class='jp'>スレッドファング</div>	<div class='jp'>スレッドファング</div> <div class='meaning'>Sled Fang</div> 
<div class='jp'>ルナティックハイ</div>	<div class='jp'>ルナティックハイ</div> <div class='meaning'>Lunatic High</div> 
<div class='jp'>ブラッドファング</div>	<div class='jp'>ブラッドファング</div> <div class='meaning'>Blood Fang</div> 
<div class='jp'>スターダストレイ</div>	<div class='jp'>スターダストレイ</div> <div class='meaning'>Stardust Ray</div> 
<div class='jp'>ハウリングムーン</div>	<div class='jp'>ハウリングムーン</div> <div class='meaning'>Howling Moon</div> 
<div class='jp'>アースレイヴ</div>	<div class='jp'>アースレイヴ</div> <div class='meaning'>Earth Rave</div> 
<div class='jp'>コスモメモリー</div>	<div class='jp'>コスモメモリー</div> <div class='meaning'>Cosmo Memory</div> 
<div class='jp'>ダイス</div>	<div class='jp'>ダイス</div> <div class='meaning'>Dice</div> 
<div class='jp'>スロット</div>	<div class='jp'>スロット</div> <div class='meaning'>Slots (lit. 'Slot')</div> 
<div class='jp'>トイボックス</div>	<div class='jp'>トイボックス</div> <div class='meaning'>Toy Box</div> 
<div class='jp'>トイソルジャー</div>	<div class='jp'>トイソルジャー</div> <div class='meaning'>Toy Soldier</div> 
<div class='jp'>モーグリダンス</div>	<div class='jp'>モーグリダンス</div> <div class='meaning'>Mog Dance (lit. 'Moogle Dance')</div> 
<div class='jp'>ラッキーガール</div>	<div class='jp'>ラッキーガール</div> <div class='meaning'>Lucky Girl</div> 
<div class='jp'>ジョーカーデス</div>	<div class='jp'>ジョーカーデス</div> <div class='meaning'>Death Joker (lit. 'Joker Death')</div> 
<div class='jp'>合体</div>	<div class='jp'><ruby><rb>合体</rb><rt>がったい</rt></ruby></div> <div class='meaning'>Transform (lit. 'Combine')</div>  <br/> <div class='stroke'>合体</div> 
<div class='jp'>オールオーバー</div>	<div class='jp'>オールオーバー</div> <div class='meaning'>Game Over (lit. 'All Over')</div> 
<div class='jp'>ブーストジャンプ</div>	<div class='jp'>ブーストジャンプ</div> <div class='meaning'>Boost Jump</div> 
<div class='jp'>ダイナマイト</div>	<div class='jp'>ダイナマイト</div> <div class='meaning'>Dynamite</div> 
<div class='jp'>ハイパージャンプ</div>	<div class='jp'>ハイパージャンプ</div> <div class='meaning'>Hyper Jump</div> 
<div class='jp'>ドラゴンモッド</div>	<div class='jp'>ドラゴンモッド</div> <div class='meaning'>Dragon (lit. 'Dragon Mod')</div> 
<div class='jp'>ドラゴンダイブ</div>	<div class='jp'>ドラゴンダイブ</div> <div class='meaning'>Dragon Dive</div> 
<div class='jp'>大乱闘</div>	<div class='jp'><ruby><rb>大</rb><rt>だい</rt></ruby><ruby><rb>乱闘</rb><rt>らんとう</rt></ruby></div> <div class='meaning'>Big Brawl</div>  <br/> <div class='stroke'>大乱闘</div> 
<div class='jp'>ハイウインド</div>	<div class='jp'>ハイウインド</div> <div class='meaning'>Highwind</div> 
<div class='jp'>ガリアンビースト</div>	<div class='jp'>ガリアンビースト</div> <div class='meaning'>Galian Beast (lit. 'Gaulian Beast')</div> 
<div class='jp'>ビーストフレア</div>	<div class='jp'>ビーストフレア</div> <div class='meaning'>Beast Flare</div> 
<div class='jp'>バーサクダンス</div>	<div class='jp'>バーサクダンス</div> <div class='meaning'>Berserk Dance</div> 
<div class='jp'>デスギガス</div>	<div class='jp'>デスギガス</div> <div class='meaning'>Death Gigas</div> 
<div class='jp'>ギガダンク</div>	<div class='jp'>ギガダンク</div> <div class='meaning'>Gigadunk (lit. 'Giga Dunk')</div> 
<div class='jp'>ライブスパーク</div>	<div class='jp'>ライブスパーク</div> <div class='meaning'>Livewire (lit. 'Live Spark')</div> 
<div class='jp'>ヘルマスカー</div>	<div class='jp'>ヘルマスカー</div> <div class='meaning'>Hell Masker</div> 
<div class='jp'>スプラッタコンボ</div>	<div class='jp'>スプラッタコンボ</div> <div class='meaning'>Splattercombo (lit. 'Splatter Combo')</div> 
<div class='jp'>ナイトメア</div>	<div class='jp'>ナイトメア</div> <div class='meaning'>Nightmare</div> 
<div class='jp'>カオス</div>	<div class='jp'>カオス</div> <div class='meaning'>Chaos</div> 
<div class='jp'>カオスセイバー</div>	<div class='jp'>カオスセイバー</div> <div class='meaning'>Chaos Saber</div> 
<div class='jp'>サタンインパクト</div>	<div class='jp'>サタンインパクト</div> <div class='meaning'>Satan Slam (lit. 'Satan Impact')</div> 
<div class='jp'>疾風迅雷</div>	<div class='jp'><ruby><rb>疾風迅雷</rb><rt>しっぷうじんらい</rt></ruby></div> <div class='meaning'>Greased Lightning (lit. 'Gale Thunderclap')</div>  <br/> <div class='stroke'>疾風迅雷</div> 
<div class='jp'>明鏡止水</div>	<div class='jp'><ruby><rb>明鏡止水</rb><rt>めいきょうしすい</rt></ruby></div> <div class='meaning'>Clear Tranquil (lit. 'Tranquil Mind')</div>  <br/> <div class='stroke'>明鏡止水</div> 
<div class='jp'>抜山蓋世</div>	<div class='jp'><ruby><rb>抜山蓋世</rb><rt>ばつざんがいせい</rt></ruby></div> <div class='meaning'>Landscaper (lit. 'Power to Move Mountains')</div>  <br/> <div class='stroke'>抜山蓋世</div> 
<div class='jp'>血祭</div>	<div class='jp'><ruby><rb>血祭</rb><rt>ちまつり</rt></ruby></div> <div class='meaning'>Bloodfest (lit. 'Blood Festival')</div>  <br/> <div class='stroke'>血祭</div> 
<div class='jp'>鎧袖一触</div>	<div class='jp'><ruby><rb>鎧袖一触</rb><rt>がいしゅういっしょく</rt></ruby></div> <div class='meaning'>Gauntlet (lit. 'Armored Sleeve Single Blow')</div>  <br/> <div class='stroke'>鎧袖一触</div> 
<div class='jp'>生者必滅</div>	<div class='jp'><ruby><rb>生者必滅</rb><rt>しょうじゃひつめつ</rt></ruby></div> <div class='meaning'>Doom of the Living (lit. 'All Living Things Must Die')</div>  <br/> <div class='stroke'>生者必滅</div> 
<div class='jp'>森羅万象</div>	<div class='jp'><ruby><rb>森羅万象</rb><rt>しんらばんしょう</rt></ruby></div> <div class='meaning'>All Creation (lit. 'All Things In Nature')</div>  <br/> <div class='stroke'>森羅万象</div> 
<div class='jp'>召喚</div>	<div class='jp'><ruby><rb>召喚</rb><rt>しょうかん</rt></ruby></div> <div class='meaning'>Summon Materia</div>  <br/> <div class='stroke'>召喚</div> 
<div class='jp'>独立</div>	<div class='jp'><ruby><rb>独立</rb><rt>どくりつ</rt></ruby></div> <div class='meaning'>Independent Materia</div>  <br/> <div class='stroke'>独立</div> 
<div class='jp'>支援</div>	<div class='jp'><ruby><rb>支援</rb><rt>しえん</rt></ruby></div> <div class='meaning'>Support Materia</div>  <br/> <div class='stroke'>支援</div> 
<div class='jp'>コマンド</div>	<div class='jp'>コマンド</div> <div class='meaning'>Command Materia</div> 
<div class='jp'>れいき</div>	<div class='jp'>れいき</div> <div class='meaning'>Ice (lit. 'Cold')</div> 
<div class='jp'>ほのお</div>	<div class='jp'>ほのお</div> <div class='meaning'>Fire (lit. 'Flame')</div> 
<div class='jp'>いかずち</div>	<div class='jp'>いかずち</div> <div class='meaning'>Lightning</div> 
<div class='jp'>かいふく</div>	<div class='jp'>かいふく</div> <div class='meaning'>Restore (lit. 'Recovery')</div> 
<div class='jp'>どく</div>	<div class='jp'>どく</div> <div class='meaning'>Poison</div> 
<div class='jp'>だいち</div>	<div class='jp'>だいち</div> <div class='meaning'>Earth</div> 
<div class='jp'>ちりょう</div>	<div class='jp'>ちりょう</div> <div class='meaning'>Heal (lit. 'Treatment')</div> 
<div class='jp'>そせい</div>	<div class='jp'>そせい</div> <div class='meaning'>Revive (lit. 'Resurrection')</div> 
<div class='jp'>ふうじる</div>	<div class='jp'>ふうじる</div> <div class='meaning'>Seal (lit. 'Close')</div> 
<div class='jp'>へんしん</div>	<div class='jp'>へんしん</div> <div class='meaning'>Transform</div> 
<div class='jp'>まどわす</div>	<div class='jp'>まどわす</div> <div class='meaning'>Mystify (lit. 'Bewilder')</div> 
<div class='jp'>じゅうりょく</div>	<div class='jp'>じゅうりょく</div> <div class='meaning'>Gravity</div> 
<div class='jp'>しょうめつ</div>	<div class='jp'>しょうめつ</div> <div class='meaning'>Destruct (lit. 'Annihilation')</div> 
<div class='jp'>バリア</div>	<div class='jp'>バリア</div> <div class='meaning'>Barrier</div> 
<div class='jp'>りだつ</div>	<div class='jp'>りだつ</div> <div class='meaning'>Exit (lit. 'Withdrawal')</div> 
<div class='jp'>いんせき</div>	<div class='jp'>いんせき</div> <div class='meaning'>Comet (lit. 'Meteorite')</div> 
<div class='jp'>フルケア</div>	<div class='jp'>フルケア</div> <div class='meaning'>Full Cure (lit. 'Full Care')</div> 
<div class='jp'>ふういん</div>	<div class='jp'>ふういん</div> <div class='meaning'>Contain (lit. 'Seal')</div> 
<div class='jp'>シールド</div>	<div class='jp'>シールド</div> <div class='meaning'>Shield</div> 
<div class='jp'>アルテマ</div>	<div class='jp'>アルテマ</div> <div class='meaning'>Ultima</div> 
<div class='jp'>マスターまほう</div>	<div class='jp'>マスターまほう</div> <div class='meaning'>Master Magic</div> 
<div class='jp'>チョコボ＆モーグリ</div>	<div class='jp'>チョコボ<ruby><rb>＆</rb><rt>あんど</rt></ruby>モーグリ</div> <div class='meaning'>Choco/Mog (lit. 'Chocobo & Moogle')</div> 
<div class='jp'>シヴァ</div>	<div class='jp'>シヴァ</div> <div class='meaning'>Shiva</div> 
<div class='jp'>イフリート</div>	<div class='jp'>イフリート</div> <div class='meaning'>Ifrit</div> 
<div class='jp'>ラムウ</div>	<div class='jp'>ラムウ</div> <div class='meaning'>Ramuh</div> 
<div class='jp'>タイタン</div>	<div class='jp'>タイタン</div> <div class='meaning'>Titan</div> 
<div class='jp'>オーディーン</div>	<div class='jp'>オーディーン</div> <div class='meaning'>Odin</div> 
<div class='jp'>バハムート</div>	<div class='jp'>バハムート</div> <div class='meaning'>Bahamut</div> 
<div class='jp'>リヴァイアサン</div>	<div class='jp'>リヴァイアサン</div> <div class='meaning'>Leviathan</div> 
<div class='jp'>クジャタ</div>	<div class='jp'>クジャタ</div> <div class='meaning'>Kujata</div> 
<div class='jp'>アレクサンダー</div>	<div class='jp'>アレクサンダー</div> <div class='meaning'>Alexander</div> 
<div class='jp'>バハムート改</div>	<div class='jp'>バハムート<ruby><rb>改</rb><rt>あらため</rt></ruby></div> <div class='meaning'>Neo Bahamut (lit. 'Bahamut Modified')</div>  <br/> <div class='stroke'>改</div> 
<div class='jp'>フェニックス</div>	<div class='jp'>フェニックス</div> <div class='meaning'>Phoenix</div> 
<div class='jp'>ハーデス</div>	<div class='jp'>ハーデス</div> <div class='meaning'>Hades</div> 
<div class='jp'>バハムート零式</div>	<div class='jp'>バハムート<ruby><rb>零</rb><rt>れい</rt></ruby><ruby><rb>式</rb><rt>しき</rt></ruby></div> <div class='meaning'>Bahamut ZERO (lit. 'Bahamut Type Zero')</div>  <br/> <div class='stroke'>零式</div> 
<div class='jp'>テュポーン</div>	<div class='jp'>テュポーン</div> <div class='meaning'>Typhon</div> 
<div class='jp'>ナイツオブラウンド</div>	<div class='jp'>ナイツオブラウンド</div> <div class='meaning'>Knights of the Round (lit. 'Knights of Round')</div> 
<div class='jp'>マスターしょうかん</div>	<div class='jp'>マスターしょうかん</div> <div class='meaning'>Master Summon</div> 
<div class='jp'>ぬすむ</div>	<div class='jp'>ぬすむ</div> <div class='meaning'>Steal</div> 
<div class='jp'>みやぶる</div>	<div class='jp'>みやぶる</div> <div class='meaning'>Sense (lit. 'Uncover')</div> 
<div class='jp'>てきのわざ</div>	<div class='jp'>てきのわざ</div> <div class='meaning'>E.Skill (lit. 'Enemy Skill')</div> 
<div class='jp'>なげる</div>	<div class='jp'>なげる</div> <div class='meaning'>Throw</div> 
<div class='jp'>あやつる</div>	<div class='jp'>あやつる</div> <div class='meaning'>Manip. (lit. 'Manipulate')</div> 
<div class='jp'>ひっさつ</div>	<div class='jp'>ひっさつ</div> <div class='meaning'>D.blow (lit. 'Deathblow')</div> 
<div class='jp'>へんか</div>	<div class='jp'>へんか</div> <div class='meaning'>Morph (lit. 'Transform')</div> 
<div class='jp'>れんぞくぎり</div>	<div class='jp'>れんぞくぎり</div> <div class='meaning'>2x-Cut (lit. 'Continuous Slash')</div> 
<div class='jp'>ぜんたいぎり</div>	<div class='jp'>ぜんたいぎり</div> <div class='meaning'>Slash-All (lit. 'Slash All')</div> 
<div class='jp'>ものまね</div>	<div class='jp'>ものまね</div> <div class='meaning'>Mime (lit. 'Mimic')</div> 
<div class='jp'>Ｗしょうかん</div>	<div class='jp'><ruby><rb>Ｗ</rb><rt>だぶりゅー</rt></ruby>しょうかん</div> <div class='meaning'>W-Summon (lit. 'Double Summon')</div> 
<div class='jp'>Ｗまほう</div>	<div class='jp'><ruby><rb>Ｗ</rb><rt>だぶりゅー</rt></ruby>まほう</div> <div class='meaning'>W-Magic (lit. 'Double Magic')</div> 
<div class='jp'>Ｗアイテム</div>	<div class='jp'><ruby><rb>Ｗ</rb><rt>だぶりゅー</rt></ruby>アイテム</div> <div class='meaning'>W-Item (lit. 'Double Item')</div> 
<div class='jp'>マスターコマンド</div>	<div class='jp'>マスターコマンド</div> <div class='meaning'>Master Command</div> 
<div class='jp'>かばう</div>	<div class='jp'>かばう</div> <div class='meaning'>Cover</div> 
<div class='jp'>カウンター</div>	<div class='jp'>カウンター</div> <div class='meaning'>Counter Attack (lit. 'Counter')</div> 
<div class='jp'>チョコボよせ</div>	<div class='jp'>チョコボよせ</div> <div class='meaning'>Chocobo Lure (lit. 'Chocobo Draw')</div> 
<div class='jp'>えんきょりこうげき</div>	<div class='jp'>えんきょりこうげき</div> <div class='meaning'>Long Range (lit. 'Long-Distance Attack')</div> 
<div class='jp'>せんせいこうげき</div>	<div class='jp'>せんせいこうげき</div> <div class='meaning'>Pre-Emptive (lit. 'Advance Attack')</div> 
<div class='jp'>ＨＰアップ</div>	<div class='jp'><ruby><rb>ＨＰ</rb><rt>えいちぴー</rt></ruby>アップ</div> <div class='meaning'>HP Plus (lit. 'HP Up')</div> 
<div class='jp'>ＭＰアップ</div>	<div class='jp'>ＭＰアップ</div> <div class='meaning'>MP Plus (lit. 'MP Up')</div> 
<div class='jp'>けいけんちアップ</div>	<div class='jp'>けいけんちアップ</div> <div class='meaning'>EXP Plus (lit. 'Experience Points Up')</div> 
<div class='jp'>ギルアップ</div>	<div class='jp'>ギルアップ</div> <div class='meaning'>Gil Plus (lit. 'Gil Up')</div> 
<div class='jp'>マジカル</div>	<div class='jp'>マジカル</div> <div class='meaning'>Magic Plus (lit. 'Magical')</div> 
<div class='jp'>スピード</div>	<div class='jp'>スピード</div> <div class='meaning'>Speed Plus (lit. 'Speed')</div> 
<div class='jp'>ラッキー</div>	<div class='jp'>ラッキー</div> <div class='meaning'>Luck Plus (lit. 'Lucky')</div> 
<div class='jp'>てきよせ</div>	<div class='jp'>てきよせ</div> <div class='meaning'>Enemy Lure (lit. 'Enemy Draw')</div> 
<div class='jp'>てきよけ</div>	<div class='jp'>てきよけ</div> <div class='meaning'>Enemy Away (lit. 'Enemy Ward')</div> 
<div class='jp'>ＨＰＭＰいれかえ</div>	<div class='jp'>ＨＰＭＰいれかえ</div> <div class='meaning'>HP<->MP (lit. 'HPMP Switch')</div> 
<div class='jp'>すべてぜんたいか</div>	<div class='jp'>すべてぜんたいか</div> <div class='meaning'>Mega All (lit. 'Entire All')</div> 
<div class='jp'>せんすい</div>	<div class='jp'>せんすい</div> <div class='meaning'>Underwater (lit. 'Diving')</div> 
<div class='jp'>ぜんたいか</div>	<div class='jp'>ぜんたいか</div> <div class='meaning'>All</div> 
<div class='jp'>ぞくせい</div>	<div class='jp'>ぞくせい</div> <div class='meaning'>Elemental</div> 
<div class='jp'>ついかこうか</div>	<div class='jp'>ついかこうか</div> <div class='meaning'>Added Effect</div> 
<div class='jp'>ついかぎり</div>	<div class='jp'>ついかぎり</div> <div class='meaning'>Added Cut</div> 
<div class='jp'>ＨＰきゅうしゅう</div>	<div class='jp'><ruby><rb>ＨＰ</rb><rt>えいちぴー</rt></ruby>きゅうしゅう</div> <div class='meaning'>HP Absorb</div> 
<div class='jp'>ＭＰきゅうしゅう</div>	<div class='jp'>ＭＰきゅうしゅう</div> <div class='meaning'>MP Absorb</div> 
<div class='jp'>ＭＰターボ</div>	<div class='jp'>ＭＰターボ</div> <div class='meaning'>MP Turbo</div> 
<div class='jp'>ふいうち</div>	<div class='jp'>ふいうち</div> <div class='meaning'>Sneak Attack</div> 
<div class='jp'>ついでにぬすむ</div>	<div class='jp'>ついでにぬすむ</div> <div class='meaning'>Steal as well</div> 
<div class='jp'>コマンドカウンター</div>	<div class='jp'>コマンドカウンター</div> <div class='meaning'>Counter</div> 
<div class='jp'>まほうカウンター</div>	<div class='jp'>まほうカウンター</div> <div class='meaning'>Magic Counter</div> 
<div class='jp'>まほうみだれうち</div>	<div class='jp'>まほうみだれうち</div> <div class='meaning'>Quadra Magic</div> 
<div class='jp'>ファイナルアタック</div>	<div class='jp'>ファイナルアタック</div> <div class='meaning'>Final Attack</div> 
<div class='jp'>たたかう</div>	<div class='jp'>たたかう</div> <div class='meaning'>Attack</div> 
<div class='jp'>まほう</div>	<div class='jp'>まほう</div> <div class='meaning'>Magic</div> 
<div class='jp'>しょうかん</div>	<div class='jp'>しょうかん</div> <div class='meaning'>Summon</div> 
<div class='jp'>ぶんどる</div>	<div class='jp'>ぶんどる</div> <div class='meaning'>Mug (lit. 'Plunder')</div> 
<div class='jp'>ぜになげ</div>	<div class='jp'>ぜになげ</div> <div class='meaning'>Coin (lit. 'Coin Throw')</div> 
<div class='jp'>みだれうち</div>	<div class='jp'>みだれうち</div> <div class='meaning'>4x-Cut (lit. 'Chaotic Strike')</div> 
<div class='jp'>いあいぬき</div>	<div class='jp'>いあいぬき</div> <div class='meaning'>Flash (lit. 'Iainuki')</div> 
<div class='jp'>チェンジ</div>	<div class='jp'>チェンジ</div> <div class='meaning'>Change</div> 
<div class='jp'>ぼうぎょ</div>	<div class='jp'>ぼうぎょ</div> <div class='meaning'>Defend</div> 
<div class='jp'>カエルのうた</div>	<div class='jp'>カエルのうた</div> <div class='meaning'>Frog Song</div> 
<div class='jp'>レベル４自爆</div>	<div class='jp'>レベル４<ruby><rb>自爆</rb><rt>じばく</rt></ruby></div> <div class='meaning'>L4 Suicide (lit. 'Level 4 Self-Destruct')</div>  <br/> <div class='stroke'>自爆</div> 
<div class='jp'>マジックハンマー</div>	<div class='jp'>マジックハンマー</div> <div class='meaning'>Magic Hammer</div> 
<div class='jp'>ホワイトウィンド</div>	<div class='jp'>ホワイトウィンド</div> <div class='meaning'>White Wind</div> 
<div class='jp'>マイティガード</div>	<div class='jp'>マイティガード</div> <div class='meaning'>Big Guard (lit. 'Mighty Guard')</div> 
<div class='jp'>天使のささやき</div>	<div class='jp'><ruby><rb>天使</rb><rt>てんし</rt></ruby>のささやき</div> <div class='meaning'>Angel Whisper</div>  <br/> <div class='stroke'>天使</div> 
<div class='jp'>ドラゴンフォース</div>	<div class='jp'>ドラゴンフォース</div> <div class='meaning'>Dragon Force</div> 
<div class='jp'>デスフォース</div>	<div class='jp'>デスフォース</div> <div class='meaning'>Death Force</div> 
<div class='jp'>火炎放射</div>	<div class='jp'><ruby><rb>火炎</rb><rt>かえん</rt></ruby><ruby><rb>放射</rb><rt>ほうしゃ</rt></ruby></div> <div class='meaning'>Flame Thrower (lit. 'Flamethrower')</div>  <br/> <div class='stroke'>火炎放射</div> 
<div class='jp'>レーザー</div>	<div class='jp'>レーザー</div> <div class='meaning'>Laser</div> 
<div class='jp'>マトラマジック</div>	<div class='jp'>マトラマジック</div> <div class='meaning'>Matra Magic</div> 
<div class='jp'>臭い息</div>	<div class='jp'><ruby><rb>臭</rb><rt>くさ</rt></ruby>い<ruby><rb>息</rb><rt>いき</rt></ruby></div> <div class='meaning'>Bad Breath (lit. 'Smelly Breath')</div>  <br/> <div class='stroke'>臭息</div> 
<div class='jp'>ベータ</div>	<div class='jp'>ベータ</div> <div class='meaning'>Beta</div> 
<div class='jp'>アクアブレス</div>	<div class='jp'>アクアブレス</div> <div class='meaning'>Aqualung (lit. 'Aqua Breath')</div> 
<div class='jp'>トライン</div>	<div class='jp'>トライン</div> <div class='meaning'>Trine</div> 
<div class='jp'>マジカルブレス</div>	<div class='jp'>マジカルブレス</div> <div class='meaning'>Magic Breath (lit. 'Magical Breath')</div> 
<div class='jp'>？？？？</div>	<div class='jp'>？？？？</div> <div class='meaning'>????</div> 
<div class='jp'>ゴブリンパンチ</div>	<div class='jp'>ゴブリンパンチ</div> <div class='meaning'>Goblin Punch</div> 
<div class='jp'>チョコボックル</div>	<div class='jp'>チョコボックル</div> <div class='meaning'>Chocobuckle (lit. 'Chocobokkuru')</div> 
<div class='jp'>レベル５デス</div>	<div class='jp'>レベル５デス</div> <div class='meaning'>L5 Death (lit. 'Level 5 Death')</div> 
<div class='jp'>死のルーレット</div>	<div class='jp'><ruby><rb>死</rb><rt>し</rt></ruby>のルーレット</div> <div class='meaning'>Roulette (lit. 'Death Roulette')</div>  <br/> <div class='stroke'>死</div> 
<div class='jp'>シャドウフレア</div>	<div class='jp'>シャドウフレア</div> <div class='meaning'>Shadow Flare</div> 
<div class='jp'>なんとか？？？</div>	<div class='jp'>なんとか？？？</div> <div class='meaning'>Pandora's Box (lit. 'What???')</div> 
<div class='jp'>ブリザド</div>	<div class='jp'>ブリザド</div> <div class='meaning'>Ice (lit. 'Blizzard')</div> 
<div class='jp'>ブリザラ</div>	<div class='jp'>ブリザラ</div> <div class='meaning'>Ice2 (lit. 'Blizzara')</div> 
<div class='jp'>ブリザガ</div>	<div class='jp'>ブリザガ</div> <div class='meaning'>Ice3 (lit. 'Blizzaga')</div> 
<div class='jp'>ファイア</div>	<div class='jp'>ファイア</div> <div class='meaning'>Fire</div> 
<div class='jp'>ファイラ</div>	<div class='jp'>ファイラ</div> <div class='meaning'>Fire2 (lit. 'Fira')</div> 
<div class='jp'>ファイガ</div>	<div class='jp'>ファイガ</div> <div class='meaning'>Fire3 (lit. 'Figa')</div> 
<div class='jp'>サンダー</div>	<div class='jp'>サンダー</div> <div class='meaning'>Bolt (lit. 'Thunder')</div> 
<div class='jp'>サンダラ</div>	<div class='jp'>サンダラ</div> <div class='meaning'>Bolt2 (lit. 'Thundera')</div> 
<div class='jp'>サンダガ</div>	<div class='jp'>サンダガ</div> <div class='meaning'>Bolt3 (lit. 'Thundega')</div> 
<div class='jp'>ケアル</div>	<div class='jp'>ケアル</div> <div class='meaning'>Cure (lit. 'Care')</div> 
<div class='jp'>ケアルラ</div>	<div class='jp'>ケアルラ</div> <div class='meaning'>Cure2 (lit. 'Carera')</div> 
<div class='jp'>リジェネ</div>	<div class='jp'>リジェネ</div> <div class='meaning'>Regen (lit. 'Regene')</div> 
<div class='jp'>ケアルガ</div>	<div class='jp'>ケアルガ</div> <div class='meaning'>Cure3 (lit. 'Carega')</div> 
<div class='jp'>バイオ</div>	<div class='jp'>バイオ</div> <div class='meaning'>Bio</div> 
<div class='jp'>バイオラ</div>	<div class='jp'>バイオラ</div> <div class='meaning'>Bio2 (lit. 'Biora')</div> 
<div class='jp'>バイオガ</div>	<div class='jp'>バイオガ</div> <div class='meaning'>Bio3 (lit. 'Bioga')</div> 
<div class='jp'>クエイク</div>	<div class='jp'>クエイク</div> <div class='meaning'>Quake</div> 
<div class='jp'>クエイラ</div>	<div class='jp'>クエイラ</div> <div class='meaning'>Quake2 (lit. 'Quara')</div> 
<div class='jp'>クエイガ</div>	<div class='jp'>クエイガ</div> <div class='meaning'>Quake3 (lit. 'Quaga')</div> 
<div class='jp'>ポイゾナ</div>	<div class='jp'>ポイゾナ</div> <div class='meaning'>Poisona</div> 
<div class='jp'>エスナ</div>	<div class='jp'>エスナ</div> <div class='meaning'>Esuna</div> 
<div class='jp'>レジスト</div>	<div class='jp'>レジスト</div> <div class='meaning'>Resist</div> 
<div class='jp'>レイズ</div>	<div class='jp'>レイズ</div> <div class='meaning'>Life (lit. 'Raise')</div> 
<div class='jp'>アレイズ</div>	<div class='jp'>アレイズ</div> <div class='meaning'>Life2 (lit. 'Arise')</div> 
<div class='jp'>スリプル</div>	<div class='jp'>スリプル</div> <div class='meaning'>Sleepel (lit. 'Sleeper')</div> 
<div class='jp'>サイレス</div>	<div class='jp'>サイレス</div> <div class='meaning'>Silence</div> 
<div class='jp'>ミニマム</div>	<div class='jp'>ミニマム</div> <div class='meaning'>Mini (lit. 'Minimum')</div> 
<div class='jp'>トード</div>	<div class='jp'>トード</div> <div class='meaning'>Toad</div> 
<div class='jp'>コンフュ</div>	<div class='jp'>コンフュ</div> <div class='meaning'>Confu</div> 
<div class='jp'>バーサク</div>	<div class='jp'>バーサク</div> <div class='meaning'>Berserk</div> 
<div class='jp'>ヘイスト</div>	<div class='jp'>ヘイスト</div> <div class='meaning'>Haste</div> 
<div class='jp'>スロウ</div>	<div class='jp'>スロウ</div> <div class='meaning'>Slow</div> 
<div class='jp'>ストップ</div>	<div class='jp'>ストップ</div> <div class='meaning'>Stop</div> 
<div class='jp'>グラビデ</div>	<div class='jp'>グラビデ</div> <div class='meaning'>Demi (lit. 'Gravide')</div> 
<div class='jp'>グラビラ</div>	<div class='jp'>グラビラ</div> <div class='meaning'>Demi2 (lit. 'Gravira')</div> 
<div class='jp'>グラビガ</div>	<div class='jp'>グラビガ</div> <div class='meaning'>Demi3 (lit. 'Graviga')</div> 
<div class='jp'>デバリア</div>	<div class='jp'>デバリア</div> <div class='meaning'>DeBarrier (lit. 'Debarrier')</div> 
<div class='jp'>デスペル</div>	<div class='jp'>デスペル</div> <div class='meaning'>DeSpell (lit. 'Despell')</div> 
<div class='jp'>デス</div>	<div class='jp'>デス</div> <div class='meaning'>Death</div> 
<div class='jp'>マバリア</div>	<div class='jp'>マバリア</div> <div class='meaning'>MBarrier (lit. 'Mabarrier')</div> 
<div class='jp'>リフレク</div>	<div class='jp'>リフレク</div> <div class='meaning'>Reflect</div> 
<div class='jp'>ウォール</div>	<div class='jp'>ウォール</div> <div class='meaning'>Wall</div> 
<div class='jp'>エスケプ</div>	<div class='jp'>エスケプ</div> <div class='meaning'>Escape</div> 
<div class='jp'>デジョン</div>	<div class='jp'>デジョン</div> <div class='meaning'>Remove (lit. 'Dezone')</div> 
<div class='jp'>コメット</div>	<div class='jp'>コメット</div> <div class='meaning'>Comet</div> 
<div class='jp'>コメテオ</div>	<div class='jp'>コメテオ</div> <div class='meaning'>Comet2 (lit. 'Cometeo')</div> 
<div class='jp'>フリーズ</div>	<div class='jp'>フリーズ</div> <div class='meaning'>Freeze</div> 
<div class='jp'>ブレイク</div>	<div class='jp'>ブレイク</div> <div class='meaning'>Break</div> 
<div class='jp'>トルネド</div>	<div class='jp'>トルネド</div> <div class='meaning'>Tornado</div> 
<div class='jp'>フレア</div>	<div class='jp'>フレア</div> <div class='meaning'>Flare</div> 
<div class='jp'>必殺技！！</div>	<div class='jp'><ruby><rb>必殺技</rb><rt>ひっさつわざ</rt></ruby>！！</div> <div class='meaning'>Deathblow‼ (lit. 'Deathblow Technique!!')</div>  <br/> <div class='stroke'>必殺技</div> 
<div class='jp'>デブチョコボ</div>	<div class='jp'>デブチョコボ</div> <div class='meaning'>Fat Chocobo (lit. 'Fatso Chocobo')</div> 
<div class='jp'>ダイヤモンドダスト</div>	<div class='jp'>ダイヤモンドダスト</div> <div class='meaning'>Diamond Dust</div> 
<div class='jp'>地獄の火炎</div>	<div class='jp'><ruby><rb>地獄</rb><rt>じごく</rt></ruby>の<ruby><rb>火炎</rb><rt>かえん</rt></ruby></div> <div class='meaning'>Hellfire (lit. 'Flames of Hell')</div>  <br/> <div class='stroke'>地獄火炎</div> 
<div class='jp'>裁きの雷</div>	<div class='jp'><ruby><rb>裁</rb><rt>さば</rt></ruby>きの<ruby><rb>雷</rb><rt>かみなり</rt></ruby></div> <div class='meaning'>Judgement Bolt (lit. 'Lightning of Judgement')</div>  <br/> <div class='stroke'>裁雷</div> 
<div class='jp'>大地の怒り</div>	<div class='jp'><ruby><rb>大地</rb><rt>だいち</rt></ruby>の<ruby><rb>怒</rb><rt>いか</rt></ruby>り</div> <div class='meaning'>Anger of the Land (lit. 'Anger of the Earth')</div>  <br/> <div class='stroke'>大地怒</div> 
<div class='jp'>斬鉄剣</div>	<div class='jp'><ruby><rb>斬鉄剣</rb><rt>ざんてつけん</rt></ruby></div> <div class='meaning'>Steel Bladed Sword (lit. 'Iron-Cutting Sword')</div>  <br/> <div class='stroke'>斬鉄剣</div> 
<div class='jp'>グングニルの槍</div>	<div class='jp'>グングニルの<ruby><rb>槍</rb><rt>やり</rt></ruby></div> <div class='meaning'>Gunge Lance (lit. 'Gungnir Spear')</div>  <br/> <div class='stroke'>槍</div> 
<div class='jp'>メガフレア</div>	<div class='jp'>メガフレア</div> <div class='meaning'>Mega Flare (lit. 'Megaflare')</div> 
<div class='jp'>大海衝</div>	<div class='jp'><ruby><rb>大海</rb><rt>だいかい</rt></ruby><ruby><rb>衝</rb><rt>しょう</rt></ruby></div> <div class='meaning'>Tidal Wave (lit. 'Great Tidal Wave')</div>  <br/> <div class='stroke'>大海衝</div> 
<div class='jp'>トライディザスター</div>	<div class='jp'>トライディザスター</div> <div class='meaning'>Tetra-Disaster (lit. 'Tri-Disaster')</div> 
<div class='jp'>聖なる審判</div>	<div class='jp'><ruby><rb>聖</rb><rt>せい</rt></ruby>なる<ruby><rb>審判</rb><rt>しんぱん</rt></ruby></div> <div class='meaning'>Judgement (lit. 'Holy Judgement')</div>  <br/> <div class='stroke'>聖審判</div> 
<div class='jp'>ギガフレア</div>	<div class='jp'>ギガフレア</div> <div class='meaning'>Giga Flare (lit. 'Gigaflare')</div> 
<div class='jp'>転生の炎</div>	<div class='jp'><ruby><rb>転生</rb><rt>てんせい</rt></ruby>の<ruby><rb>炎</rb><rt>ほのお</rt></ruby></div> <div class='meaning'>Phoenix Flame (lit. 'Flames of Reincarnation')</div>  <br/> <div class='stroke'>転生炎</div> 
<div class='jp'>暗黒の釜</div>	<div class='jp'><ruby><rb>暗黒</rb><rt>あんこく</rt></ruby>の<ruby><rb>釜</rb><rt>かま</rt></ruby></div> <div class='meaning'>Black Cauldron (lit. 'Cauldron of Darkness')</div>  <br/> <div class='stroke'>暗黒釜</div> 
<div class='jp'>テラフレア</div>	<div class='jp'>テラフレア</div> <div class='meaning'>Tera Flare (lit. 'Teraflare')</div> 
<div class='jp'>天地崩壊</div>	<div class='jp'><ruby><rb>天地</rb><rt>てんち</rt></ruby><ruby><rb>崩壊</rb><rt>ほうかい</rt></ruby></div> <div class='meaning'>Disintegration (lit. 'Collapse of Heaven and Earth')</div>  <br/> <div class='stroke'>天地崩壊</div> 
<div class='jp'>アルティメットエンド</div>	<div class='jp'>アルティメットエンド</div> <div class='meaning'>Ultimate End</div> 
<div class='jp'>バスターソード</div>	<div class='jp'>バスターソード</div> <div class='meaning'>Buster Sword (lit. 'Bastard Sword')</div> 
<div class='jp'>ミスリルセイバー</div>	<div class='jp'>ミスリルセイバー</div> <div class='meaning'>Mythril Saber (lit. 'Mithril Saber')</div> 
<div class='jp'>ハードブレイカー</div>	<div class='jp'>ハードブレイカー</div> <div class='meaning'>Hardedge (lit. 'Hard Breaker')</div> 
<div class='jp'>バタフライエッジ</div>	<div class='jp'>バタフライエッジ</div> <div class='meaning'>Butterfly Edge</div> 
<div class='jp'>村雨</div>	<div class='jp'><ruby><rb>村雨</rb><rt>むらさめ</rt></ruby></div> <div class='meaning'>Murasame</div>  <br/> <div class='stroke'>村雨</div> 
<div class='jp'>オーガニクス</div>	<div class='jp'>オーガニクス</div> <div class='meaning'>Organics</div> 
<div class='jp'>クリスタルソード</div>	<div class='jp'>クリスタルソード</div> <div class='meaning'>Crystal Sword</div> 
<div class='jp'>フォースイーター</div>	<div class='jp'>フォースイーター</div> <div class='meaning'>Force Stealer (lit. 'Force Eater')</div> 
<div class='jp'>ルーンブレイド</div>	<div class='jp'>ルーンブレイド</div> <div class='meaning'>Rune Blade</div> 
<div class='jp'>エンハンスソード</div>	<div class='jp'>エンハンスソード</div> <div class='meaning'>Enhance Sword</div> 
<div class='jp'>釘バット</div>	<div class='jp'><ruby><rb>釘</rb><rt>くぎ</rt></ruby>バット</div> <div class='meaning'>Nail Bat</div>  <br/> <div class='stroke'>釘</div> 
<div class='jp'>陸奥守吉行</div>	<div class='jp'><ruby><rb>陸奥</rb><rt>むつ</rt></ruby><ruby><rb>守</rb><rt>のかみ</rt></ruby><ruby><rb>吉行</rb><rt>よしゆき</rt></ruby></div> <div class='meaning'>Yoshiyuki (lit. 'Mutsunokami Yoshiyuki')</div>  <br/> <div class='stroke'>陸奥守吉行</div> 
<div class='jp'>アポカリプス</div>	<div class='jp'>アポカリプス</div> <div class='meaning'>Apocalypse</div> 
<div class='jp'>天の叢雲</div>	<div class='jp'><ruby><rb>天</rb><rt>あめ</rt></ruby>の<ruby><rb>叢雲</rb><rt>むらくも</rt></ruby></div> <div class='meaning'>Heaven's Cloud (lit. 'Ame no Murakumo')</div>  <br/> <div class='stroke'>天叢雲</div> 
<div class='jp'>ラグナロク</div>	<div class='jp'>ラグナロク</div> <div class='meaning'>Ragnarok</div> 
<div class='jp'>アルテマウェポン</div>	<div class='jp'>アルテマウェポン</div> <div class='meaning'>Ultimate Weapon (lit. 'Ultima Weapon')</div> 
<div class='jp'>ガトリングガン</div>	<div class='jp'>ガトリングガン</div> <div class='meaning'>Gatling Gun</div> 
<div class='jp'>アサルトガン</div>	<div class='jp'>アサルトガン</div> <div class='meaning'>Assault Gun</div> 
<div class='jp'>キャノンボール</div>	<div class='jp'>キャノンボール</div> <div class='meaning'>Cannon Ball (lit. 'Cannonball')</div> 
<div class='jp'>アトミックシザー</div>	<div class='jp'>アトミックシザー</div> <div class='meaning'>Atomic Scissors (lit. 'Atomic Scissor')</div> 
<div class='jp'>ハードバルカン</div>	<div class='jp'>ハードバルカン</div> <div class='meaning'>Heavy Vulcan (lit. 'Hard Vulcan')</div> 
<div class='jp'>チェーンソー</div>	<div class='jp'>チェーンソー</div> <div class='meaning'>Chainsaw</div> 
<div class='jp'>マイクロレーザー</div>	<div class='jp'>マイクロレーザー</div> <div class='meaning'>Microlaser</div> 
<div class='jp'>Ａ・Ｍキャノン</div>	<div class='jp'><ruby><rb>Ａ</rb><rt>えい</rt></ruby>・<ruby><rb>Ｍ</rb><rt>えむ</rt></ruby>キャノン</div> <div class='meaning'>A∙M Cannon (lit. 'A-M Cannon')</div> 
<div class='jp'>Ｗマシンガン</div>	<div class='jp'><ruby><rb>Ｗ</rb><rt>だぶりゅー</rt></ruby>マシンガン</div> <div class='meaning'>W Machine Gun (lit. 'Double Machine Gun')</div> 
<div class='jp'>ドリルアーム</div>	<div class='jp'>ドリルアーム</div> <div class='meaning'>Drill Arm</div> 
<div class='jp'>ソリッドバズーカ</div>	<div class='jp'>ソリッドバズーカ</div> <div class='meaning'>Solid Bazooka</div> 
<div class='jp'>ロケットパンチ</div>	<div class='jp'>ロケットパンチ</div> <div class='meaning'>Rocket Punch</div> 
<div class='jp'>エネミーランチャ</div>	<div class='jp'>エネミーランチャ</div> <div class='meaning'>Enemy Launcher</div> 
<div class='jp'>パイルバンカー</div>	<div class='jp'>パイルバンカー</div> <div class='meaning'>Pile Banger (lit. 'Pilebunker')</div> 
<div class='jp'>マキシマムレイ</div>	<div class='jp'>マキシマムレイ</div> <div class='meaning'>Max Ray (lit. 'Maximum Ray')</div> 
<div class='jp'>ミッシングスコア</div>	<div class='jp'>ミッシングスコア</div> <div class='meaning'>Missing Score</div> 
<div class='jp'>レザーグローブ</div>	<div class='jp'>レザーグローブ</div> <div class='meaning'>Leather Glove</div> 
<div class='jp'>メタルナックル</div>	<div class='jp'>メタルナックル</div> <div class='meaning'>Metal Knuckle</div> 
<div class='jp'>ミスリルクロー</div>	<div class='jp'>ミスリルクロー</div> <div class='meaning'>Mythril Claw (lit. 'Mithril Claw')</div> 
<div class='jp'>グランドグラブ</div>	<div class='jp'>グランドグラブ</div> <div class='meaning'>Grand Glove</div> 
<div class='jp'>タイガーファング</div>	<div class='jp'>タイガーファング</div> <div class='meaning'>Tiger Fang</div> 
<div class='jp'>ダイアナックル</div>	<div class='jp'>ダイアナックル</div> <div class='meaning'>Diamond Knuckle</div> 
<div class='jp'>ドラゴンクロー</div>	<div class='jp'>ドラゴンクロー</div> <div class='meaning'>Dragon Claw</div> 
<div class='jp'>クリスタルグラブ</div>	<div class='jp'>クリスタルグラブ</div> <div class='meaning'>Crystal Glove</div> 
<div class='jp'>モータードライブ</div>	<div class='jp'>モータードライブ</div> <div class='meaning'>Motor Drive</div> 
<div class='jp'>プラチナフィスト</div>	<div class='jp'>プラチナフィスト</div> <div class='meaning'>Platinum Fist</div> 
<div class='jp'>カイザーナックル</div>	<div class='jp'>カイザーナックル</div> <div class='meaning'>Kaiser Knuckle</div> 
<div class='jp'>軍手</div>	<div class='jp'><ruby><rb>軍手</rb><rt>ぐんて</rt></ruby></div> <div class='meaning'>Work Glove (lit. 'Cotton Work Glove')</div>  <br/> <div class='stroke'>軍手</div> 
<div class='jp'>オーバーソウル</div>	<div class='jp'>オーバーソウル</div> <div class='meaning'>Powersoul (lit. 'Oversoul')</div> 
<div class='jp'>マスターフィスト</div>	<div class='jp'>マスターフィスト</div> <div class='meaning'>Master Fist</div> 
<div class='jp'>ゴッドハンド</div>	<div class='jp'>ゴッドハンド</div> <div class='meaning'>God's Hand (lit. 'Godhand')</div> 
<div class='jp'>プレミアムハート</div>	<div class='jp'>プレミアムハート</div> <div class='meaning'>Premium Heart</div> 
<div class='jp'>ガードロッド</div>	<div class='jp'>ガードロッド</div> <div class='meaning'>Guard Stick (lit. 'Guard Rod')</div> 
<div class='jp'>ミスリルロッド</div>	<div class='jp'>ミスリルロッド</div> <div class='meaning'>Mythril Rod (lit. 'Mithril Rod')</div> 
<div class='jp'>フルメタルロッド</div>	<div class='jp'>フルメタルロッド</div> <div class='meaning'>Full Metal Staff (lit. 'Fullmetal Rod')</div> 
<div class='jp'>ストライクロッド</div>	<div class='jp'>ストライクロッド</div> <div class='meaning'>Striking Staff (lit. 'Strike Rod')</div> 
<div class='jp'>プリズムロッド</div>	<div class='jp'>プリズムロッド</div> <div class='meaning'>Prism Staff (lit. 'Prism Rod')</div> 
<div class='jp'>オーロラロッド</div>	<div class='jp'>オーロラロッド</div> <div class='meaning'>Aurora Rod</div> 
<div class='jp'>ウィザードロッド</div>	<div class='jp'>ウィザードロッド</div> <div class='meaning'>Wizard Staff (lit. 'Wizard Rod')</div> 
<div class='jp'>ワイザーロッド</div>	<div class='jp'>ワイザーロッド</div> <div class='meaning'>Wizer Staff (lit. 'Wiser Rod')</div> 
<div class='jp'>フェアリーテイル</div>	<div class='jp'>フェアリーテイル</div> <div class='meaning'>Fairy Tale</div> 
<div class='jp'>アンブレラ</div>	<div class='jp'>アンブレラ</div> <div class='meaning'>Umbrella</div> 
<div class='jp'>プリンセスガード</div>	<div class='jp'>プリンセスガード</div> <div class='meaning'>Princess Guard</div> 
<div class='jp'>ミスリルクリップ</div>	<div class='jp'>ミスリルクリップ</div> <div class='meaning'>Mythril Clip (lit. 'Mithril Clip')</div> 
<div class='jp'>ギヤマンヘアピン</div>	<div class='jp'>ギヤマンヘアピン</div> <div class='meaning'>Diamond Pin (lit. 'Glasscraft Hairpin')</div> 
<div class='jp'>シルバーバレッタ</div>	<div class='jp'>シルバーバレッタ</div> <div class='meaning'>Silver Barrette (lit. 'Silver Barette')</div> 
<div class='jp'>ゴールドバレッタ</div>	<div class='jp'>ゴールドバレッタ</div> <div class='meaning'>Gold Barette</div> 
<div class='jp'>アダマンクリップ</div>	<div class='jp'>アダマンクリップ</div> <div class='meaning'>Adaman Clip</div> 
<div class='jp'>クリスタルコーム</div>	<div class='jp'>クリスタルコーム</div> <div class='meaning'>Crystal Comb</div> 
<div class='jp'>マジックコーム</div>	<div class='jp'>マジックコーム</div> <div class='meaning'>Magic Comb</div> 
<div class='jp'>プラチナバレッタ</div>	<div class='jp'>プラチナバレッタ</div> <div class='meaning'>Plus Barette (lit. 'Platinum Barette')</div> 
<div class='jp'>セントクリップ</div>	<div class='jp'>セントクリップ</div> <div class='meaning'>Centclip (lit. 'Saint Clip')</div> 
<div class='jp'>かんざし</div>	<div class='jp'>かんざし</div> <div class='meaning'>Hairpin</div> 
<div class='jp'>セラフコーム</div>	<div class='jp'>セラフコーム</div> <div class='meaning'>Seraph Comb</div> 
<div class='jp'>ベヒーモスホーン</div>	<div class='jp'>ベヒーモスホーン</div> <div class='meaning'>Behemoth Horn</div> 
<div class='jp'>スプリガンクリップ</div>	<div class='jp'>スプリガンクリップ</div> <div class='meaning'>Spring Gun Clip (lit. 'Spriggan Clip')</div> 
<div class='jp'>リミテッドムーン</div>	<div class='jp'>リミテッドムーン</div> <div class='meaning'>Limited Moon</div> 
<div class='jp'>十字手裏剣</div>	<div class='jp'><ruby><rb>十字</rb><rt>じゅうじ</rt></ruby><ruby><rb>手裏剣</rb><rt>しゅりけん</rt></ruby></div> <div class='meaning'>4-point Shuriken (lit. 'Cross Shuriken')</div>  <br/> <div class='stroke'>十字手裏剣</div> 
<div class='jp'>ブーメラン</div>	<div class='jp'>ブーメラン</div> <div class='meaning'>Boomerang</div> 
<div class='jp'>風車</div>	<div class='jp'><ruby><rb>風車</rb><rt>かざぐるま</rt></ruby></div> <div class='meaning'>Pinwheel</div>  <br/> <div class='stroke'>風車</div> 
<div class='jp'>円月輪</div>	<div class='jp'><ruby><rb>円</rb><rt>えん</rt></ruby><ruby><rb>月輪</rb><rt>げつりん</rt></ruby></div> <div class='meaning'>Razor Ring (lit. 'Full Moon Ring')</div>  <br/> <div class='stroke'>円月輪</div> 
<div class='jp'>ホークアイ</div>	<div class='jp'>ホークアイ</div> <div class='meaning'>Hawkeye</div> 
<div class='jp'>クリスタルクロス</div>	<div class='jp'>クリスタルクロス</div> <div class='meaning'>Crystal Cross</div> 
<div class='jp'>風斬り</div>	<div class='jp'><ruby><rb>風</rb><rt>かぜ</rt></ruby><ruby><rb>斬</rb><rt>き</rt></ruby>り</div> <div class='meaning'>Wind Slash</div>  <br/> <div class='stroke'>風斬</div> 
<div class='jp'>ツインヴァイパー</div>	<div class='jp'>ツインヴァイパー</div> <div class='meaning'>Twin Viper</div> 
<div class='jp'>卍手裏剣</div>	<div class='jp'><ruby><rb>卍</rb><rt>まんじ</rt></ruby><ruby><rb>手裏剣</rb><rt>しゅりけん</rt></ruby></div> <div class='meaning'>Spiral Shuriken (lit. 'Manji Shuriken')</div>  <br/> <div class='stroke'>卍手裏剣</div> 
<div class='jp'>スーパーボール</div>	<div class='jp'>スーパーボール</div> <div class='meaning'>Superball</div> 
<div class='jp'>風魔手裏剣</div>	<div class='jp'><ruby><rb>風</rb><rt>ふう</rt></ruby><ruby><rb>魔</rb><rt>ま</rt></ruby><ruby><rb>手裏剣</rb><rt>しゅりけん</rt></ruby></div> <div class='meaning'>Magic Shuriken (lit. 'Fuma Shuriken')</div>  <br/> <div class='stroke'>風魔手裏剣</div> 
<div class='jp'>ライジングサン</div>	<div class='jp'>ライジングサン</div> <div class='meaning'>Rising Sun</div> 
<div class='jp'>折り鶴</div>	<div class='jp'><ruby><rb>折り鶴</rb><rt>おりづる</rt></ruby></div> <div class='meaning'>Oritsuru (lit. 'Paper Crane')</div>  <br/> <div class='stroke'>折鶴</div> 
<div class='jp'>不倶戴天</div>	<div class='jp'><ruby><rb>不倶戴天</rb><rt>ふぐたいてん</rt></ruby></div> <div class='meaning'>Conformer (lit. 'Not All Support Heaven - Eternal Enemy')</div>  <br/> <div class='stroke'>不倶戴天</div> 
<div class='jp'>イエローメガホン</div>	<div class='jp'>イエローメガホン</div> <div class='meaning'>Yellow M-phone (lit. 'Yellow Megaphone')</div> 
<div class='jp'>グリーンメガホン</div>	<div class='jp'>グリーンメガホン</div> <div class='meaning'>Green M-phone (lit. 'Green Megaphone')</div> 
<div class='jp'>ブルーメガホン</div>	<div class='jp'>ブルーメガホン</div> <div class='meaning'>Blue M-phone (lit. 'Blue Megaphone')</div> 
<div class='jp'>レッドメガホン</div>	<div class='jp'>レッドメガホン</div> <div class='meaning'>Red M-phone (lit. 'Red Megaphone')</div> 
<div class='jp'>クリスタルメガホン</div>	<div class='jp'>クリスタルメガホン</div> <div class='meaning'>Crystal M-phone (lit. 'Crystal Megaphone')</div> 
<div class='jp'>ホワイトメガホン</div>	<div class='jp'>ホワイトメガホン</div> <div class='meaning'>White M-phone (lit. 'White Megaphone')</div> 
<div class='jp'>ブラックメガホン</div>	<div class='jp'>ブラックメガホン</div> <div class='meaning'>Black M-phone (lit. 'Black Megaphone')</div> 
<div class='jp'>シルバーメガホン</div>	<div class='jp'>シルバーメガホン</div> <div class='meaning'>Silver M-phone (lit. 'Silver Megaphone')</div> 
<div class='jp'>ゴールドメガホン</div>	<div class='jp'>ゴールドメガホン</div> <div class='meaning'>Gold M-phone (lit. 'Gold Megaphone')</div> 
<div class='jp'>法螺貝</div>	<div class='jp'><ruby><rb>法螺貝</rb><rt>ほらがい</rt></ruby></div> <div class='meaning'>Trumpet Shell (lit. 'Conch')</div>  <br/> <div class='stroke'>法螺貝</div> 
<div class='jp'>突撃ラッパ</div>	<div class='jp'><ruby><rb>突撃</rb><rt>とつげき</rt></ruby>ラッパ</div> <div class='meaning'>Battle Trumpet (lit. 'Assault Trumpet')</div>  <br/> <div class='stroke'>突撃</div> 
<div class='jp'>スターライトホン</div>	<div class='jp'>スターライトホン</div> <div class='meaning'>Starlight Phone (lit. 'Starlight Horn')</div> 
<div class='jp'>マーベラスチアー</div>	<div class='jp'>マーベラスチアー</div> <div class='meaning'>HP Shout (lit. 'Marvelous Cheer')</div> 
<div class='jp'>クイックシルバー</div>	<div class='jp'>クイックシルバー</div> <div class='meaning'>Quicksilver</div> 
<div class='jp'>スパス</div>	<div class='jp'>スパス</div> <div class='meaning'>Shotgun (lit. 'SPAS')</div> 
<div class='jp'>ランダル</div>	<div class='jp'>ランダル</div> <div class='meaning'>Shortbarrel (lit. 'Randall')</div> 
<div class='jp'>ライアット</div>	<div class='jp'>ライアット</div> <div class='meaning'>Lariat (lit. 'Riot')</div> 
<div class='jp'>ウィンチェスター</div>	<div class='jp'>ウィンチェスター</div> <div class='meaning'>Winchester</div> 
<div class='jp'>ピースメーカー</div>	<div class='jp'>ピースメーカー</div> <div class='meaning'>Peacemaker</div> 
<div class='jp'>バントライン</div>	<div class='jp'>バントライン</div> <div class='meaning'>Buntline</div> 
<div class='jp'>ロングバレルＲ</div>	<div class='jp'>ロングバレル<ruby><rb>Ｒ</rb><rt>あーる</rt></ruby></div> <div class='meaning'>Long Barrel R</div> 
<div class='jp'>銀玉鉄砲</div>	<div class='jp'><ruby><rb>銀</rb><rt>ぎん</rt></ruby><ruby><rb>玉</rb><rt>だま</rt></ruby><ruby><rb>鉄砲</rb><rt>でっぽう</rt></ruby></div> <div class='meaning'>Silver Rifle (lit. 'BB Gun')</div>  <br/> <div class='stroke'>銀玉鉄砲</div> 
<div class='jp'>スナイパーＣＲ</div>	<div class='jp'>スナイパー<ruby><rb>ＣＲ</rb><rt>しーあーる</rt></ruby></div> <div class='meaning'>Sniper CR</div> 
<div class='jp'>ハイブロウＳＴ</div>	<div class='jp'>ハイブロウ<ruby><rb>Ｓ</rb><rt>えす</rt></ruby><ruby><rb>Ｔ</rb><rt>てぃー</rt></ruby></div> <div class='meaning'>Supershot ST (lit. 'Highblow ST')</div> 
<div class='jp'>アウトサイダー</div>	<div class='jp'>アウトサイダー</div> <div class='meaning'>Outsider</div> 
<div class='jp'>デスペナルティ</div>	<div class='jp'>デスペナルティ</div> <div class='meaning'>Death Penalty</div> 
<div class='jp'>スピア</div>	<div class='jp'>スピア</div> <div class='meaning'>Spear</div> 
<div class='jp'>スラッシュパイク</div>	<div class='jp'>スラッシュパイク</div> <div class='meaning'>Slash Lance (lit. 'Slash Pike')</div> 
<div class='jp'>トライデント</div>	<div class='jp'>トライデント</div> <div class='meaning'>Trident</div> 
<div class='jp'>ポールアックス</div>	<div class='jp'>ポールアックス</div> <div class='meaning'>Mast Ax (lit. 'Poleaxe')</div> 
<div class='jp'>パルチザン</div>	<div class='jp'>パルチザン</div> <div class='meaning'>Partisan</div> 
<div class='jp'>蛇矛</div>	<div class='jp'><ruby><rb>蛇</rb><rt>じゃ</rt></ruby><ruby><rb>矛</rb><rt>ほこ</rt></ruby></div> <div class='meaning'>Viper Halberd (lit. 'Snake Halberd')</div>  <br/> <div class='stroke'>蛇矛</div> 
<div class='jp'>ジャベリン</div>	<div class='jp'>ジャベリン</div> <div class='meaning'>Javelin</div> 
<div class='jp'>グローランス</div>	<div class='jp'>グローランス</div> <div class='meaning'>Grow Lance (lit. 'Glow Lance')</div> 
<div class='jp'>モップ</div>	<div class='jp'>モップ</div> <div class='meaning'>Mop</div> 
<div class='jp'>ドラグーンランス</div>	<div class='jp'>ドラグーンランス</div> <div class='meaning'>Dragoon Lance (lit. 'Dragon Lance')</div> 
<div class='jp'>青龍偃月刀</div>	<div class='jp'><ruby><rb>青龍</rb><rt>せいりゅう</rt></ruby><ruby><rb>偃月刀</rb><rt>えんげつとう</rt></ruby></div> <div class='meaning'>Scimitar (lit. 'Seiryuu Scimitar')</div>  <br/> <div class='stroke'>青龍偃月刀</div> 
<div class='jp'>方天画戟</div>	<div class='jp'><ruby><rb>方</rb><rt>ほう</rt></ruby><ruby><rb>天</rb><rt>てん</rt></ruby><ruby><rb>画</rb><rt>が</rt></ruby><ruby><rb>戟</rb><rt>げき</rt></ruby></div> <div class='meaning'>Flayer (lit. 'Fang Tian Hua Ji')</div>  <br/> <div class='stroke'>方天画戟</div> 
<div class='jp'>ロンギヌス</div>	<div class='jp'>ロンギヌス</div> <div class='meaning'>Spirit Lance (lit. 'Longinus')</div> 
<div class='jp'>ビーナスゴスペル</div>	<div class='jp'>ビーナスゴスペル</div> <div class='meaning'>Venus Gospel</div> 
<div class='jp'>正宗</div>	<div class='jp'><ruby><rb>正宗</rb><rt>まさむね</rt></ruby></div> <div class='meaning'>Masamune</div>  <br/> <div class='stroke'>正宗</div> 
<div class='jp'>ブロンズバングル</div>	<div class='jp'>ブロンズバングル</div> <div class='meaning'>Bronze Bangle</div> 
<div class='jp'>アイアンバングル</div>	<div class='jp'>アイアンバングル</div> <div class='meaning'>Iron Bangle</div> 
<div class='jp'>チタンバングル</div>	<div class='jp'>チタンバングル</div> <div class='meaning'>Titan Bangle (lit. 'Titanium Bangle')</div> 
<div class='jp'>ミスリルの腕輪</div>	<div class='jp'>ミスリルの<ruby><rb>腕輪</rb><rt>うでわ</rt></ruby></div> <div class='meaning'>Mythril Armlet (lit. 'Mithril Bracelet')</div>  <br/> <div class='stroke'>腕輪</div> 
<div class='jp'>カーボンバングル</div>	<div class='jp'>カーボンバングル</div> <div class='meaning'>Carbon Bangle</div> 
<div class='jp'>銀の腕輪</div>	<div class='jp'><ruby><rb>銀</rb><rt>ぎん</rt></ruby>の<ruby><rb>腕輪</rb><rt>うでわ</rt></ruby></div> <div class='meaning'>Silver Armlet (lit. 'Silver Bracelet')</div>  <br/> <div class='stroke'>銀腕輪</div> 
<div class='jp'>金の腕輪</div>	<div class='jp'><ruby><rb>金</rb><rt>きん</rt></ruby>の<ruby><rb>腕輪</rb><rt>うでわ</rt></ruby></div> <div class='meaning'>Gold Armlet (lit. 'Golden Bracelet')</div>  <br/> <div class='stroke'>金腕輪</div> 
<div class='jp'>ダイアバングル</div>	<div class='jp'>ダイアバングル</div> <div class='meaning'>Diamond Bangle</div> 
<div class='jp'>クリスタルバングル</div>	<div class='jp'>クリスタルバングル</div> <div class='meaning'>Crystal Bangle</div> 
<div class='jp'>プラチナバングル</div>	<div class='jp'>プラチナバングル</div> <div class='meaning'>Platinum Bangle (lit. 'Platina Bangle')</div> 
<div class='jp'>ルーンの腕輪</div>	<div class='jp'>ルーンの<ruby><rb>腕輪</rb><rt>うでわ</rt></ruby></div> <div class='meaning'>Rune Armlet (lit. 'Rune Bracelet')</div>  <br/> <div class='stroke'>腕輪</div> 
<div class='jp'>エジンコート</div>	<div class='jp'>エジンコート</div> <div class='meaning'>Edincoat (lit. 'Agincourt')</div> 
<div class='jp'>ウィザードブレス</div>	<div class='jp'>ウィザードブレス</div> <div class='meaning'>Wizard Bracelet (lit. 'Wizard Brace')</div> 
<div class='jp'>アダマンバングル</div>	<div class='jp'>アダマンバングル</div> <div class='meaning'>Adaman Bangle</div> 
<div class='jp'>ギガースの腕輪</div>	<div class='jp'>ギガースの<ruby><rb>腕輪</rb><rt>うでわ</rt></ruby></div> <div class='meaning'>Gigas Armlet (lit. 'Gigas Bracelet')</div>  <br/> <div class='stroke'>腕輪</div> 
<div class='jp'>インペリアルガード</div>	<div class='jp'>インペリアルガード</div> <div class='meaning'>Imperial Guard</div> 
<div class='jp'>エイジスの腕輪</div>	<div class='jp'>エイジスの<ruby><rb>腕輪</rb><rt>うでわ</rt></ruby></div> <div class='meaning'>Aegis Armlet (lit. 'Aegis Bracelet')</div>  <br/> <div class='stroke'>腕輪</div> 
<div class='jp'>フォースブレス</div>	<div class='jp'>フォースブレス</div> <div class='meaning'>Fourth Bracelet (lit. 'Force Bracelet')</div> 
<div class='jp'>ウォーリアバングル</div>	<div class='jp'>ウォーリアバングル</div> <div class='meaning'>Warrior Bangle</div> 
<div class='jp'>神羅安式防具</div>	<div class='jp'><ruby><rb>神</rb><rt>しん</rt></ruby><ruby><rb>羅</rb><rt>ら</rt></ruby><ruby><rb>安</rb><rt>あん</rt></ruby><ruby><rb>式</rb><rt>しき</rt></ruby><ruby><rb>防具</rb><rt>ぼうぐ</rt></ruby></div> <div class='meaning'>Shinra Beta (lit. 'Shinra Relaxed Type Defense Tool')</div>  <br/> <div class='stroke'>神羅安式防具</div> 
<div class='jp'>神羅甲型防具改</div>	<div class='jp'><ruby><rb>神</rb><rt>しん</rt></ruby><ruby><rb>羅</rb><rt>ら</rt></ruby><ruby><rb>甲</rb><rt>こう</rt></ruby><ruby><rb>型</rb><rt>がた</rt></ruby><ruby><rb>防具</rb><rt>ぼうぐ</rt></ruby><ruby><rb>改</rb><rt>かい</rt></ruby></div> <div class='meaning'>Shinra Alpha (lit. 'Improved Shinra Armored Defense Tool')</div>  <br/> <div class='stroke'>神羅甲型防具改</div> 
<div class='jp'>フォウスロット</div>	<div class='jp'>フォウスロット</div> <div class='meaning'>Four Slots (lit. 'Four Slot')</div> 
<div class='jp'>烈火の腕輪</div>	<div class='jp'><ruby><rb>烈火</rb><rt>れっか</rt></ruby>の<ruby><rb>腕輪</rb><rt>うでわ</rt></ruby></div> <div class='meaning'>Fire Armlet (lit. 'Conflagrant Bracelet')</div>  <br/> <div class='stroke'>烈火腕輪</div> 
<div class='jp'>極光の腕輪</div>	<div class='jp'><ruby><rb>極光</rb><rt>きょっこう</rt></ruby>の<ruby><rb>腕輪</rb><rt>うでわ</rt></ruby></div> <div class='meaning'>Aurora Armlet (lit. 'Aurora Bracelet')</div>  <br/> <div class='stroke'>極光腕輪</div> 
<div class='jp'>天雷の腕輪</div>	<div class='jp'><ruby><rb>天雷</rb><rt>てんらい</rt></ruby>の<ruby><rb>腕輪</rb><rt>うでわ</rt></ruby></div> <div class='meaning'>Bolt Armlet (lit. 'Thunder Bracelet')</div>  <br/> <div class='stroke'>天雷腕輪</div> 
<div class='jp'>ドラゴンの腕輪</div>	<div class='jp'>ドラゴンの<ruby><rb>腕輪</rb><rt>うでわ</rt></ruby></div> <div class='meaning'>Dragon Armlet (lit. 'Dragon Bracelet')</div>  <br/> <div class='stroke'>腕輪</div> 
<div class='jp'>ミネルバブレス</div>	<div class='jp'>ミネルバブレス</div> <div class='meaning'>Minerva Band (lit. 'Minerva Brace')</div> 
<div class='jp'>エスコートガード</div>	<div class='jp'>エスコートガード</div> <div class='meaning'>Escort Guard</div> 
<div class='jp'>ミスティール</div>	<div class='jp'>ミスティール</div> <div class='meaning'>Mystile (lit. 'Mystère')</div> 
<div class='jp'>ザイドリッツ</div>	<div class='jp'>ザイドリッツ</div> <div class='meaning'>Ziedrich (lit. 'Seydlitz')</div> 
<div class='jp'>高級腕時計</div>	<div class='jp'><ruby><rb>高級</rb><rt>こうきゅう</rt></ruby><ruby><rb>腕時計</rb><rt>うでどけい</rt></ruby></div> <div class='meaning'>Precious Watch (lit. 'High-Quality Wristwatch')</div>  <br/> <div class='stroke'>高級腕時計</div> 
<div class='jp'>チョコボの腕輪</div>	<div class='jp'>チョコボの<ruby><rb>腕輪</rb><rt>うでわ</rt></ruby></div> <div class='meaning'>Chocobracelet (lit. 'Chocobo Bracelet')</div>  <br/> <div class='stroke'>腕輪</div> 
<div class='jp'>パワーリスト</div>	<div class='jp'>パワーリスト</div> <div class='meaning'>Power Wrist</div> 
<div class='jp'>防弾チョッキ</div>	<div class='jp'><ruby><rb>防弾チョッキ</rb><rt>ぼうだんちょっき</rt></ruby></div> <div class='meaning'>Protect Vest (lit. 'Bulletproof Vest')</div>  <br/> <div class='stroke'>防弾</div> 
<div class='jp'>イヤリング</div>	<div class='jp'>イヤリング</div> <div class='meaning'>Earring</div> 
<div class='jp'>タリスマン</div>	<div class='jp'>タリスマン</div> <div class='meaning'>Talisman</div> 
<div class='jp'>チョコボのはね</div>	<div class='jp'>チョコボのはね</div> <div class='meaning'>Chocofeather (lit. 'Chocobo Feather')</div> 
<div class='jp'>お守り</div>	<div class='jp'>お<ruby><rb>守</rb><rt>まも</rt></ruby>り</div> <div class='meaning'>Amulet</div>  <br/> <div class='stroke'>守</div> 
<div class='jp'>チャンピオンベルト</div>	<div class='jp'>チャンピオンベルト</div> <div class='meaning'>Champion Belt</div> 
<div class='jp'>ポイズンリング</div>	<div class='jp'>ポイズンリング</div> <div class='meaning'>Poison Ring</div> 
<div class='jp'>タフネスリング</div>	<div class='jp'>タフネスリング</div> <div class='meaning'>Tough Ring (Touph Ring) (lit. 'Toughness Ring')</div> 
<div class='jp'>サークレット</div>	<div class='jp'>サークレット</div> <div class='meaning'>Circlet</div> 
<div class='jp'>星のペンダント</div>	<div class='jp'><ruby><rb>星</rb><rt>ほし</rt></ruby>のペンダント</div> <div class='meaning'>Star Pendant</div>  <br/> <div class='stroke'>星</div> 
<div class='jp'>銀縁メガネ</div>	<div class='jp'><ruby><rb>銀縁</rb><rt>ぎんぶち</rt></ruby>メガネ</div> <div class='meaning'>Silver Glasses (lit. 'Silver-Rimmed Glasses')</div>  <br/> <div class='stroke'>銀縁</div> 
<div class='jp'>ハチマキ</div>	<div class='jp'>ハチマキ</div> <div class='meaning'>Headband</div> 
<div class='jp'>フェアリーリング</div>	<div class='jp'>フェアリーリング</div> <div class='meaning'>Fairy Ring</div> 
<div class='jp'>ジュエルリング</div>	<div class='jp'>ジュエルリング</div> <div class='meaning'>Jem Ring (lit. 'Jewel Ring')</div> 
<div class='jp'>ホワイトケープ</div>	<div class='jp'>ホワイトケープ</div> <div class='meaning'>White Cape</div> 
<div class='jp'>エルメスのくつ</div>	<div class='jp'>エルメスのくつ</div> <div class='meaning'>Sprint Shoes (lit. 'Hermes Shoes')</div> 
<div class='jp'>安らぎの指輪</div>	<div class='jp'><ruby><rb>安</rb><rt>やす</rt></ruby>らぎの<ruby><rb>指輪</rb><rt>ゆびわ</rt></ruby></div> <div class='meaning'>Peace Ring (lit. 'Tranquil Ring')</div>  <br/> <div class='stroke'>安指輪</div> 
<div class='jp'>リボン</div>	<div class='jp'>リボン</div> <div class='meaning'>Ribbon</div> 
<div class='jp'>炎の指輪</div>	<div class='jp'><ruby><rb>炎</rb><rt>ほのお</rt></ruby>の<ruby><rb>指輪</rb><rt>ゆびわ</rt></ruby></div> <div class='meaning'>Fire Ring (lit. 'Flame Ring')</div>  <br/> <div class='stroke'>炎指輪</div> 
<div class='jp'>冷気の指輪</div>	<div class='jp'><ruby><rb>冷気</rb><rt>れいき</rt></ruby>の<ruby><rb>指輪</rb><rt>ゆびわ</rt></ruby></div> <div class='meaning'>Ice Ring (lit. 'Cold Ring')</div>  <br/> <div class='stroke'>冷気指輪</div> 
<div class='jp'>雷の指輪</div>	<div class='jp'><ruby><rb>雷</rb><rt>かみなり</rt></ruby>の<ruby><rb>指輪</rb><rt>ゆびわ</rt></ruby></div> <div class='meaning'>Bolt Ring (lit. 'Lightning Ring')</div>  <br/> <div class='stroke'>雷指輪</div> 
<div class='jp'>テトラエレメンタル</div>	<div class='jp'>テトラエレメンタル</div> <div class='meaning'>Tetra Elemental</div> 
<div class='jp'>セーフティビット</div>	<div class='jp'>セーフティビット</div> <div class='meaning'>Safety Bit</div> 
<div class='jp'>怒りの指輪</div>	<div class='jp'><ruby><rb>怒</rb><rt>いか</rt></ruby>りの<ruby><rb>指輪</rb><rt>ゆびわ</rt></ruby></div> <div class='meaning'>Fury Ring (lit. 'Anger Ring')</div>  <br/> <div class='stroke'>怒指輪</div> 
<div class='jp'>呪いの指輪</div>	<div class='jp'><ruby><rb>呪</rb><rt>のろ</rt></ruby>いの<ruby><rb>指輪</rb><rt>ゆびわ</rt></ruby></div> <div class='meaning'>Curse Ring (lit. 'Cursed Ring')</div>  <br/> <div class='stroke'>呪指輪</div> 
<div class='jp'>守りの指輪</div>	<div class='jp'><ruby><rb>守</rb><rt>も</rt></ruby>りの<ruby><rb>指輪</rb><rt>ゆびわ</rt></ruby></div> <div class='meaning'>Protect Ring (lit. 'Protection Ring')</div>  <br/> <div class='stroke'>守指輪</div> 
<div class='jp'>タマのすず</div>	<div class='jp'>タマのすず</div> <div class='meaning'>Cat's Bell (lit. 'Tama's Bell')</div> 
<div class='jp'>リフレクトリング</div>	<div class='jp'>リフレクトリング</div> <div class='meaning'>Reflect Ring</div> 
<div class='jp'>水の指輪</div>	<div class='jp'><ruby><rb>水</rb><rt>みず</rt></ruby>の<ruby><rb>指輪</rb><rt>ゆびわ</rt></ruby></div> <div class='meaning'>Water Ring</div>  <br/> <div class='stroke'>水指輪</div> 
<div class='jp'>盗族の小手</div>	<div class='jp'><ruby><rb>盗</rb><rt>とう</rt></ruby><ruby><rb>族</rb><rt>ぞく</rt></ruby>の<ruby><rb>小手</rb><rt>こて</rt></ruby></div> <div class='meaning'>Sneak Glove (lit. 'Thief's Bracer')</div>  <br/> <div class='stroke'>盗族小手</div> 
<div class='jp'>ヒュプノクラウン</div>	<div class='jp'>ヒュプノクラウン</div> <div class='meaning'>HypnoCrown (lit. 'Hypno-Crown')</div> 
<div class='jp'>ポーション</div>	<div class='jp'>ポーション</div> <div class='meaning'>Potion</div> 
<div class='jp'>ハイポーション</div>	<div class='jp'>ハイポーション</div> <div class='meaning'>Hi-Potion (lit. 'High Potion')</div> 
<div class='jp'>エクスポーション</div>	<div class='jp'>エクスポーション</div> <div class='meaning'>X-Potion</div> 
<div class='jp'>エーテル</div>	<div class='jp'>エーテル</div> <div class='meaning'>Ether</div> 
<div class='jp'>エーテルターボ</div>	<div class='jp'>エーテルターボ</div> <div class='meaning'>Turbo Ether (lit. 'Ether Turbo')</div> 
<div class='jp'>エリクサー</div>	<div class='jp'>エリクサー</div> <div class='meaning'>Elixir</div> 
<div class='jp'>ラストエリクサー</div>	<div class='jp'>ラストエリクサー</div> <div class='meaning'>Megalixir (lit. 'Last Elixir')</div> 
<div class='jp'>フェニックスの尾</div>	<div class='jp'>フェニックスの<ruby><rb>尾</rb><rt>お</rt></ruby></div> <div class='meaning'>Phoenix Down (lit. 'Phoenix Tail')</div>  <br/> <div class='stroke'>尾</div> 
<div class='jp'>毒消し</div>	<div class='jp'><ruby><rb>毒消</rb><rt>どくけ</rt></ruby>し</div> <div class='meaning'>Antidote</div>  <br/> <div class='stroke'>毒消</div> 
<div class='jp'>目薬</div>	<div class='jp'><ruby><rb>目薬</rb><rt>めぐすり</rt></ruby></div> <div class='meaning'>Eye drop (lit. 'Eye Drops')</div>  <br/> <div class='stroke'>目薬</div> 
<div class='jp'>金の針</div>	<div class='jp'><ruby><rb>金</rb><rt>きん</rt></ruby>の<ruby><rb>針</rb><rt>はり</rt></ruby></div> <div class='meaning'>Soft (lit. 'Golden Needle')</div>  <br/> <div class='stroke'>金針</div> 
<div class='jp'>乙女のキッス</div>	<div class='jp'><ruby><rb>乙女</rb><rt>おとめ</rt></ruby>のキッス</div> <div class='meaning'>Maiden's Kiss</div>  <br/> <div class='stroke'>乙女</div> 
<div class='jp'>うちでのこづち</div>	<div class='jp'>うちでのこづち</div> <div class='meaning'>Cornucopia (lit. 'Lucky Mallet')</div> 
<div class='jp'>やまびこえんまく</div>	<div class='jp'>やまびこえんまく</div> <div class='meaning'>Echo Screen (lit. 'Echo Smokescreen')</div> 
<div class='jp'>興奮剤</div>	<div class='jp'><ruby><rb>興奮剤</rb><rt>こうふんざい</rt></ruby></div> <div class='meaning'>Hyper (lit. 'Stimulant')</div>  <br/> <div class='stroke'>興奮剤</div> 
<div class='jp'>鎮静剤</div>	<div class='jp'><ruby><rb>鎮静剤</rb><rt>ちんせいざい</rt></ruby></div> <div class='meaning'>Tranquilizer</div>  <br/> <div class='stroke'>鎮静剤</div> 
<div class='jp'>万能薬</div>	<div class='jp'><ruby><rb>万能薬</rb><rt>ばんのうやく</rt></ruby></div> <div class='meaning'>Remedy (lit. 'Panacea')</div>  <br/> <div class='stroke'>万能薬</div> 
<div class='jp'>テント</div>	<div class='jp'>テント</div> <div class='meaning'>Tent</div> 
<div class='jp'>セーブクリスタル</div>	<div class='jp'>セーブクリスタル</div> <div class='meaning'>Save Crystal</div> 
<div class='jp'>けむりだま</div>	<div class='jp'>けむりだま</div> <div class='meaning'>Smoke Bomb</div> 
<div class='jp'>光のカーテン</div>	<div class='jp'><ruby><rb>光</rb><rt>ひかり</rt></ruby>のカーテン</div> <div class='meaning'>Light Curtain</div>  <br/> <div class='stroke'>光</div> 
<div class='jp'>月のカーテン</div>	<div class='jp'><ruby><rb>月</rb><rt>つき</rt></ruby>のカーテン</div> <div class='meaning'>Lunar Curtain</div>  <br/> <div class='stroke'>月</div> 
<div class='jp'>反射ミラー</div>	<div class='jp'><ruby><rb>反射</rb><rt>はんしゃ</rt></ruby>ミラー</div> <div class='meaning'>Mirror (lit. 'Reflective Mirror')</div>  <br/> <div class='stroke'>反射</div> 
<div class='jp'>スピードドリンク</div>	<div class='jp'>スピードドリンク</div> <div class='meaning'>Speed Drink</div> 
<div class='jp'>英雄の薬</div>	<div class='jp'><ruby><rb>英雄</rb><rt>えいゆう</rt></ruby>の<ruby><rb>薬</rb><rt>くすり</rt></ruby></div> <div class='meaning'>Hero Drink (lit. 'Hero Medicine')</div>  <br/> <div class='stroke'>英雄薬</div> 
<div class='jp'>ワクチン</div>	<div class='jp'>ワクチン</div> <div class='meaning'>Vaccine</div> 
<div class='jp'>聖なるトーチ</div>	<div class='jp'><ruby><rb>聖</rb><rt>せい</rt></ruby>なるトーチ</div> <div class='meaning'>Holy Torch</div>  <br/> <div class='stroke'>聖</div> 
<div class='jp'>手榴弾</div>	<div class='jp'><div><ruby><rb>手榴弾</rb><rt>しゅりゅうだん</rt></ruby><br></div></div> <div class='meaning'>Hand Grenade</div>  <br/> <div class='stroke'>手榴弾</div> 
<div class='jp'>ボムのかけら</div>	<div class='jp'>ボムのかけら</div> <div class='meaning'>Shrapnel (lit. 'Bomb Fragment')</div> 
<div class='jp'>ボムの右腕</div>	<div class='jp'>ボムの<ruby><rb>右腕</rb><rt>みぎうで</rt></ruby></div> <div class='meaning'>Right arm (lit. 'Bomb's Right Arm')</div>  <br/> <div class='stroke'>右腕</div> 
<div class='jp'>金の砂時計</div>	<div class='jp'><ruby><rb>金</rb><rt>きん</rt></ruby>の<ruby><rb>砂時計</rb><rt>すなどけい</rt></ruby></div> <div class='meaning'>Hourglass (lit. 'Golden Hourglass')</div>  <br/> <div class='stroke'>金砂時計</div> 
<div class='jp'>死神のキッス</div>	<div class='jp'><ruby><rb>死神</rb><rt>しにがみ</rt></ruby>のキッス</div> <div class='meaning'>Kiss of Death (lit. 'Grim Reaper's Kiss')</div>  <br/> <div class='stroke'>死神</div> 
<div class='jp'>クモの糸</div>	<div class='jp'><ruby><rb>クモの糸</rb><rt>くものいと</rt></ruby></div> <div class='meaning'>Spider Web (lit. 'Spider Thread')</div>  <br/> <div class='stroke'>糸</div> 
<div class='jp'>ドリームパウダー</div>	<div class='jp'>ドリームパウダー</div> <div class='meaning'>Dream Powder</div> 
<div class='jp'>サイレントマスク</div>	<div class='jp'>サイレントマスク</div> <div class='meaning'>Mute Mask (lit. 'Silent Mask')</div> 
<div class='jp'>戦いのゴング</div>	<div class='jp'><ruby><rb>戦</rb><rt>たたか</rt></ruby>いのゴング</div> <div class='meaning'>War Gong (lit. 'Battle Gong')</div>  <br/> <div class='stroke'>戦</div> 
<div class='jp'>惑わし草</div>	<div class='jp'><ruby><rb>惑</rb><rt>まど</rt></ruby>わし<ruby><rb>草</rb><rt>そう</rt></ruby></div> <div class='meaning'>Loco weed (lit. 'Delusion Grass')</div>  <br/> <div class='stroke'>惑草</div> 
<div class='jp'>火龍の牙</div>	<div class='jp'><ruby><rb>火</rb><rt>か</rt></ruby><ruby><rb>龍</rb><rt>りゅう</rt></ruby>の<ruby><rb>牙</rb><rt>きば</rt></ruby></div> <div class='meaning'>Fire Fang (lit. 'Firedrake Fang')</div>  <br/> <div class='stroke'>火龍牙</div> 
<div class='jp'>火とん</div>	<div class='jp'><ruby><rb>火</rb><rt>か</rt></ruby>とん</div> <div class='meaning'>Fire Veil (lit. 'Unleashed Fire')</div>  <br/> <div class='stroke'>火</div> 
<div class='jp'>南極の風</div>	<div class='jp'><ruby><rb>南極</rb><rt>なんきょく</rt></ruby>の<ruby><rb>風</rb><rt>かぜ</rt></ruby></div> <div class='meaning'>Antarctic Wind</div>  <br/> <div class='stroke'>南極風</div> 
<div class='jp'>冷気の結晶</div>	<div class='jp'><ruby><rb>冷気</rb><rt>れいき</rt></ruby>の<ruby><rb>結晶</rb><rt>けっしょう</rt></ruby></div> <div class='meaning'>Ice Crystal (lit. 'Cold Crystal')</div>  <br/> <div class='stroke'>冷気結晶</div> 
<div class='jp'>電撃鳥の角</div>	<div class='jp'><ruby><rb>電撃</rb><rt>でんげき</rt></ruby><ruby><rb>鳥</rb><rt>ちょう</rt></ruby>の<ruby><rb>角</rb><rt>つの</rt></ruby></div> <div class='meaning'>Bolt Plume (lit. 'Shock Bird Horn')</div>  <br/> <div class='stroke'>電撃鳥角</div> 
<div class='jp'>雷迅</div>	<div class='jp'><ruby><rb>雷迅</rb><rt>らいじん</rt></ruby></div> <div class='meaning'>Swift Bolt (lit. 'Swift Thunder')</div>  <br/> <div class='stroke'>雷迅</div> 
<div class='jp'>大地のドラム</div>	<div class='jp'><ruby><rb>大地</rb><rt>だいち</rt></ruby>のドラム</div> <div class='meaning'>Earth Drum</div>  <br/> <div class='stroke'>大地</div> 
<div class='jp'>大地のハンマー</div>	<div class='jp'><ruby><rb>大地</rb><rt>だいち</rt></ruby>のハンマー</div> <div class='meaning'>Earth Mallet (lit. 'Earth Hammer')</div>  <br/> <div class='stroke'>大地</div> 
<div class='jp'>有害物質</div>	<div class='jp'><ruby><rb>有害物質</rb><rt>ゆうがいぶっしつ</rt></ruby></div> <div class='meaning'>Deadly Waste (lit. 'Hazardous Material')</div>  <br/> <div class='stroke'>有害物質</div> 
<div class='jp'>モルボルの触手</div>	<div class='jp'>モルボルの<ruby><rb>触手</rb><rt>しょくしゅ</rt></ruby></div> <div class='meaning'>M-Tentacles (lit. 'Morbol Tentacle')</div>  <br/> <div class='stroke'>触手</div> 
<div class='jp'>星の砂</div>	<div class='jp'><ruby><rb>星</rb><rt>ほし</rt></ruby>の<ruby><rb>砂</rb><rt>すな</rt></ruby></div> <div class='meaning'>Stardust</div>  <br/> <div class='stroke'>星砂</div> 
<div class='jp'>バンパイアの牙</div>	<div class='jp'>バンパイアの<ruby><rb>牙</rb><rt>きば</rt></ruby></div> <div class='meaning'>Vampire Fang</div>  <br/> <div class='stroke'>牙</div> 
<div class='jp'>ゴーストハンド</div>	<div class='jp'>ゴーストハンド</div> <div class='meaning'>Ghost Hand</div> 
<div class='jp'>バジリスクの爪</div>	<div class='jp'>バジリスクの<ruby><rb>爪</rb><rt>つめ</rt></ruby></div> <div class='meaning'>Vagyrisk Claw (lit. 'Basilisk Claw')</div>  <br/> <div class='stroke'>爪</div> 
<div class='jp'>モズのはやにえ</div>	<div class='jp'>モズのはやにえ</div> <div class='meaning'>Impaler (lit. 'Shrike's Prey')</div> 
<div class='jp'>チヂマール</div>	<div class='jp'>チヂマール</div> <div class='meaning'>Shrivel (lit. 'Miniaturize')</div> 
<div class='jp'>ファイアカクテル</div>	<div class='jp'>ファイアカクテル</div> <div class='meaning'>Molotov (lit. 'Fire Cocktail')</div> 
<div class='jp'>巨鳥のハネ</div>	<div class='jp'><ruby><rb>巨鳥</rb><rt>きょちょう</rt></ruby>のハネ</div> <div class='meaning'>Bird Wing (lit. 'Giant Bird Feather')</div>  <br/> <div class='stroke'>巨鳥</div> 
<div class='jp'>海龍のウロコ</div>	<div class='jp'><ruby><rb>海</rb><rt>かい</rt></ruby><ruby><rb>龍</rb><rt>りゅう</rt></ruby>のウロコ</div> <div class='meaning'>Dragon Scales (lit. 'Sea Dragon Scale')</div>  <br/> <div class='stroke'>海龍</div> 
<div class='jp'>Ｓマイン</div>	<div class='jp'><ruby><rb>Ｓ</rb><rt>えす</rt></ruby>マイン</div> <div class='meaning'>S-Mine (lit. 'S Mine')</div> 
<div class='jp'>２０３ミリ砲弾</div>	<div class='jp'>２０３ミリ<ruby><rb>砲弾</rb><rt>ほうだん</rt></ruby></div> <div class='meaning'>8-inch Cannon (8inch Cannon) (lit. '203mm Cannon Shell')</div>  <br/> <div class='stroke'>砲弾</div> 
<div class='jp'>重力球</div>	<div class='jp'><ruby><rb>重力</rb><rt>じゅうりょく</rt></ruby><ruby><rb>球</rb><rt>きゅう</rt></ruby></div> <div class='meaning'>Graviball (lit. 'Gravity Ball')</div>  <br/> <div class='stroke'>重力球</div> 
<div class='jp'>時空弾</div>	<div class='jp'><ruby><rb>時空</rb><rt>じくう</rt></ruby><ruby><rb>弾</rb><rt>だん</rt></ruby></div> <div class='meaning'>T/S Bomb (lit. 'Spacetime Bomb')</div>  <br/> <div class='stroke'>時空弾</div> 
<div class='jp'>イカスミ</div>	<div class='jp'>イカスミ</div> <div class='meaning'>Ink (lit. 'Squid Ink')</div> 
<div class='jp'>しびれ針</div>	<div class='jp'>しびれ<ruby><rb>針</rb><rt>ばり</rt></ruby></div> <div class='meaning'>Dazers (lit. 'Numbness Needle')</div>  <br/> <div class='stroke'>針</div> 
<div class='jp'>双龍の牙</div>	<div class='jp'><ruby><rb>双</rb><rt>そう</rt></ruby><ruby><rb>龍</rb><rt>りゅう</rt></ruby>の<ruby><rb>牙</rb><rt>きば</rt></ruby></div> <div class='meaning'>Dragon Fang (lit. 'Twin Dragon Fang')</div>  <br/> <div class='stroke'>双龍牙</div> 
<div class='jp'>魔女の大釜</div>	<div class='jp'><ruby><rb>魔女</rb><rt>まじょ</rt></ruby>の<ruby><rb>大釜</rb><rt>おおがま</rt></ruby></div> <div class='meaning'>Cauldron (lit. 'Witch's Cauldron')</div>  <br/> <div class='stroke'>魔女大釜</div> 
<div class='jp'>ギザールの野菜</div>	<div class='jp'>ギザールの<ruby><rb>野菜</rb><rt>やさい</rt></ruby></div> <div class='meaning'>Gysahl Greens (lit. 'Gysahl Vegetable')</div>  <br/> <div class='stroke'>野菜</div> 
<div class='jp'>クラッカの野菜</div>	<div class='jp'>クラッカの<ruby><rb>野菜</rb><rt>やさい</rt></ruby></div> <div class='meaning'>Krakka Greens (lit. 'Karaka Vegetable')</div>  <br/> <div class='stroke'>野菜</div> 
<div class='jp'>タンタルの野菜</div>	<div class='jp'>タンタルの<ruby><rb>野菜</rb><rt>やさい</rt></ruby></div> <div class='meaning'>Tantal Greens (lit. 'Tantal Vegetable')</div>  <br/> <div class='stroke'>野菜</div> 
<div class='jp'>パサーナの野菜</div>	<div class='jp'>パサーナの<ruby><rb>野菜</rb><rt>やさい</rt></ruby></div> <div class='meaning'>Pahsana Greens (lit. 'Pasana Vegetable')</div>  <br/> <div class='stroke'>野菜</div> 
<div class='jp'>クリーエの野菜</div>	<div class='jp'>クリーエの<ruby><rb>野菜</rb><rt>やさい</rt></ruby></div> <div class='meaning'>Curiel Greens (lit. 'Curie Vegetable')</div>  <br/> <div class='stroke'>野菜</div> 
<div class='jp'>レイゲンの野菜</div>	<div class='jp'>レイゲンの<ruby><rb>野菜</rb><rt>やさい</rt></ruby></div> <div class='meaning'>Reagan Greens (lit. 'Reigen Vegetable')</div>  <br/> <div class='stroke'>野菜</div> 
<div class='jp'>ミメットの野菜</div>	<div class='jp'>ミメットの<ruby><rb>野菜</rb><rt>やさい</rt></ruby></div> <div class='meaning'>Mimett Greens (lit. 'Mimet Vegetable')</div>  <br/> <div class='stroke'>野菜</div> 
<div class='jp'>シルキスの野菜</div>	<div class='jp'>シルキスの<ruby><rb>野菜</rb><rt>やさい</rt></ruby></div> <div class='meaning'>Sylkis Greens (lit. 'Silkis Vegetable')</div>  <br/> <div class='stroke'>野菜</div> 
<div class='jp'>ピピオの実</div>	<div class='jp'>ピピオの<ruby><rb>実</rb><rt>み</rt></ruby></div> <div class='meaning'>Pepio Nut (lit. 'Pipio Fruit')</div>  <br/> <div class='stroke'>実</div> 
<div class='jp'>ルチルの実</div>	<div class='jp'>ルチルの<ruby><rb>実</rb><rt>み</rt></ruby></div> <div class='meaning'>Luchile Nut (lit. 'Rutile Fruit')</div>  <br/> <div class='stroke'>実</div> 
<div class='jp'>サラハの実</div>	<div class='jp'>サラハの<ruby><rb>実</rb><rt>み</rt></ruby></div> <div class='meaning'>Saraha Nut (lit. 'Saraha Fruit')</div>  <br/> <div class='stroke'>実</div> 
<div class='jp'>ラサンの実</div>	<div class='jp'>ラサンの<ruby><rb>実</rb><rt>み</rt></ruby></div> <div class='meaning'>Lasan Nut (lit. 'Lasan Fruit')</div>  <br/> <div class='stroke'>実</div> 
<div class='jp'>パラムの実</div>	<div class='jp'>パラムの<ruby><rb>実</rb><rt>み</rt></ruby></div> <div class='meaning'>Pram Nut (lit. 'Param Fruit')</div>  <br/> <div class='stroke'>実</div> 
<div class='jp'>ポロフの実</div>	<div class='jp'>ポロフの<ruby><rb>実</rb><rt>み</rt></ruby></div> <div class='meaning'>Porov Nut (lit. 'Polov Fruit')</div>  <br/> <div class='stroke'>実</div> 
<div class='jp'>カラブの実</div>	<div class='jp'>カラブの<ruby><rb>実</rb><rt>み</rt></ruby></div> <div class='meaning'>Carob Nut (lit. 'Carob Fruit')</div>  <br/> <div class='stroke'>実</div> 
<div class='jp'>ゼイオの実</div>	<div class='jp'>ゼイオの<ruby><rb>実</rb><rt>み</rt></ruby></div> <div class='meaning'>Zeio Nut (lit. 'Zeio Fruit')</div>  <br/> <div class='stroke'>実</div> 
<div class='jp'>パワーアップ</div>	<div class='jp'>パワーアップ</div> <div class='meaning'>Power Source (lit. 'Power Up')</div> 
<div class='jp'>ガードアップ</div>	<div class='jp'>ガードアップ</div> <div class='meaning'>Guard Source (lit. 'Guard Up')</div> 
<div class='jp'>マジックアップ</div>	<div class='jp'>マジックアップ</div> <div class='meaning'>Magic Source (lit. 'Magic Up')</div> 
<div class='jp'>マインドアップ</div>	<div class='jp'>マインドアップ</div> <div class='meaning'>Mind Source (lit. 'Mind Up')</div> 
<div class='jp'>スピードアップ</div>	<div class='jp'>スピードアップ</div> <div class='meaning'>Speed Source (lit. 'Speed Up')</div> 
<div class='jp'>ラックアップ</div>	<div class='jp'>ラックアップ</div> <div class='meaning'>Luck Source (lit. 'Luck Up')</div> 
<div class='jp'>１／３５神羅兵</div>	<div class='jp'>１／３５<ruby><rb>神</rb><rt>しん</rt></ruby><ruby><rb>羅</rb><rt>ら</rt></ruby><ruby><rb>兵</rb><rt>へい</rt></ruby></div> <div class='meaning'>1/35 soldier (lit. '1/35 Shinra Soldier')</div>  <br/> <div class='stroke'>神羅兵</div> 
<div class='jp'>ジンクバッテリー</div>	<div class='jp'>ジンクバッテリー</div> <div class='meaning'>Battery (lit. 'Zinc Battery')</div> 
<div class='jp'>ポケットティッシュ</div>	<div class='jp'>ポケットティッシュ</div> <div class='meaning'>Tissue (lit. 'Pocket Tissue')</div> 
<div class='jp'>超合金スイーパー</div>	<div class='jp'><ruby><rb>超合金</rb><rt>ちょうごうきん</rt></ruby>スイーパー</div> <div class='meaning'>Super Sweeper (lit. 'Super-Alloy Sweeper')</div>  <br/> <div class='stroke'>超合金</div> 
<div class='jp'>マサムネブレード</div>	<div class='jp'>マサムネブレード</div> <div class='meaning'>Masamune Blade</div> 
<div class='jp'>ディオ激闘日記</div>	<div class='jp'>ディオ<ruby><rb>激闘</rb><rt>げきとう</rt></ruby><ruby><rb>日記</rb><rt>にっき</rt></ruby></div> <div class='meaning'>Combat Diary (lit. 'Dio's Fierce Combat Diary')</div>  <br/> <div class='stroke'>激闘日記</div> 
<div class='jp'>サイン色紙</div>	<div class='jp'>サイン<ruby><rb>色紙</rb><rt>しきし</rt></ruby></div> <div class='meaning'>Autograph (lit. 'Signed Colored Paper')</div>  <br/> <div class='stroke'>色紙</div> 
<div class='jp'>人生バクチ打ち</div>	<div class='jp'><ruby><rb>人生</rb><rt>じんせい</rt></ruby>バクチ<ruby><rb>打</rb><rt>う</rt></ruby>ち</div> <div class='meaning'>Gambler (lit. 'Gambler's Life')</div>  <br/> <div class='stroke'>人生打</div> 
<div class='jp'>アースハープ</div>	<div class='jp'>アースハープ</div> <div class='meaning'>Earth Harp</div> 
<div class='jp'>デザートローズ</div>	<div class='jp'>デザートローズ</div> <div class='meaning'>Desert Rose</div> 
<div class='jp'>ガイドブック</div>	<div class='jp'>ガイドブック</div> <div class='meaning'>Guide Book (lit. 'Guidebook')</div> 
<div class='jp'>コットンのドレス</div>	<div class='jp'>コットンのドレス</div> <div class='meaning'>Cotton Dress</div> 
<div class='jp'>サテンのドレス</div>	<div class='jp'>サテンのドレス</div> <div class='meaning'>Satin Dress</div> 
<div class='jp'>シルクのドレス</div>	<div class='jp'>シルクのドレス</div> <div class='meaning'>Silk Dress</div> 
<div class='jp'>クセゲのかつら</div>	<div class='jp'>クセゲのかつら</div> <div class='meaning'>Wig (lit. 'Frizzy Wig')</div> 
<div class='jp'>チャバツのかつら</div>	<div class='jp'>チャバツのかつら</div> <div class='meaning'>Dyed Wig (lit. 'Brown Wig')</div> 
<div class='jp'>ブロンドのかつら</div>	<div class='jp'>ブロンドのかつら</div> <div class='meaning'>Blonde Wig</div> 
<div class='jp'>ガラスのティアラ</div>	<div class='jp'>ガラスのティアラ</div> <div class='meaning'>Glass Tiara</div> 
<div class='jp'>ルビーのティアラ</div>	<div class='jp'>ルビーのティアラ</div> <div class='meaning'>Ruby Tiara</div> 
<div class='jp'>ダイヤのティアラ</div>	<div class='jp'>ダイヤのティアラ</div> <div class='meaning'>Diamond Tiara</div> 
<div class='jp'>コロン</div>	<div class='jp'>コロン</div> <div class='meaning'>Cologne</div> 
<div class='jp'>フラワーコロン</div>	<div class='jp'>フラワーコロン</div> <div class='meaning'>Flower cologne (lit. 'Flower Cologne')</div> 
<div class='jp'>セクシーコロン</div>	<div class='jp'>セクシーコロン</div> <div class='meaning'>Sexy Cologne</div> 
<div class='jp'>ランジェリー</div>	<div class='jp'>ランジェリー</div> <div class='meaning'>Lingerie</div> 
<div class='jp'>ビキニパンツ</div>	<div class='jp'>ビキニパンツ</div> <div class='meaning'>Bikini briefs (lit. 'Bikini Underpants')</div> 
<div class='jp'>会員カード</div>	<div class='jp'><ruby><rb>会員</rb><rt>かいいん</rt></ruby>カード</div> <div class='meaning'>Member's Card (lit. 'Membership Card')</div>  <br/> <div class='stroke'>会員</div> 
<div class='jp'>薬屋商品クーポン</div>	<div class='jp'><ruby><rb>薬屋</rb><rt>くすりや</rt></ruby><ruby><rb>商品</rb><rt>しょうひん</rt></ruby>クーポン</div> <div class='meaning'>Pharmacy Coupons (lit. 'Pharmacy Merchandise Coupon')</div>  <br/> <div class='stroke'>薬屋商品</div> 
<div class='jp'>消毒薬</div>	<div class='jp'><ruby><rb>消毒薬</rb><rt>しょうどくやく</rt></ruby></div> <div class='meaning'>Disinfectant</div>  <br/> <div class='stroke'>消毒薬</div> 
<div class='jp'>消臭薬</div>	<div class='jp'><ruby><rb>消臭</rb><rt>しょうしゅう</rt></ruby><ruby><rb>薬</rb><rt>やく</rt></ruby></div> <div class='meaning'>Deodorant</div>  <br/> <div class='stroke'>消臭薬</div> 
<div class='jp'>消化薬</div>	<div class='jp'><ruby><rb>消化</rb><rt>しょうか</rt></ruby><ruby><rb>薬</rb><rt>やく</rt></ruby></div> <div class='meaning'>Digestive</div>  <br/> <div class='stroke'>消化薬</div> 
<div class='jp'>カードキー６０～６８</div>	<div class='jp'>カードキー６０～６８</div> <div class='meaning'>Keycard 60~68 (lit. 'Card Key 60~68')</div> 
<div class='jp'>ミッドガルパーツ</div>	<div class='jp'>ミッドガルパーツ</div> <div class='meaning'>Midgar parts (lit. 'Midgar Parts')</div> 
<div class='jp'>Ａ、Ｂ、Ｃクーポン</div>	<div class='jp'><ruby><rb>Ａ</rb><rt>えい</rt></ruby>、<ruby><rb>Ｂ</rb><rt>びー</rt></ruby>、<ruby><rb>Ｃ</rb><rt>しー</rt></ruby>クーポン</div> <div class='meaning'>A, B, C Coupon</div> 
<div class='jp'>ミスリル</div>	<div class='jp'>ミスリル</div> <div class='meaning'>Mythril (lit. 'Mithril')</div> 
<div class='jp'>ゴールドチケット</div>	<div class='jp'>ゴールドチケット</div> <div class='meaning'>Gold Ticket</div> 
<div class='jp'>地下室の鍵</div>	<div class='jp'><ruby><rb>地下室</rb><rt>ちかしつ</rt></ruby>の<ruby><rb>鍵</rb><rt>かぎ</rt></ruby></div> <div class='meaning'>Basement Key (lit. 'Cellar Key')</div>  <br/> <div class='stroke'>地下室鍵</div> 
<div class='jp'>キーストーン</div>	<div class='jp'>キーストーン</div> <div class='meaning'>Keystone</div> 
<div class='jp'>黒マテリア</div>	<div class='jp'><ruby><rb>黒</rb><rt>くろ</rt></ruby>マテリア</div> <div class='meaning'>Black Materia</div>  <br/> <div class='stroke'>黒</div> 
<div class='jp'>ルナハープ</div>	<div class='jp'>ルナハープ</div> <div class='meaning'>Lunar Harp</div> 
<div class='jp'>水神様のうろこ</div>	<div class='jp'><ruby><rb>水神</rb><rt>みずがみ</rt></ruby><ruby><rb>様</rb><rt>さま</rt></ruby>のうろこ</div> <div class='meaning'>Leviathan Scales (lit. 'Water God's Scales')</div>  <br/> <div class='stroke'>水神様</div> 
<div class='jp'>大氷河の地図</div>	<div class='jp'><ruby><rb>大</rb><rt>だい</rt></ruby><ruby><rb>氷河</rb><rt>ひょうが</rt></ruby>の<ruby><rb>地図</rb><rt>ちず</rt></ruby></div> <div class='meaning'>Glacier Map (lit. 'Great Glacier Map')</div>  <br/> <div class='stroke'>大氷河地図</div> 
<div class='jp'>スノーボード</div>	<div class='jp'>スノーボード</div> <div class='meaning'>Snowboard</div> 
<div class='jp'>ヒュージマテリア</div>	<div class='jp'>ヒュージマテリア</div> <div class='meaning'>Huge Materia</div> 
<div class='jp'>古代種の鍵</div>	<div class='jp'><ruby><rb>古代</rb><rt>こだい</rt></ruby><ruby><rb>種</rb><rt>しゅ</rt></ruby>の<ruby><rb>鍵</rb><rt>かぎ</rt></ruby></div> <div class='meaning'>Key to Ancients (lit. 'Ancients' Key')</div>  <br/> <div class='stroke'>古代種鍵</div> 
<div class='jp'>５番街ゲートの鍵</div>	<div class='jp'>５<ruby><rb>番</rb><rt>ばん</rt></ruby><ruby><rb>街</rb><rt>がい</rt></ruby>ゲートの<ruby><rb>鍵</rb><rt>かぎ</rt></ruby></div> <div class='meaning'>Key to Sector 5 (lit. 'District 5 Gate Key')</div>  <br/> <div class='stroke'>番街鍵</div> 
<div class='jp'>ファーストレイ</div>	<div class='jp'>ファーストレイ</div> <div class='meaning'>1st Ray (lit. 'First Ray')</div> 
<div class='jp'>トゥーサイド</div>	<div class='jp'>トゥーサイド</div> <div class='meaning'>2-Faced (lit. 'Two Side')</div> 
<div class='jp'>ヘクトアイズ</div>	<div class='jp'>ヘクトアイズ</div> <div class='meaning'>8 eye (lit. 'Hecto Eyes')</div> 
<div class='jp'>アクロフィーズ</div>	<div class='jp'>アクロフィーズ</div> <div class='meaning'>Acrophies</div> 
<div class='jp'>アダマンタイマイ</div>	<div class='jp'>アダマンタイマイ</div> <div class='meaning'>Adamantaimai</div> 
<div class='jp'>空中兵</div>	<div class='jp'><ruby><rb>空中</rb><rt>くうちゅう</rt></ruby><ruby><rb>兵</rb><rt>へい</rt></ruby></div> <div class='meaning'>Aero Combatant (lit. 'Sky Trooper')</div>  <br/> <div class='stroke'>空中兵</div> 
<div class='jp'>アーリマン</div>	<div class='jp'>アーリマン</div> <div class='meaning'>Allemagne (lit. 'Ahriman')</div> 
<div class='jp'>エンシャントドラゴン</div>	<div class='jp'>エンシャントドラゴン</div> <div class='meaning'>Ancient Dragon</div> 
<div class='jp'>アークドラゴン</div>	<div class='jp'>アークドラゴン</div> <div class='meaning'>Ark Dragon (lit. 'Archdragon')</div> 
<div class='jp'>フルアーマーゴーレム</div>	<div class='jp'>フルアーマーゴーレム</div> <div class='meaning'>Armored Golem (lit. 'Full Armor Golem')</div> 
<div class='jp'>親衛隊員</div>	<div class='jp'><ruby><rb>親衛隊</rb><rt>しんえいたい</rt></ruby><ruby><rb>員</rb><rt>いん</rt></ruby></div> <div class='meaning'>Attack Squad (lit. 'Elite Guard Member')</div>  <br/> <div class='stroke'>親衛隊員</div> 
<div class='jp'>イビルラップ</div>	<div class='jp'>イビルラップ</div> <div class='meaning'>Bad Rap (lit. 'Evil Wrap')</div> 
<div class='jp'>イビルラップサンプル</div>	<div class='jp'>イビルラップサンプル</div> <div class='meaning'>Bad Rap Sample (lit. 'Evil Wrap Sample')</div> 
<div class='jp'>バグナドラナ</div>	<div class='jp'>バグナドラナ</div> <div class='meaning'>Bagnadrana</div> 
<div class='jp'>バジリスク</div>	<div class='jp'>バジリスク</div> <div class='meaning'>Bagrisk (lit. 'Basilisk')</div> 
<div class='jp'>ババヴェラウミュ</div>	<div class='jp'>ババヴェラウミュ</div> <div class='meaning'>Bahba Velamyu (lit. 'Baba Velamyu')</div> 
<div class='jp'>バンダースナッチ</div>	<div class='jp'>バンダースナッチ</div> <div class='meaning'>Bandersnatch</div> 
<div class='jp'>バンディット</div>	<div class='jp'>バンディット</div> <div class='meaning'>Bandit</div> 
<div class='jp'>バッテリーキャップ</div>	<div class='jp'>バッテリーキャップ</div> <div class='meaning'>Battery Cap</div> 
<div class='jp'>ビーチプラグ</div>	<div class='jp'>ビーチプラグ</div> <div class='meaning'>Beachplug (lit. 'Beach Plug')</div> 
<div class='jp'>ベヒーモス</div>	<div class='jp'>ベヒーモス</div> <div class='meaning'>Behemoth</div> 
<div class='jp'>怪奇虫</div>	<div class='jp'><ruby><rb>怪奇</rb><rt>かいき</rt></ruby><ruby><rb>虫</rb><rt>ちゅう</rt></ruby></div> <div class='meaning'>Bizarre Bug</div>  <br/> <div class='stroke'>怪奇虫</div> 
<div class='jp'>ブラックバット</div>	<div class='jp'>ブラックバット</div> <div class='meaning'>Black Bat</div> 
<div class='jp'>スウェルフロート</div>	<div class='jp'>スウェルフロート</div> <div class='meaning'>Bloatfloat (lit. 'Swell Float')</div> 
<div class='jp'>ブラッドテイスト</div>	<div class='jp'>ブラッドテイスト</div> <div class='meaning'>Blood Taste</div> 
<div class='jp'>ブルードラゴン</div>	<div class='jp'>ブルードラゴン</div> <div class='meaning'>Blue Dragon</div> 
<div class='jp'>プアゾキュート</div>	<div class='jp'>プアゾキュート</div> <div class='meaning'>Blugu (lit. 'Poissocute')</div> 
<div class='jp'>ボム</div>	<div class='jp'>ボム</div> <div class='meaning'>Bomb</div> 
<div class='jp'>バウンドファット</div>	<div class='jp'>バウンドファット</div> <div class='meaning'>Boundfat (lit. 'Bound Fat')</div> 
<div class='jp'>ブレインポッド</div>	<div class='jp'>ブレインポッド</div> <div class='meaning'>Brain Pod</div> 
<div class='jp'>ブルモーター</div>	<div class='jp'>ブルモーター</div> <div class='meaning'>Bullmotor (lit. 'Bull Motor')</div> 
<div class='jp'>サポテンダー</div>	<div class='jp'>サポテンダー</div> <div class='meaning'>Cactuar (lit. 'Sapotender')</div> 
<div class='jp'>サボテンダー</div>	<div class='jp'>サボテンダー</div> <div class='meaning'>Cactuer (lit. 'Sabotender')</div> 
<div class='jp'>キャッパワイヤ</div>	<div class='jp'>キャッパワイヤ</div> <div class='meaning'>Capparwire (lit. 'Capper Wire')</div> 
<div class='jp'>隊長</div>	<div class='jp'><ruby><rb>隊長</rb><rt>たいちょう</rt></ruby></div> <div class='meaning'>Captain</div>  <br/> <div class='stroke'>隊長</div> 
<div class='jp'>カスタネッツ</div>	<div class='jp'>カスタネッツ</div> <div class='meaning'>Castanets</div> 
<div class='jp'>シェザーシザー</div>	<div class='jp'>シェザーシザー</div> <div class='meaning'>Ceasar (lit. 'Caesar Scissor')</div> 
<div class='jp'>チョコボ</div>	<div class='jp'>チョコボ</div> <div class='meaning'>Chocobo</div> 
<div class='jp'>クリストファー</div>	<div class='jp'>クリストファー</div> <div class='meaning'>Christopher</div> 
<div class='jp'>チュースタンク</div>	<div class='jp'>チュースタンク</div> <div class='meaning'>Chuse Tank (lit. 'Chews Tank')</div> 
<div class='jp'>ＣＭＤ.グランドホーン</div>	<div class='jp'>ＣＭＤ.グランドホーン</div> <div class='meaning'>CMD.Grand Horn (lit. 'CMD. Grand Horn')</div> 
<div class='jp'>コカトリス</div>	<div class='jp'>コカトリス</div> <div class='meaning'>Cokatolis (lit. 'Cockatrice')</div> 
<div class='jp'>コルネオの部下</div>	<div class='jp'>コルネオの<ruby><rb>部下</rb><rt>ぶか</rt></ruby></div> <div class='meaning'>Corneo's Lackey (lit. 'Corneo's Subordinate')</div>  <br/> <div class='stroke'>部下</div> 
<div class='jp'>コルベット</div>	<div class='jp'>コルベット</div> <div class='meaning'>Corvette</div> 
<div class='jp'>クロウラー</div>	<div class='jp'>クロウラー</div> <div class='meaning'>Crawler</div> 
<div class='jp'>クレイジーソウ</div>	<div class='jp'>クレイジーソウ</div> <div class='meaning'>Crazy Saw</div> 
<div class='jp'>クリプシェイ</div>	<div class='jp'>クリプシェイ</div> <div class='meaning'>Cripshay</div> 
<div class='jp'>クロムウェル</div>	<div class='jp'>クロムウェル</div> <div class='meaning'>Cromwell</div> 
<div class='jp'>クラウンランス</div>	<div class='jp'>クラウンランス</div> <div class='meaning'>Crown Lance</div> 
<div class='jp'>クリセイルス</div>	<div class='jp'>クリセイルス</div> <div class='meaning'>Crysales (lit. 'Chrysalis')</div> 
<div class='jp'>クアール</div>	<div class='jp'>クアール</div> <div class='meaning'>Cuahl (lit. 'Coeurl')</div> 
<div class='jp'>スイーパーカスタム</div>	<div class='jp'>スイーパーカスタム</div> <div class='meaning'>Custom Sweeper (lit. 'Sweeper Custom')</div> 
<div class='jp'>ダークドラゴン</div>	<div class='jp'>ダークドラゴン</div> <div class='meaning'>Dark Dragon</div> 
<div class='jp'>デスクロー</div>	<div class='jp'>デスクロー</div> <div class='meaning'>Death Claw</div> 
<div class='jp'>デスディーラー</div>	<div class='jp'>デスディーラー</div> <div class='meaning'>Death Dealer</div> 
<div class='jp'>デスマシン</div>	<div class='jp'>デスマシン</div> <div class='meaning'>Death Machine</div> 
<div class='jp'>ディーングロウ</div>	<div class='jp'>ディーングロウ</div> <div class='meaning'>Deenglow</div> 
<div class='jp'>デザートサハギン</div>	<div class='jp'>デザートサハギン</div> <div class='meaning'>Desert Sahagin (lit. 'Desert Sahuagin')</div> 
<div class='jp'>デビルライド</div>	<div class='jp'>デビルライド</div> <div class='meaning'>Devil Ride (lit. 'Devil Rider')</div> 
<div class='jp'>ディアブロ</div>	<div class='jp'>ディアブロ</div> <div class='meaning'>Diablo</div> 
<div class='jp'>ダイバーネスト</div>	<div class='jp'>ダイバーネスト</div> <div class='meaning'>Diver Nest</div> 
<div class='jp'>ドァブゥル</div>	<div class='jp'>ドァブゥル</div> <div class='meaning'>Doorbull (lit. 'Doubull')</div> 
<div class='jp'>ファニーフェイス</div>	<div class='jp'>ファニーフェイス</div> <div class='meaning'>Dorky Face (lit. 'Funny Face')</div> 
<div class='jp'>ドラゴン</div>	<div class='jp'>ドラゴン</div> <div class='meaning'>Dragon</div> 
<div class='jp'>ドラゴンライダー</div>	<div class='jp'>ドラゴンライダー</div> <div class='meaning'>Dragon Rider</div> 
<div class='jp'>ドラゴンゾンビー</div>	<div class='jp'>ドラゴンゾンビー</div> <div class='meaning'>Dragon Zombie</div> 
<div class='jp'>デュアルホーン</div>	<div class='jp'>デュアルホーン</div> <div class='meaning'>Dual Horn</div> 
<div class='jp'>イーグルガン</div>	<div class='jp'>イーグルガン</div> <div class='meaning'>Eagle Gun</div> 
<div class='jp'>刃頭獣</div>	<div class='jp'><ruby><rb>刃</rb><rt>は</rt></ruby><ruby><rb>頭</rb><rt>あたま</rt></ruby><ruby><rb>獣</rb><rt>じゅう</rt></ruby></div> <div class='meaning'>Edgehead (lit. 'Blade-Headed Animal')</div>  <br/> <div class='stroke'>刃頭獣</div> 
<div class='jp'>エレファダンク</div>	<div class='jp'>エレファダンク</div> <div class='meaning'>Elfadunk (lit. 'Elephadunk')</div> 
<div class='jp'>エリゴル</div>	<div class='jp'>エリゴル</div> <div class='meaning'>Eligor</div> 
<div class='jp'>エピオルニス</div>	<div class='jp'>エピオルニス</div> <div class='meaning'>Epiolnis (lit. 'Aepyornis')</div> 
<div class='jp'>イビルヘッド</div>	<div class='jp'>イビルヘッド</div> <div class='meaning'>Evilhead (lit. 'Evil Head')</div> 
<div class='jp'>フラップビート</div>	<div class='jp'>フラップビート</div> <div class='meaning'>Flapbeat (lit. 'Flap Beat')</div> 
<div class='jp'>フラワープラング</div>	<div class='jp'>フラワープラング</div> <div class='meaning'>Flower Prong</div> 
<div class='jp'>フォーミュラ</div>	<div class='jp'>フォーミュラ</div> <div class='meaning'>Formula</div> 
<div class='jp'>フォールランダ</div>	<div class='jp'>フォールランダ</div> <div class='meaning'>Foulander</div> 
<div class='jp'>フローズンネイル</div>	<div class='jp'>フローズンネイル</div> <div class='meaning'>Frozen Nail</div> 
<div class='jp'>ふせや　かずまさクン</div>	<div class='jp'>ふせや　かずまさクン</div> <div class='meaning'>N/A (lit. 'Kazumasa Fuseya')</div> 
<div class='jp'>バジガンディ</div>	<div class='jp'>バジガンディ</div> <div class='meaning'>Gagighandi (lit. 'Basigandi')</div> 
<div class='jp'>ガーゴイル</div>	<div class='jp'>ガーゴイル</div> <div class='meaning'>Gargoyle</div> 
<div class='jp'>ガルーダ</div>	<div class='jp'>ガルーダ</div> <div class='meaning'>Garuda</div> 
<div class='jp'>ガスダクター</div>	<div class='jp'>ガスダクター</div> <div class='meaning'>Gas Ducter</div> 
<div class='jp'>ギロフェルゴ</div>	<div class='jp'>ギロフェルゴ</div> <div class='meaning'>Ghirofelgo (lit. 'Guillofellgo')</div> 
<div class='jp'>ゴースト</div>	<div class='jp'>ゴースト</div> <div class='meaning'>Ghost</div> 
<div class='jp'>ゴーストシップ</div>	<div class='jp'>ゴーストシップ</div> <div class='meaning'>Ghost Ship</div> 
<div class='jp'>ギ族の亡霊</div>	<div class='jp'>ギ<ruby><rb>族</rb><rt>ぞく</rt></ruby>の<ruby><rb>亡霊</rb><rt>ぼうれい</rt></ruby></div> <div class='meaning'>Gi Spector (lit. 'Gi tribe Apparition')</div>  <br/> <div class='stroke'>族亡霊</div> 
<div class='jp'>ギガース</div>	<div class='jp'>ギガース</div> <div class='meaning'>Gigas</div> 
<div class='jp'>ジギィ</div>	<div class='jp'>ジギィ</div> <div class='meaning'>Gighee (lit. 'Ziggy')</div> 
<div class='jp'>ゴブリン</div>	<div class='jp'>ゴブリン</div> <div class='meaning'>Goblin</div> 
<div class='jp'>ゴーレム</div>	<div class='jp'>ゴーレム</div> <div class='meaning'>Golem</div> 
<div class='jp'>グランドホーン</div>	<div class='jp'>グランドホーン</div> <div class='meaning'>Grand Horn</div> 
<div class='jp'>グランガラン</div>	<div class='jp'>グランガラン</div> <div class='meaning'>Grangalan</div> 
<div class='jp'>コグランガラン</div>	<div class='jp'>コグランガラン</div> <div class='meaning'>Grangalan Jr. (lit. 'Grangalan's Child')</div> 
<div class='jp'>マゴグランガラン</div>	<div class='jp'>マゴグランガラン</div> <div class='meaning'>Grangalan Jr. Jr. (lit. 'Grangalan's Grandchild')</div> 
<div class='jp'>グラシュトライク</div>	<div class='jp'>グラシュトライク</div> <div class='meaning'>Grashtrike</div> 
<div class='jp'>グレムリン</div>	<div class='jp'>グレムリン</div> <div class='meaning'>Gremlin</div> 
<div class='jp'>グレネード</div>	<div class='jp'>グレネード</div> <div class='meaning'>Grenade</div> 
<div class='jp'>擲弾兵</div>	<div class='jp'><ruby><rb>擲弾</rb><rt>てきだん</rt></ruby><ruby><rb>兵</rb><rt>へい</rt></ruby></div> <div class='meaning'>Grenade Combatant (lit. 'Grenadier')</div>  <br/> <div class='stroke'>擲弾兵</div> 
<div class='jp'>グリフォン</div>	<div class='jp'>グリフォン</div> <div class='meaning'>Griffin (lit. 'Griffon')</div> 
<div class='jp'>グリムガード</div>	<div class='jp'>グリムガード</div> <div class='meaning'>Grimguard (lit. 'Grim Guard')</div> 
<div class='jp'>グロスパンツァー・大砲塔</div>	<div class='jp'>グロスパンツァー・<ruby><rb>大</rb><rt>たい</rt></ruby><ruby><rb>砲塔</rb><rt>ほうとう</rt></ruby></div> <div class='meaning'>Grosspanzer∙Big (lit. 'Grosspanzer: Big Gun Turret')</div>  <br/> <div class='stroke'>大砲塔</div> 
<div class='jp'>グロスパンツァー・車体</div>	<div class='jp'>グロスパンツァー・<ruby><rb>車体</rb><rt>しゃたい</rt></ruby></div> <div class='meaning'>Grosspanzer∙Mobile (lit. 'Grosspanzer: Frame')</div>  <br/> <div class='stroke'>車体</div> 
<div class='jp'>グロスパンツァー・小砲塔</div>	<div class='jp'>グロスパンツァー・<ruby><rb>小</rb><rt>しょう</rt></ruby><ruby><rb>砲塔</rb><rt>ほうとう</rt></ruby></div> <div class='meaning'>Grosspanzer∙Small (lit. 'Grosspanzer: Small Gun Turret')</div>  <br/> <div class='stroke'>小砲塔</div> 
<div class='jp'>戦闘員</div>	<div class='jp'><ruby><rb>戦闘員</rb><rt>せんとういん</rt></ruby></div> <div class='meaning'>Grunt (lit. 'Combatant')</div>  <br/> <div class='stroke'>戦闘員</div> 
<div class='jp'>ガードハウンド</div>	<div class='jp'>ガードハウンド</div> <div class='meaning'>Guard Hound</div> 
<div class='jp'>ガードシステム</div>	<div class='jp'>ガードシステム</div> <div class='meaning'>Guard System</div> 
<div class='jp'>ガーディアン</div>	<div class='jp'>ガーディアン</div> <div class='meaning'>Guardian</div> 
<div class='jp'>ガンキャリアー</div>	<div class='jp'>ガンキャリアー</div> <div class='meaning'>Gun Carrier</div> 
<div class='jp'>デジョンハンマ</div>	<div class='jp'>デジョンハンマ</div> <div class='meaning'>Hammer Blaster (lit. 'Dezone Hammer')</div> 
<div class='jp'>ハードアタッカー</div>	<div class='jp'>ハードアタッカー</div> <div class='meaning'>Hard Attacker</div> 
<div class='jp'>キマイラ</div>	<div class='jp'>キマイラ</div> <div class='meaning'>Harpy (lit. 'Chimera')</div> 
<div class='jp'>ネックハンター</div>	<div class='jp'>ネックハンター</div> <div class='meaning'>Head Hunter (lit. 'Neck Hunter')</div> 
<div class='jp'>ヘッドボンバー</div>	<div class='jp'>ヘッドボンバー</div> <div class='meaning'>Headbomber (lit. 'Head Bomber')</div> 
<div class='jp'>ヘビータンク</div>	<div class='jp'>ヘビータンク</div> <div class='meaning'>Heavy Tank</div> 
<div class='jp'>ヘッジホッグパイ</div>	<div class='jp'>ヘッジホッグパイ</div> <div class='meaning'>Hedgehog Pie</div> 
<div class='jp'>ニーズへッグ</div>	<div class='jp'>ニーズへッグ</div> <div class='meaning'>Heg (lit. 'Nidhogg')</div> 
<div class='jp'>ヘルハウス</div>	<div class='jp'>ヘルハウス</div> <div class='meaning'>Hell House</div> 
<div class='jp'>ヘルハーレーＶＲ２</div>	<div class='jp'>ヘルハーレーＶＲ２</div> <div class='meaning'>Hell Rider VR2 (lit. 'Hell Harley VR2')</div> 
<div class='jp'>ヒポグリフ</div>	<div class='jp'>ヒポグリフ</div> <div class='meaning'>Hippogriff</div> 
<div class='jp'>オチュー</div>	<div class='jp'>オチュー</div> <div class='meaning'>Ho-chu (lit. 'Otyugh')</div> 
<div class='jp'>ハングリー</div>	<div class='jp'>ハングリー</div> <div class='meaning'>Hungry</div> 
<div class='jp'>アイスゴーレム</div>	<div class='jp'>アイスゴーレム</div> <div class='meaning'>Ice Golem</div> 
<div class='jp'>つらら</div>	<div class='jp'>つらら</div> <div class='meaning'>Icicle</div> 
<div class='jp'>鉄巨人</div>	<div class='jp'><ruby><rb>鉄</rb><rt>てつ</rt></ruby><ruby><rb>巨人</rb><rt>きょじん</rt></ruby></div> <div class='meaning'>Iron Man (lit. 'Iron Giant')</div>  <br/> <div class='stroke'>鉄巨人</div> 
<div class='jp'>アイロネート</div>	<div class='jp'>アイロネート</div> <div class='meaning'>Ironite (lit. 'Ironet')</div> 
<div class='jp'>ジェジュジェミ</div>	<div class='jp'>ジェジュジェミ</div> <div class='meaning'>Jayjujayme</div> 
<div class='jp'>ジェミニスミー</div>	<div class='jp'>ジェミニスミー</div> <div class='meaning'>Jemnezmy (lit. 'Geminismi')</div> 
<div class='jp'>ジャッジ</div>	<div class='jp'>ジャッジ</div> <div class='meaning'>Jersey (lit. 'Judge')</div> 
<div class='jp'>ジョーカー</div>	<div class='jp'>ジョーカー</div> <div class='meaning'>Joker</div> 
<div class='jp'>ジャンピング</div>	<div class='jp'>ジャンピング</div> <div class='meaning'>Jumping</div> 
<div class='jp'>カームファング</div>	<div class='jp'>カームファング</div> <div class='meaning'>Kalm Fang</div> 
<div class='jp'>ゲルシュメルゼ</div>	<div class='jp'>ゲルシュメルゼ</div> <div class='meaning'>Kelzmelzer (lit. 'Gel Schmelze')</div> 
<div class='jp'>キュルビヌュ</div>	<div class='jp'>キュルビヌュ</div> <div class='meaning'>Killbin (lit. 'Curubinew')</div> 
<div class='jp'>インセクトキマラ</div>	<div class='jp'>インセクトキマラ</div> <div class='meaning'>Kimara Bug (lit. 'Insect Chimera')</div> 
<div class='jp'>キングベヒーモス</div>	<div class='jp'>キングベヒーモス</div> <div class='meaning'>King Behemoth</div> 
<div class='jp'>キュビルデュヌス</div>	<div class='jp'>キュビルデュヌス</div> <div class='meaning'>Kyuvilduns (lit. 'Kuvildunus')</div> 
<div class='jp'>ランドウォーム</div>	<div class='jp'>ランドウォーム</div> <div class='meaning'>Land Worm</div> 
<div class='jp'>レーザーキャノン</div>	<div class='jp'>レーザーキャノン</div> <div class='meaning'>Laser Cannon</div> 
<div class='jp'>レッサーロプロス</div>	<div class='jp'>レッサーロプロス</div> <div class='meaning'>Lessaloploth (lit. 'Lesser Ropross')</div> 
<div class='jp'>レブリコン</div>	<div class='jp'>レブリコン</div> <div class='meaning'>Levrikon</div> 
<div class='jp'>マシンガン</div>	<div class='jp'>マシンガン</div> <div class='meaning'>Machine Gun</div> 
<div class='jp'>マドゥジュ</div>	<div class='jp'>マドゥジュ</div> <div class='meaning'>Madouge</div> 
<div class='jp'>マジックポット</div>	<div class='jp'>マジックポット</div> <div class='meaning'>Magic Pot</div> 
<div class='jp'>マグナード</div>	<div class='jp'>マグナード</div> <div class='meaning'>Magnade</div> 
<div class='jp'>モルボル</div>	<div class='jp'>モルボル</div> <div class='meaning'>Malboro (lit. 'Morbol')</div> 
<div class='jp'>モールダンサー</div>	<div class='jp'>モールダンサー</div> <div class='meaning'>Malldancer (lit. 'Maul Dancer')</div> 
<div class='jp'>マンドラゴラ</div>	<div class='jp'>マンドラゴラ</div> <div class='meaning'>Mandragora</div> 
<div class='jp'>マンホール</div>	<div class='jp'>マンホール</div> <div class='meaning'>Manhole</div> 
<div class='jp'>海兵隊員</div>	<div class='jp'><ruby><rb>海兵隊</rb><rt>かいへいたい</rt></ruby><ruby><rb>員</rb><rt>いん</rt></ruby></div> <div class='meaning'>Marine</div>  <br/> <div class='stroke'>海兵隊員</div> 
<div class='jp'>マスタートンベリ</div>	<div class='jp'>マスタートンベリ</div> <div class='meaning'>Master Tonberry</div> 
<div class='jp'>まつむら　やすしクン</div>	<div class='jp'>まつむら　やすしクン</div> <div class='meaning'>N/A (lit. 'Yasushi Matsumara')</div> 
<div class='jp'>マキシマムキマイラ</div>	<div class='jp'>マキシマムキマイラ</div> <div class='meaning'>Maximum Kimaira (lit. 'Maximum Chimera')</div> 
<div class='jp'>ミドガルズオルム</div>	<div class='jp'>ミドガルズオルム</div> <div class='meaning'>Midgar Zolom (lit. 'Midgardsormr')</div> 
<div class='jp'>強化戦闘員</div>	<div class='jp'><ruby><rb>強化</rb><rt>きょうか</rt></ruby><ruby><rb>戦闘員</rb><rt>せんとういん</rt></ruby></div> <div class='meaning'>Mighty Grunt (lit. 'Strengthened Combatant')</div>  <br/> <div class='stroke'>強化戦闘員</div> 
<div class='jp'>ミラージュ</div>	<div class='jp'>ミラージュ</div> <div class='meaning'>Mirage</div> 
<div class='jp'>モノドライブ</div>	<div class='jp'>モノドライブ</div> <div class='meaning'>Mono Drive</div> 
<div class='jp'>モススラッシャー</div>	<div class='jp'>モススラッシャー</div> <div class='meaning'>Moth Slasher (lit. 'Moss Slasher')</div> 
<div class='jp'>ムーバー</div>	<div class='jp'>ムーバー</div> <div class='meaning'>Mover</div> 
<div class='jp'>警備兵</div>	<div class='jp'><ruby><rb>警備兵</rb><rt>けいびへい</rt></ruby></div> <div class='meaning'>MP (lit. 'Guard')</div>  <br/> <div class='stroke'>警備兵</div> 
<div class='jp'>ムー</div>	<div class='jp'>ムー</div> <div class='meaning'>Mu</div> 
<div class='jp'>謎のニンジャ</div>	<div class='jp'><ruby><rb>謎</rb><rt>なぞ</rt></ruby>のニンジャ</div> <div class='meaning'>Mystery Ninja (lit. 'Mysterious Ninja')</div>  <br/> <div class='stroke'>謎</div> 
<div class='jp'>ニードルキッス</div>	<div class='jp'>ニードルキッス</div> <div class='meaning'>Needle Kiss</div> 
<div class='jp'>ネロスフェロス</div>	<div class='jp'>ネロスフェロス</div> <div class='meaning'>Nerosuferoth (lit. 'Nerospheroth')</div> 
<div class='jp'>ニブルウルフ</div>	<div class='jp'>ニブルウルフ</div> <div class='meaning'>Nibel Wolf (lit. 'Nifl Wolf')</div> 
<div class='jp'>パラサイト</div>	<div class='jp'>パラサイト</div> <div class='meaning'>Parasite</div> 
<div class='jp'>ポーランサリタ</div>	<div class='jp'>ポーランサリタ</div> <div class='meaning'>Pollensalta (lit. 'Pouran Salita')</div> 
<div class='jp'>プドゥレア</div>	<div class='jp'>プドゥレア</div> <div class='meaning'>Poodler (lit. 'Poderare')</div> 
<div class='jp'>プドゥレアサンプル</div>	<div class='jp'>プドゥレアサンプル</div> <div class='meaning'>Poodler Sample (lit. 'Poderare Sample')</div> 
<div class='jp'>プロトマシンガン</div>	<div class='jp'>プロトマシンガン</div> <div class='meaning'>Proto Machinegun (lit. 'Proto Machine Gun')</div> 
<div class='jp'>プラウラー</div>	<div class='jp'>プラウラー</div> <div class='meaning'>Prowler</div> 
<div class='jp'>ピラミッド</div>	<div class='jp'>ピラミッド</div> <div class='meaning'>Pyramid</div> 
<div class='jp'>クイックマシンガン</div>	<div class='jp'>クイックマシンガン</div> <div class='meaning'>Quick Machine Gun</div> 
<div class='jp'>足斬草</div>	<div class='jp'><ruby><rb>足</rb><rt>あし</rt></ruby><ruby><rb>斬</rb><rt>き</rt></ruby><ruby><rb>草</rb><rt>そう</rt></ruby></div> <div class='meaning'>Razor Weed (lit. 'Foot-Cutting Grass')</div>  <br/> <div class='stroke'>足斬草</div> 
<div class='jp'>リルフサック</div>	<div class='jp'>リルフサック</div> <div class='meaning'>Rilfsak</div> 
<div class='jp'>ミサイルランチャー</div>	<div class='jp'>ミサイルランチャー</div> <div class='meaning'>Rocket Launcher (lit. 'Missile Launcher')</div> 
<div class='jp'>カノンルーレット</div>	<div class='jp'>カノンルーレット</div> <div class='meaning'>Roulette Cannon (lit. 'Cannon Roulette')</div> 
<div class='jp'>サハギン</div>	<div class='jp'>サハギン</div> <div class='meaning'>Sahagin (lit. 'Sahuagin')</div> 
<div class='jp'>サンプル：Ｈ０５１２‐ＯＰＴ</div>	<div class='jp'>サンプル：<ruby><rb>Ｈ</rb><rt>えいち</rt></ruby>０５１２‐ＯＰＴ</div> <div class='meaning'>Sample:H0512-opt (lit. 'Sample: H0512-OPT')</div> 
<div class='jp'>シザース</div>	<div class='jp'>シザース</div> <div class='meaning'>Scissors</div> 
<div class='jp'>ソッチ</div>	<div class='jp'>ソッチ</div> <div class='meaning'>Scotch (lit. 'Sotci')</div> 
<div class='jp'>スクリーマー</div>	<div class='jp'>スクリーマー</div> <div class='meaning'>Screamer</div> 
<div class='jp'>サーチアイ</div>	<div class='jp'>サーチアイ</div> <div class='meaning'>Scrutin Eye (lit. 'Search Eye')</div> 
<div class='jp'>スカルプチュア</div>	<div class='jp'>スカルプチュア</div> <div class='meaning'>Sculpture</div> 
<div class='jp'>シーウォーム</div>	<div class='jp'>シーウォーム</div> <div class='meaning'>Sea Worm</div> 
<div class='jp'>サーチャクラウン</div>	<div class='jp'>サーチャクラウン</div> <div class='meaning'>Search Crown (lit. 'Searcher Crown')</div> 
<div class='jp'>上級戦闘員</div>	<div class='jp'><ruby><rb>上級</rb><rt>じょうきゅう</rt></ruby><ruby><rb>戦闘員</rb><rt>せんとういん</rt></ruby></div> <div class='meaning'>Senior Grunt (lit. 'Senior Combatant')</div>  <br/> <div class='stroke'>上級戦闘員</div> 
<div class='jp'>サーペント</div>	<div class='jp'>サーペント</div> <div class='meaning'>Serpent</div> 
<div class='jp'>シャドウメーカー</div>	<div class='jp'>シャドウメーカー</div> <div class='meaning'>Shadow Maker</div> 
<div class='jp'>シュレッド</div>	<div class='jp'>シュレッド</div> <div class='meaning'>Shred</div> 
<div class='jp'>キキキアチョ</div>	<div class='jp'>キキキアチョ</div> <div class='meaning'>Skeeskee (lit. 'Kikiki Bird')</div> 
<div class='jp'>スラローム</div>	<div class='jp'>スラローム</div> <div class='meaning'>Slalom</div> 
<div class='jp'>スラップス</div>	<div class='jp'>スラップス</div> <div class='meaning'>Slaps</div> 
<div class='jp'>スモッグファクト</div>	<div class='jp'>スモッグファクト</div> <div class='meaning'>Smogger (lit. 'Smog Factory')</div> 
<div class='jp'>ステルシーステップ</div>	<div class='jp'>ステルシーステップ</div> <div class='meaning'>Sneaky Step (lit. 'Stealthy Step')</div> 
<div class='jp'>スノウ</div>	<div class='jp'>スノウ</div> <div class='meaning'>Snow</div> 
<div class='jp'>ソルジャー：１ＳＴ</div>	<div class='jp'>ソルジャー：１ＳＴ</div> <div class='meaning'>SOLDIER:1st (lit. 'Soldier: 1ST')</div> 
<div class='jp'>ソルジャー：２ＮＤ</div>	<div class='jp'>ソルジャー：２ＮＤ</div> <div class='meaning'>SOLDIER:2nd (lit. 'Soldier: 2ND')</div> 
<div class='jp'>ソルジャー：３ＲＤ</div>	<div class='jp'>ソルジャー：３<ruby><rb>Ｒ</rb><rt>らうんど</rt></ruby><ruby><rb>Ｄ</rb><rt>でぃー</rt></ruby></div> <div class='meaning'>SOLDIER:3rd (lit. 'Soldier: 3RD')</div> 
<div class='jp'>スピードサウンド</div>	<div class='jp'>スピードサウンド</div> <div class='meaning'>Sonic Speed (lit. 'Speed Sound')</div> 
<div class='jp'>ソウルファイア</div>	<div class='jp'>ソウルファイア</div> <div class='meaning'>Soul Fire</div> 
<div class='jp'>特殊戦闘員</div>	<div class='jp'><ruby><rb>特殊</rb><rt>とくしゅ</rt></ruby><ruby><rb>戦闘員</rb><rt>せんとういん</rt></ruby></div> <div class='meaning'>Special Combatant</div>  <br/> <div class='stroke'>特殊戦闘員</div> 
<div class='jp'>スペンサー</div>	<div class='jp'>スペンサー</div> <div class='meaning'>Spencer (lit. 'Spenser')</div> 
<div class='jp'>スパイラル</div>	<div class='jp'>スパイラル</div> <div class='meaning'>Spiral</div> 
<div class='jp'>スティルヴ</div>	<div class='jp'>スティルヴ</div> <div class='meaning'>Stilva (lit. 'Stilve')</div> 
<div class='jp'>スティンガー</div>	<div class='jp'>スティンガー</div> <div class='meaning'>Stinger</div> 
<div class='jp'>神羅潜水兵</div>	<div class='jp'><ruby><rb>神</rb><rt>しん</rt></ruby><ruby><rb>羅</rb><rt>ら</rt></ruby><ruby><rb>潜水</rb><rt>せんすい</rt></ruby><ruby><rb>兵</rb><rt>へい</rt></ruby></div> <div class='meaning'>Submarine Crew (lit. 'Shinra Submariner')</div>  <br/> <div class='stroke'>神羅潜水兵</div> 
<div class='jp'>スイーパー</div>	<div class='jp'>スイーパー</div> <div class='meaning'>Sweeper</div> 
<div class='jp'>ソードダンス</div>	<div class='jp'>ソードダンス</div> <div class='meaning'>Sword Dance</div> 
<div class='jp'>尾跳飛</div>	<div class='jp'><ruby><rb>尾跳飛</rb><rt>びちょうひ</rt></ruby></div> <div class='meaning'>Tail Vault (lit. 'Tail Leap')</div>  <br/> <div class='stroke'>尾跳飛</div> 
<div class='jp'>雷神鳥</div>	<div class='jp'><ruby><rb>雷神</rb><rt>らいじん</rt></ruby><ruby><rb>鳥</rb><rt>ちょう</rt></ruby></div> <div class='meaning'>Thunderbird (lit. 'Raijin Bird')</div>  <br/> <div class='stroke'>雷神鳥</div> 
<div class='jp'>トーンアドゥ</div>	<div class='jp'>トーンアドゥ</div> <div class='meaning'>Tonadu (lit. 'Tornade')</div> 
<div class='jp'>トンベリ</div>	<div class='jp'>トンベリ</div> <div class='meaning'>Tonberry</div> 
<div class='jp'>タッチミー</div>	<div class='jp'>タッチミー</div> <div class='meaning'>Touch Me</div> 
<div class='jp'>ポイズンフロッグ</div>	<div class='jp'>ポイズンフロッグ</div> <div class='meaning'>Toxic Frog (lit. 'Poison Frog')</div> 
<div class='jp'>トリックプレイ</div>	<div class='jp'>トリックプレイ</div> <div class='meaning'>Trickplay (lit. 'Trick Prey')</div> 
<div class='jp'>ダブルブレイン</div>	<div class='jp'>ダブルブレイン</div> <div class='meaning'>Twin Brain (lit. 'Double Brain')</div> 
<div class='jp'>アンダーリザード</div>	<div class='jp'>アンダーリザード</div> <div class='meaning'>Under Lizard</div> 
<div class='jp'>海底警備兵</div>	<div class='jp'><ruby><rb>海底</rb><rt>かいてい</rt></ruby><ruby><rb>警備兵</rb><rt>けいびへい</rt></ruby></div> <div class='meaning'>Underwater MP (lit. 'Seabed Guard')</div>  <br/> <div class='stroke'>海底警備兵</div> 
<div class='jp'>正体不明</div>	<div class='jp'><ruby><rb>正体不明</rb><rt>しょうたいふめい</rt></ruby></div> <div class='meaning'>Unknown (lit. 'Form Unknown')</div>  <br/> <div class='stroke'>正体不明</div> 
<div class='jp'>正体不明２</div>	<div class='jp'><ruby><rb>正体不明</rb><rt>しょうたいふめい</rt></ruby>２</div> <div class='meaning'>Unknown 2 (lit. 'Form Unknown 2')</div>  <br/> <div class='stroke'>正体不明</div> 
<div class='jp'>正体不明３</div>	<div class='jp'><ruby><rb>正体不明</rb><rt>しょうたいふめい</rt></ruby>３</div> <div class='meaning'>Unknown 3 (lit. 'Form Unknown 3')</div>  <br/> <div class='stroke'>正体不明</div> 
<div class='jp'>バルロン</div>	<div class='jp'>バルロン</div> <div class='meaning'>Valron (lit. 'Balron')</div> 
<div class='jp'>ヴァギドポリス</div>	<div class='jp'>ヴァギドポリス</div> <div class='meaning'>Vargid Police (lit. 'Vagidopolis')</div> 
<div class='jp'>ベルチャータスク</div>	<div class='jp'>ベルチャータスク</div> <div class='meaning'>Velcher Task (lit. 'Belcher Task')</div> 
<div class='jp'>ヴァイス</div>	<div class='jp'>ヴァイス</div> <div class='meaning'>Vice</div> 
<div class='jp'>ブラキオレイドス</div>	<div class='jp'>ブラキオレイドス</div> <div class='meaning'>Vlakorados (lit. 'Brachioraidus')</div> 
<div class='jp'>警告板</div>	<div class='jp'><ruby><rb>警告</rb><rt>けいこく</rt></ruby><ruby><rb>板</rb><rt>ばん</rt></ruby></div> <div class='meaning'>Warning Board</div>  <br/> <div class='stroke'>警告板</div> 
<div class='jp'>水球</div>	<div class='jp'><ruby><rb>水球</rb><rt>すいきゅう</rt></ruby></div> <div class='meaning'>Waterpolo (lit. 'Water Ball')</div>  <br/> <div class='stroke'>水球</div> 
<div class='jp'>ホウルイーター</div>	<div class='jp'>ホウルイーター</div> <div class='meaning'>Whole Eater (lit. 'Hole Eater')</div> 
<div class='jp'>ウィンドウィング</div>	<div class='jp'>ウィンドウィング</div> <div class='meaning'>Wind Wing</div> 
<div class='jp'>ウルフラマイター</div>	<div class='jp'>ウルフラマイター</div> <div class='meaning'>Wolfmeister (lit. 'Wolfraimiter')</div> 
<div class='jp'>超級怒龍砲</div>	<div class='jp'><ruby><rb>超</rb><rt>ちょう</rt></ruby><ruby><rb>級</rb><rt>きゅう</rt></ruby><ruby><rb>怒</rb><rt>ど</rt></ruby><ruby><rb>龍</rb><rt>りゅう</rt></ruby><ruby><rb>砲</rb><rt>ほう</rt></ruby></div> <div class='meaning'>XCannon (lit. 'Transultimate Angry Dragon Cannon')</div>  <br/> <div class='stroke'>超級怒龍砲</div> 
<div class='jp'>ヤン</div>	<div class='jp'>ヤン</div> <div class='meaning'>Yang</div> 
<div class='jp'>イン</div>	<div class='jp'>イン</div> <div class='meaning'>Ying (lit. 'Yin')</div> 
<div class='jp'>ゼムゼレット</div>	<div class='jp'>ゼムゼレット</div> <div class='meaning'>Zemzelett</div> 
<div class='jp'>ゼネネ</div>	<div class='jp'>ゼネネ</div> <div class='meaning'>Zenene</div> 
<div class='jp'>ゾロカルター</div>	<div class='jp'>ゾロカルター</div> <div class='meaning'>Zolokalter</div> 
<div class='jp'>ズー</div>	<div class='jp'>ズー</div> <div class='meaning'>Zuu</div> 
<div class='jp'>エアバスター</div>	<div class='jp'>エアバスター</div> <div class='meaning'>Air Buster</div> 
<div class='jp'>アプス</div>	<div class='jp'>アプス</div> <div class='meaning'>Aps (lit. 'Apsu')</div> 
<div class='jp'>リバース・セフィロス</div>	<div class='jp'>リバース・セフィロス</div> <div class='meaning'>Bizarro∙Sephiroth (lit. 'Rebirth Sephiroth')</div> 
<div class='jp'>ボトムスウェル</div>	<div class='jp'>ボトムスウェル</div> <div class='meaning'>Bottomswell</div> 
<div class='jp'>キャリーアーマー</div>	<div class='jp'>キャリーアーマー</div> <div class='meaning'>Carry Armor</div> 
<div class='jp'>チェホフ</div>	<div class='jp'>チェホフ</div> <div class='meaning'>Chekov (lit. 'Chekhov')</div> 
<div class='jp'>ダークネイション</div>	<div class='jp'>ダークネイション</div> <div class='meaning'>Dark Nation</div> 
<div class='jp'>デモンズゲイト</div>	<div class='jp'>デモンズゲイト</div> <div class='meaning'>Demons Gate (lit. 'Demon's Gate')</div> 
<div class='jp'>ダイヤウェポン</div>	<div class='jp'>ダイヤウェポン</div> <div class='meaning'>Diamond Weapon</div> 
<div class='jp'>ダイン</div>	<div class='jp'>ダイン</div> <div class='meaning'>Dyne</div> 
<div class='jp'>エメラルドウェポン</div>	<div class='jp'>エメラルドウェポン</div> <div class='meaning'>Emerald Weapon</div> 
<div class='jp'>目</div>	<div class='jp'><ruby><rb>目</rb><rt>め</rt></ruby></div> <div class='meaning'>Eye</div>  <br/> <div class='stroke'>目</div> 
<div class='jp'>ギ・ナタタク</div>	<div class='jp'>ギ・ナタタク</div> <div class='meaning'>Gi Nattak (lit. 'Gi Natatak')</div> 
<div class='jp'>ゴドー</div>	<div class='jp'>ゴドー</div> <div class='meaning'>Godo (lit. 'Godot')</div> 
<div class='jp'>ゴーリキー</div>	<div class='jp'>ゴーリキー</div> <div class='meaning'>Gorkii (lit. 'Gorky')</div> 
<div class='jp'>ガードスコーピオン</div>	<div class='jp'>ガードスコーピオン</div> <div class='meaning'>Guard Scorpion</div> 
<div class='jp'>ヘリガンナー</div>	<div class='jp'>ヘリガンナー</div> <div class='meaning'>Heli Gunner</div> 
<div class='jp'>ヘレティック宝条</div>	<div class='jp'>ヘレティック<ruby><rb>宝</rb><rt>たから</rt></ruby><ruby><rb>条</rb><rt>じょう</rt></ruby></div> <div class='meaning'>Helletic Hojo (lit. 'Heretic Hojo')</div>  <br/> <div class='stroke'>宝条</div> 
<div class='jp'>宝条</div>	<div class='jp'><ruby><rb>宝</rb><rt>たから</rt></ruby><ruby><rb>条</rb><rt>じょう</rt></ruby></div> <div class='meaning'>Hojo</div>  <br/> <div class='stroke'>宝条</div> 
<div class='jp'>ハンドレッドガンナー</div>	<div class='jp'>ハンドレッドガンナー</div> <div class='meaning'>Hundred Gunner</div> 
<div class='jp'>ジャマーアーマー</div>	<div class='jp'>ジャマーアーマー</div> <div class='meaning'>Jamar Armor (lit. 'Jammer Armor')</div> 
<div class='jp'>ジェノバ・ＢＩＲＴＨ</div>	<div class='jp'>ジェノバ・ＢＩＲＴＨ</div> <div class='meaning'>Jenova∙BIRTH (lit. 'Jenova: BIRTH')</div> 
<div class='jp'>ジェノバ・ＬＩＦＥ</div>	<div class='jp'>ジェノバ・ＬＩＦＥ</div> <div class='meaning'>Jenova∙LIFE (lit. 'Jenova: LIFE')</div> 
<div class='jp'>ジェノバ・ＤＥＡＴＨ</div>	<div class='jp'>ジェノバ・ＤＥＡＴＨ</div> <div class='meaning'>Jenova∙DEATH (lit. 'Jenova: DEATH')</div> 
<div class='jp'>ジェノバ・ＳＹＮＴＨＥＳＩＳ</div>	<div class='jp'>ジェノバ・ＳＹＮＴＨＥＳＩＳ</div> <div class='meaning'>Jenova∙SYNTHESIS (lit. 'Jenova: SYNTHESIS')</div> 
<div class='jp'>左腕</div>	<div class='jp'><ruby><rb>左</rb><rt>ひだり</rt></ruby><ruby><rb>腕</rb><rt>うで</rt></ruby></div> <div class='meaning'>Left Arm (Helletic Hojo) (lit. 'Left Arm')</div>  <br/> <div class='stroke'>左腕</div> 
<div class='jp'>極限生命体宝条ＮＡ</div>	<div class='jp'><ruby><rb>極限</rb><rt>きょくげん</rt></ruby><ruby><rb>生命体</rb><rt>せいめいたい</rt></ruby><ruby><rb>宝</rb><rt>ほう</rt></ruby><ruby><rb>条</rb><rt>じょう</rt></ruby> ＮＡ</div> <div class='meaning'>Lifeform-Hojo N (lit. 'Extreme Lifeform Hojo NA')</div>  <br/> <div class='stroke'>極限生命体宝条</div> 
<div class='jp'>ロストナンバー</div>	<div class='jp'>ロストナンバー</div> <div class='meaning'>Lost Number</div> 
<div class='jp'>マテリアキーパー</div>	<div class='jp'>マテリアキーパー</div> <div class='meaning'>Materia Keeper</div> 
<div class='jp'>モーターボール</div>	<div class='jp'>モーターボール</div> <div class='meaning'>Motor Ball (lit. 'Motorball')</div> 
<div class='jp'>パルマー</div>	<div class='jp'>パルマー</div> <div class='meaning'>Palmer</div> 
<div class='jp'>プラウド・クラッド</div>	<div class='jp'>プラウド・クラッド</div> <div class='meaning'>Proud Clod (lit. 'Proudclad')</div> 
<div class='jp'>ラプス</div>	<div class='jp'>ラプス</div> <div class='meaning'>Rapps (lit. 'Rapsu')</div> 
<div class='jp'>レッドドラゴン</div>	<div class='jp'>レッドドラゴン</div> <div class='meaning'>Red Dragon</div> 
<div class='jp'>右腕</div>	<div class='jp'><ruby><rb>右</rb><rt>みぎ</rt></ruby><ruby><rb>腕</rb><rt>うで</rt></ruby></div> <div class='meaning'>Right Arm (Helletic Hojo) (lit. 'Right Arm')</div>  <br/> <div class='stroke'>右腕</div> 
<div class='jp'>ルビーウェポン</div>	<div class='jp'>ルビーウェポン</div> <div class='meaning'>Ruby Weapon</div> 
<div class='jp'>触手</div>	<div class='jp'><ruby><rb>触手</rb><rt>しょくしゅ</rt></ruby></div> <div class='meaning'>Ruby's Tentacle (lit. 'Tentacle')</div>  <br/> <div class='stroke'>触手</div> 
<div class='jp'>ルーファウス</div>	<div class='jp'>ルーファウス</div> <div class='meaning'>Rufus</div> 
<div class='jp'>サンプル：Ｈ０５１２</div>	<div class='jp'>サンプル：<ruby><rb>Ｈ</rb><rt>えいち</rt></ruby>０５１２</div> <div class='meaning'>Sample:H0512 (lit. 'Sample: H0512')</div> 
<div class='jp'>セーファ・セフィロス</div>	<div class='jp'>セーファ・セフィロス</div> <div class='meaning'>Safer∙Sephiroth (lit. 'Sepher Sephiroth')</div> 
<div class='jp'>ツインヘッド</div>	<div class='jp'>ツインヘッド</div> <div class='meaning'>Schizo (lit. 'Twinhead')</div> 
<div class='jp'>セフィロス</div>	<div class='jp'>セフィロス</div> <div class='meaning'>Sephiroth</div> 
<div class='jp'>シェイク</div>	<div class='jp'>シェイク</div> <div class='meaning'>Shake</div> 
<div class='jp'>スタニフ</div>	<div class='jp'>スタニフ</div> <div class='meaning'>Staniv</div> 
<div class='jp'>タークス: イリーナ</div>	<div class='jp'>タークス:イリーナ</div> <div class='meaning'>Turks:Elena (lit. 'Turks: Irena')</div> 
<div class='jp'>タークス: レノ</div>	<div class='jp'>タークス:レノ</div> <div class='meaning'>Turks:Reno (lit. 'Turks: Reno')</div> 
<div class='jp'>タークス: ルード</div>	<div class='jp'>タークス:ルード</div> <div class='meaning'>Turks:Rude (lit. 'Turks: Rude')</div> 
<div class='jp'>？？？</div>	<div class='jp'>？？？</div> <div class='meaning'>???</div> 
<div class='jp'>怪しい針</div>	<div class='jp'><ruby><rb>怪</rb><rt>あや</rt></ruby>しい<ruby><rb>針</rb><rt>はり</rt></ruby></div> <div class='meaning'>? Needle (lit. 'Suspicious Needle')</div>  <br/> <div class='stroke'>怪針</div> 
<div class='jp'>ハンドレッドニードル</div>	<div class='jp'>ハンドレッドニードル</div> <div class='meaning'>100 Needles</div> 
<div class='jp'>はりせんぼん</div>	<div class='jp'>はりせんぼん</div> <div class='meaning'>1000 Needles</div> 
<div class='jp'>２段アタック</div>	<div class='jp'>２<ruby><rb>段</rb><rt>だん</rt></ruby>アタック</div> <div class='meaning'>2-stage Attack (lit. 'Double Attack')</div>  <br/> <div class='stroke'>段</div> 
<div class='jp'>ＡＢ砲</div>	<div class='jp'><ruby><rb>ＡＢ</rb><rt>えいびー</rt></ruby><ruby><rb>砲</rb><rt>ほう</rt></ruby></div> <div class='meaning'>AB Cannon</div>  <br/> <div class='stroke'>砲</div> 
<div class='jp'>異常ブレス</div>	<div class='jp'><ruby><rb>異常</rb><rt>いじょう</rt></ruby>ブレス</div> <div class='meaning'>Abnormal Breath (lit. 'Abnormality Breath')</div>  <br/> <div class='stroke'>異常</div> 
<div class='jp'>ステータス異常弾</div>	<div class='jp'>ステータス<ruby><rb>異常</rb><rt>いじょう</rt></ruby><ruby><rb>弾</rb><rt>だん</rt></ruby></div> <div class='meaning'>Abnormal Shell (lit. 'Status Abnormality Shell')</div>  <br/> <div class='stroke'>異常弾</div> 
<div class='jp'>吸収</div>	<div class='jp'><ruby><rb>吸収</rb><rt>きゅうしゅう</rt></ruby></div> <div class='meaning'>Absorb</div>  <br/> <div class='stroke'>吸収</div> 
<div class='jp'>アシッドシャワー</div>	<div class='jp'>アシッドシャワー</div> <div class='meaning'>Acid Rain (lit. 'Acid Shower')</div> 
<div class='jp'>アドレナリン</div>	<div class='jp'>アドレナリン</div> <div class='meaning'>Adrenaline</div> 
<div class='jp'>エアロガ</div>	<div class='jp'>エアロガ</div> <div class='meaning'>Aero3 (lit. 'Aeroga')</div> 
<div class='jp'>エアボンバー</div>	<div class='jp'>エアボンバー</div> <div class='meaning'>Air Bomber</div> 
<div class='jp'>エメラルドビッグバン</div>	<div class='jp'>エメラルドビッグバン</div> <div class='meaning'>Aire Tam Storm (lit. 'Emerald Big Bang')</div> 
<div class='jp'>角突き</div>	<div class='jp'><ruby><rb>角</rb><rt>つの</rt></ruby><ruby><rb>突</rb><rt>つ</rt></ruby>き</div> <div class='meaning'>Angle Punch (lit. 'Horn Thrust')</div>  <br/> <div class='stroke'>角突</div> 
<div class='jp'>アームアタック</div>	<div class='jp'>アームアタック</div> <div class='meaning'>Arm Attack</div> 
<div class='jp'>アームキヤッチ</div>	<div class='jp'>アームキヤッチ</div> <div class='meaning'>Arm Grab (lit. 'Arm Catch')</div> 
<div class='jp'>アームパンチ</div>	<div class='jp'>アームパンチ</div> <div class='meaning'>Arm Punch</div> 
<div class='jp'>アスピル</div>	<div class='jp'>アスピル</div> <div class='meaning'>Aspil</div> 
<div class='jp'>アトミックレイ</div>	<div class='jp'>アトミックレイ</div> <div class='meaning'>Atomic Ray</div> 
<div class='jp'>オーロラフェンス</div>	<div class='jp'>オーロラフェンス</div> <div class='meaning'>Aurora Fence</div> 
<div class='jp'>木の葉乱舞</div>	<div class='jp'><ruby><rb>木の葉</rb><rt>このは</rt></ruby><ruby><rb>乱舞</rb><rt>らんぶ</rt></ruby></div> <div class='meaning'>Autumn Leaves (lit. 'Wild Leaf Dance')</div>  <br/> <div class='stroke'>木葉乱舞</div> 
<div class='jp'>副砲</div>	<div class='jp'><ruby><rb>副</rb><rt>ふく</rt></ruby><ruby><rb>砲</rb><rt>ほう</rt></ruby></div> <div class='meaning'>Aux Artillery (lit. 'Auxiliary Cannon')</div>  <br/> <div class='stroke'>副砲</div> 
<div class='jp'>雪崩</div>	<div class='jp'><ruby><rb>雪崩</rb><rt>なだれ</rt></ruby></div> <div class='meaning'>Avalanche</div>  <br/> <div class='stroke'>雪崩</div> 
<div class='jp'>ののしる</div>	<div class='jp'>ののしる</div> <div class='meaning'>Bad mouth (lit. 'Insult')</div> 
<div class='jp'>暴れる</div>	<div class='jp'><ruby><rb>暴</rb><rt>あば</rt></ruby>れる</div> <div class='meaning'>Ballistic (lit. 'Rage')</div>  <br/> <div class='stroke'>暴</div> 
<div class='jp'>クチバシ</div>	<div class='jp'>クチバシ</div> <div class='meaning'>Beak</div> 
<div class='jp'>ビームキャノン</div>	<div class='jp'>ビームキャノン</div> <div class='meaning'>Beam Cannon</div> 
<div class='jp'>マシンガンビーム</div>	<div class='jp'>マシンガンビーム</div> <div class='meaning'>Beam Gun (lit. 'Machine Gun Beam')</div> 
<div class='jp'>ビーストソード</div>	<div class='jp'>ビーストソード</div> <div class='meaning'>Beast Sword</div> 
<div class='jp'>バーサク針</div>	<div class='jp'>バーサク<ruby><rb>針</rb><rt>はり</rt></ruby></div> <div class='meaning'>Berserk Needle</div>  <br/> <div class='stroke'>針</div> 
<div class='jp'>まどわしハート</div>	<div class='jp'>まどわしハート</div> <div class='meaning'>Bewildered (lit. 'Bewildering Heart')</div> 
<div class='jp'>ビッグボンバー</div>	<div class='jp'>ビッグボンバー</div> <div class='meaning'>Big Bomber</div> 
<div class='jp'>大口ブレス</div>	<div class='jp'><ruby><rb>大口</rb><rt>おおぐち</rt></ruby>ブレス</div> <div class='meaning'>Big Breath (lit. 'Big Mouth Breath')</div>  <br/> <div class='stroke'>大口</div> 
<div class='jp'>ビッグクロウ</div>	<div class='jp'>ビッグクロウ</div> <div class='meaning'>Big Claw</div> 
<div class='jp'>ビッグファング</div>	<div class='jp'>ビッグファング</div> <div class='meaning'>Big Fang</div> 
<div class='jp'>ビッグハンドクラッシュ</div>	<div class='jp'>ビッグハンドクラッシュ</div> <div class='meaning'>Big Hand Clash (lit. 'Big Hand Crush')</div> 
<div class='jp'>大角</div>	<div class='jp'><ruby><rb>大</rb><rt>おお</rt></ruby><ruby><rb>角</rb><rt>つの</rt></ruby></div> <div class='meaning'>Big Horn</div>  <br/> <div class='stroke'>大角</div> 
<div class='jp'>大花粉</div>	<div class='jp'><ruby><rb>大</rb><rt>だい</rt></ruby><ruby><rb>花粉</rb><rt>かふん</rt></ruby></div> <div class='meaning'>Big Pollen</div>  <br/> <div class='stroke'>大花粉</div> 
<div class='jp'>ビッグパンチ</div>	<div class='jp'>ビッグパンチ</div> <div class='meaning'>Big Punch</div> 
<div class='jp'>ビッグレッドクリッパー</div>	<div class='jp'>ビッグレッドクリッパー</div> <div class='meaning'>Big Red Clipper</div> 
<div class='jp'>大音波</div>	<div class='jp'><ruby><rb>大</rb><rt>だい</rt></ruby><ruby><rb>音波</rb><rt>おんぱ</rt></ruby></div> <div class='meaning'>Big Sound (lit. 'Big Soundwave')</div>  <br/> <div class='stroke'>大音波</div> 
<div class='jp'>大旋回</div>	<div class='jp'><ruby><rb>大</rb><rt>だい</rt></ruby><ruby><rb>旋回</rb><rt>せんかい</rt></ruby></div> <div class='meaning'>Big Spiral (lit. 'Big Rotation')</div>  <br/> <div class='stroke'>大旋回</div> 
<div class='jp'>ビッグスイング</div>	<div class='jp'>ビッグスイング</div> <div class='meaning'>Big Swing</div> 
<div class='jp'>ビッグウェーブ</div>	<div class='jp'>ビッグウェーブ</div> <div class='meaning'>Big Wave</div> 
<div class='jp'>バイオガス</div>	<div class='jp'>バイオガス</div> <div class='meaning'>Bio Gas</div> 
<div class='jp'>鳥キック</div>	<div class='jp'><ruby><rb>鳥</rb><rt>とり</rt></ruby>キック</div> <div class='meaning'>Bird Kick</div>  <br/> <div class='stroke'>鳥</div> 
<div class='jp'>かみつき</div>	<div class='jp'>かみつき</div> <div class='meaning'>Bite</div> 
<div class='jp'>リバース・エナジー</div>	<div class='jp'>リバース・エナジー</div> <div class='meaning'>Bizzarro Enegy (lit. 'Rebirth Energy')</div> 
<div class='jp'>ブラスター</div>	<div class='jp'>ブラスター</div> <div class='meaning'>Blaster</div> 
<div class='jp'>吸血</div>	<div class='jp'><ruby><rb>吸血</rb><rt>きゅうけつ</rt></ruby></div> <div class='meaning'>Blood Suck</div>  <br/> <div class='stroke'>吸血</div> 
<div class='jp'>ブラッドネイル</div>	<div class='jp'>ブラッドネイル</div> <div class='meaning'>Bloody Nail (lit. 'Blood Nail')</div> 
<div class='jp'>ふきとばし</div>	<div class='jp'>ふきとばし</div> <div class='meaning'>Blown Away (lit. 'Blow Away')</div> 
<div class='jp'>ブルードラゴンブレス</div>	<div class='jp'>ブルードラゴンブレス</div> <div class='meaning'>Blue Dragon Breath</div> 
<div class='jp'>ブルーフレーム</div>	<div class='jp'>ブルーフレーム</div> <div class='meaning'>Blue Flame</div> 
<div class='jp'>ブルーインパルス</div>	<div class='jp'>ブルーインパルス</div> <div class='meaning'>Blue Impulse</div> 
<div class='jp'>青い光</div>	<div class='jp'><ruby><rb>青</rb><rt>あお</rt></ruby>い<ruby><rb>光</rb><rt>ひかり</rt></ruby></div> <div class='meaning'>Blue Light</div>  <br/> <div class='stroke'>青光</div> 
<div class='jp'>全体尾</div>	<div class='jp'><ruby><rb>全体</rb><rt>ぜんたい</rt></ruby><ruby><rb>尾</rb><rt>び</rt></ruby></div> <div class='meaning'>Body Tail (lit. 'Whole Tail')</div>  <br/> <div class='stroke'>全体尾</div> 
<div class='jp'>体当たり</div>	<div class='jp'><ruby><rb>体当</rb><rt>たいあ</rt></ruby>たり</div> <div class='meaning'>Bodyblow (lit. 'Body Blow')</div>  <br/> <div class='stroke'>体当</div> 
<div class='jp'>電撃球</div>	<div class='jp'><ruby><rb>電撃</rb><rt>でんげき</rt></ruby><ruby><rb>球</rb><rt>きゅう</rt></ruby></div> <div class='meaning'>Bolt Ball (lit. 'Shock Ball')</div>  <br/> <div class='stroke'>電撃球</div> 
<div class='jp'>ボム爆発</div>	<div class='jp'>ボム<ruby><rb>爆発</rb><rt>ばくはつ</rt></ruby></div> <div class='meaning'>Bomb Blast (lit. 'Bomb Explosion')</div>  <br/> <div class='stroke'>爆発</div> 
<div class='jp'>ボーン</div>	<div class='jp'>ボーン</div> <div class='meaning'>Bone</div> 
<div class='jp'>軟骨剣</div>	<div class='jp'><ruby><rb>軟骨</rb><rt>なんこつ</rt></ruby><ruby><rb>剣</rb><rt>けん</rt></ruby></div> <div class='meaning'>Bonecutter (lit. 'Cartilage Sword')</div>  <br/> <div class='stroke'>軟骨剣</div> 
<div class='jp'>アワ</div>	<div class='jp'>アワ</div> <div class='meaning'>Bubble</div> 
<div class='jp'>虫針</div>	<div class='jp'><ruby><rb>虫</rb><rt>むし</rt></ruby><ruby><rb>針</rb><rt>ばり</rt></ruby></div> <div class='meaning'>Bug Needle</div>  <br/> <div class='stroke'>虫針</div> 
<div class='jp'>バタフライアタック</div>	<div class='jp'>バタフライアタック</div> <div class='meaning'>Butterfly Attack</div> 
<div class='jp'>Ｃ砲</div>	<div class='jp'><ruby><rb>Ｃ</rb><rt>しー</rt></ruby><ruby><rb>砲</rb><rt>ほう</rt></ruby></div> <div class='meaning'>C Cannon</div>  <br/> <div class='stroke'>砲</div> 
<div class='jp'>カプセル</div>	<div class='jp'>カプセル</div> <div class='meaning'>Capsule</div> 
<div class='jp'>カタパルト</div>	<div class='jp'>カタパルト</div> <div class='meaning'>Catapult</div> 
<div class='jp'>落盤</div>	<div class='jp'><ruby><rb>落盤</rb><rt>らくばん</rt></ruby></div> <div class='meaning'>Cave-in</div>  <br/> <div class='stroke'>落盤</div> 
<div class='jp'>突進</div>	<div class='jp'><ruby><rb>突進</rb><rt>とっしん</rt></ruby></div> <div class='meaning'>Charge</div>  <br/> <div class='stroke'>突進</div> 
<div class='jp'>チョコボ、あばれる</div>	<div class='jp'>チョコボ、あばれる</div> <div class='meaning'>Chocobo goes nuts (lit. 'Chocobo, raging')</div> 
<div class='jp'>急降下アタック</div>	<div class='jp'><ruby><rb>急降下</rb><rt>きゅうこうか</rt></ruby>アタック</div> <div class='meaning'>Chute Attack (lit. 'Swoop Attack')</div>  <br/> <div class='stroke'>急降下</div> 
<div class='jp'>ツメ</div>	<div class='jp'>ツメ</div> <div class='meaning'>Claw</div> 
<div class='jp'>クラブ</div>	<div class='jp'>クラブ</div> <div class='meaning'>Club</div> 
<div class='jp'>ぼくさつにんじんソード</div>	<div class='jp'>ぼくさつにんじんソード</div> <div class='meaning'>Club Sword (lit. 'Fatal Carrot Sword')</div> 
<div class='jp'>冷気</div>	<div class='jp'><ruby><rb>冷気</rb><rt>れいき</rt></ruby></div> <div class='meaning'>Cold</div>  <br/> <div class='stroke'>冷気</div> 
<div class='jp'>コールドブレス</div>	<div class='jp'>コールドブレス</div> <div class='meaning'>Cold Breath</div> 
<div class='jp'>指冷凍弾</div>	<div class='jp'><ruby><rb>指</rb><rt>ゆび</rt></ruby><ruby><rb>冷凍</rb><rt>れいとう</rt></ruby><ruby><rb>弾</rb><rt>だん</rt></ruby></div> <div class='meaning'>Cold Snap (lit. 'Freezing Finger Bullet')</div>  <br/> <div class='stroke'>指冷凍弾</div> 
<div class='jp'>コンボ</div>	<div class='jp'>コンボ</div> <div class='meaning'>Combo</div> 
<div class='jp'>混乱ミサイル</div>	<div class='jp'><ruby><rb>混乱</rb><rt>こんらん</rt></ruby>ミサイル</div> <div class='meaning'>Confu Missile (lit. 'Confusion Missile')</div>  <br/> <div class='stroke'>混乱</div> 
<div class='jp'>混乱鱗粉</div>	<div class='jp'><ruby><rb>混乱</rb><rt>こんらん</rt></ruby><ruby><rb>鱗粉</rb><rt>りんぷん</rt></ruby></div> <div class='meaning'>Confu-scales (lit. 'Confusion Scales')</div>  <br/> <div class='stroke'>混乱鱗粉</div> 
<div class='jp'>連続ツメ</div>	<div class='jp'><ruby><rb>連続</rb><rt>れんぞく</rt></ruby>ツメ</div> <div class='meaning'>Continu-claw (lit. 'Continuous Claw')</div>  <br/> <div class='stroke'>連続</div> 
<div class='jp'>ひび</div>	<div class='jp'>ひび</div> <div class='meaning'>Crack</div> 
<div class='jp'>マッドクロウ</div>	<div class='jp'>マッドクロウ</div> <div class='meaning'>Crazy Claw (lit. 'Mad Claw')</div> 
<div class='jp'>不気味タッチ</div>	<div class='jp'><ruby><rb>不気味</rb><rt>ぶきみ</rt></ruby>タッチ</div> <div class='meaning'>Creepy Touch (lit. 'Eerie Touch')</div>  <br/> <div class='stroke'>不気味</div> 
<div class='jp'>クロスインパルス</div>	<div class='jp'>クロスインパルス</div> <div class='meaning'>Cross Impulse</div> 
<div class='jp'>クロスシザー</div>	<div class='jp'>クロスシザー</div> <div class='meaning'>Cross Scissor</div> 
<div class='jp'>押し潰す</div>	<div class='jp'><ruby><rb>押</rb><rt>お</rt></ruby>し<ruby><rb>潰</rb><rt>つぶ</rt></ruby>す</div> <div class='meaning'>Crush</div>  <br/> <div class='stroke'>押潰</div> 
<div class='jp'>のろいの言葉</div>	<div class='jp'>のろいの<ruby><rb>言葉</rb><rt>ことば</rt></ruby></div> <div class='meaning'>Curses (lit. 'Cursed Words')</div>  <br/> <div class='stroke'>言葉</div> 
<div class='jp'>きり</div>	<div class='jp'>きり</div> <div class='meaning'>Cut (lit. 'Slash')</div> 
<div class='jp'>カッター</div>	<div class='jp'>カッター</div> <div class='meaning'>Cutter</div> 
<div class='jp'>ダメージ攻撃</div>	<div class='jp'>ダメージ<ruby><rb>攻撃</rb><rt>こうげき</rt></ruby></div> <div class='meaning'>Damage Attack</div>  <br/> <div class='stroke'>攻撃</div> 
<div class='jp'>ダンス</div>	<div class='jp'>ダンス</div> <div class='meaning'>Dance</div> 
<div class='jp'>ダークドラゴンブレス</div>	<div class='jp'>ダークドラゴンブレス</div> <div class='meaning'>Dark Dragon Breath</div> 
<div class='jp'>ダークニードル</div>	<div class='jp'>ダークニードル</div> <div class='meaning'>Dark Needle</div> 
<div class='jp'>ダークアイ</div>	<div class='jp'>ダークアイ</div> <div class='meaning'>Darkeye (lit. 'Dark Eye')</div> 
<div class='jp'>危ない針</div>	<div class='jp'><ruby><rb>危</rb><rt>あぶ</rt></ruby>ない<ruby><rb>針</rb><rt>はり</rt></ruby></div> <div class='meaning'>Deadly Needles (lit. 'Dangerous Needle')</div>  <br/> <div class='stroke'>危針</div> 
<div class='jp'>デッドリーホイール</div>	<div class='jp'>デッドリーホイール</div> <div class='meaning'>Deadly Wheel</div> 
<div class='jp'>デイン</div>	<div class='jp'>デイン</div> <div class='meaning'>Deen</div> 
<div class='jp'>デモンズクラッシュ</div>	<div class='jp'>デモンズクラッシュ</div> <div class='meaning'>Demon Rush (lit. 'Demon's Rush')</div> 
<div class='jp'>ダイヤ</div>	<div class='jp'>ダイヤ</div> <div class='meaning'>Diamond</div> 
<div class='jp'>ダイヤファイア</div>	<div class='jp'>ダイヤファイア</div> <div class='meaning'>Diamond Fire</div> 
<div class='jp'>ダイヤフラッシュ</div>	<div class='jp'>ダイヤフラッシュ</div> <div class='meaning'>Diamond Flash</div> 
<div class='jp'>タイブキック</div>	<div class='jp'>タイブキック</div> <div class='meaning'>Dive Kick</div> 
<div class='jp'>かわす</div>	<div class='jp'>かわす</div> <div class='meaning'>Dodge</div> 
<div class='jp'>ヒレパンチ</div>	<div class='jp'>ヒレパンチ</div> <div class='meaning'>Dorsal Punch (lit. 'Fin Punch')</div> 
<div class='jp'>ダブルブレス</div>	<div class='jp'>ダブルブレス</div> <div class='meaning'>Double Breath</div> 
<div class='jp'>タブルショット</div>	<div class='jp'>タブルショット</div> <div class='meaning'>Double Shot</div> 
<div class='jp'>怒龍砲</div>	<div class='jp'><ruby><rb>怒</rb><rt>ど</rt></ruby><ruby><rb>龍</rb><rt>りゅう</rt></ruby><ruby><rb>砲</rb><rt>ほう</rt></ruby></div> <div class='meaning'>Dragon Cannon (lit. 'Angry Dragon Cannon')</div>  <br/> <div class='stroke'>怒龍砲</div> 
<div class='jp'>龍宮の舞</div>	<div class='jp'><ruby><rb>龍</rb><rt>りゅう</rt></ruby><ruby><rb>宮</rb><rt>ぐう</rt></ruby>の<ruby><rb>舞</rb><rt>まい</rt></ruby></div> <div class='meaning'>Dragon Dance (lit. 'Dragon Shrine Dance')</div>  <br/> <div class='stroke'>龍宮舞</div> 
<div class='jp'>ドラゴンファング</div>	<div class='jp'>ドラゴンファング</div> <div class='meaning'>Dragon Fang</div> 
<div class='jp'>ドレイン</div>	<div class='jp'>ドレイン</div> <div class='meaning'>Drain</div> 
<div class='jp'>ドリフトターン</div>	<div class='jp'>ドリフトターン</div> <div class='meaning'>Drift Turn</div> 
<div class='jp'>ドリルドライブ</div>	<div class='jp'>ドリルドライブ</div> <div class='meaning'>Drilldrive (lit. 'Drill Drive')</div> 
<div class='jp'>ツインアタック</div>	<div class='jp'>ツインアタック</div> <div class='meaning'>Dual Attack (lit. 'Twin Attack')</div> 
<div class='jp'>ダブルスパイク</div>	<div class='jp'>ダブルスパイク</div> <div class='meaning'>Dual Spike (lit. 'Double Spike')</div> 
<div class='jp'>両翼射撃</div>	<div class='jp'><ruby><rb>両翼</rb><rt>りょうよく</rt></ruby><ruby><rb>射撃</rb><rt>しゃげき</rt></ruby></div> <div class='meaning'>Dual Wing Fire (lit. 'Double Wing Fire')</div>  <br/> <div class='stroke'>両翼射撃</div> 
<div class='jp'>アースクエイク</div>	<div class='jp'>アースクエイク</div> <div class='meaning'>Earthquake</div> 
<div class='jp'>食べる</div>	<div class='jp'><ruby><rb>食</rb><rt>た</rt></ruby>べる</div> <div class='meaning'>Eat</div>  <br/> <div class='stroke'>食</div> 
<div class='jp'>放電</div>	<div class='jp'><ruby><rb>放電</rb><rt>ほうでん</rt></ruby></div> <div class='meaning'>Electric Burst (lit. 'Electric Discharge')</div>  <br/> <div class='stroke'>放電</div> 
<div class='jp'>電磁ロッド</div>	<div class='jp'><ruby><rb>電磁</rb><rt>でんじ</rt></ruby>ロッド</div> <div class='meaning'>Electro-Mag Rod (lit. 'Electromagnetic Rod')</div>  <br/> <div class='stroke'>電磁</div> 
<div class='jp'>磁場転換</div>	<div class='jp'><ruby><rb>磁場</rb><rt>じば</rt></ruby><ruby><rb>転換</rb><rt>てんかん</rt></ruby></div> <div class='meaning'>Electromag (lit. 'Reverse Polarity')</div>  <br/> <div class='stroke'>磁場転換</div> 
<div class='jp'>電気ロッド</div>	<div class='jp'><ruby><rb>電気</rb><rt>でんき</rt></ruby>ロッド</div> <div class='meaning'>Electroprod (lit. 'Electric Rod')</div>  <br/> <div class='stroke'>電気</div> 
<div class='jp'>電気ロッド・マーク２</div>	<div class='jp'><ruby><rb>電気</rb><rt>でんき</rt></ruby>ロッド・マーク２</div> <div class='meaning'>Electroprod 2 (lit. 'Electric Rod Mark 2')</div>  <br/> <div class='stroke'>電気</div> 
<div class='jp'>エメラルドビーム</div>	<div class='jp'>エメラルドビーム</div> <div class='meaning'>Emerald Beam</div> 
<div class='jp'>エメラルドレーザー</div>	<div class='jp'>エメラルドレーザー</div> <div class='meaning'>Emerald Laser</div> 
<div class='jp'>エメラルドシュート</div>	<div class='jp'>エメラルドシュート</div> <div class='meaning'>Emerald Shoot</div> 
<div class='jp'>教皇</div>	<div class='jp'><ruby><rb>教皇</rb><rt>きょうこう</rt></ruby></div> <div class='meaning'>Emperor (lit. 'The Hierophant')</div>  <br/> <div class='stroke'>教皇</div> 
<div class='jp'>エナジーボール</div>	<div class='jp'>エナジーボール</div> <div class='meaning'>Energy Ball</div> 
<div class='jp'>エネルギー吸収</div>	<div class='jp'>エネルギー<ruby><rb>吸収</rb><rt>きゅうしゅう</rt></ruby></div> <div class='meaning'>Energy Siphon (lit. 'Energy Absorb')</div>  <br/> <div class='stroke'>吸収</div> 
<div class='jp'>射出</div>	<div class='jp'><ruby><rb>射出</rb><rt>しゃしゅつ</rt></ruby></div> <div class='meaning'>Erupt (lit. 'Emit')</div>  <br/> <div class='stroke'>射出</div> 
<div class='jp'>噴火</div>	<div class='jp'><ruby><rb>噴火</rb><rt>ふんか</rt></ruby></div> <div class='meaning'>Eruption</div>  <br/> <div class='stroke'>噴火</div> 
<div class='jp'>ずらかる</div>	<div class='jp'>ずらかる</div> <div class='meaning'>Escape</div> 
<div class='jp'>みんなのうらみ</div>	<div class='jp'>みんなのうらみ</div> <div class='meaning'>Everyone's Grudge</div> 
<div class='jp'>イビルポイズン</div>	<div class='jp'>イビルポイズン</div> <div class='meaning'>Evil Poison</div> 
<div class='jp'>究極逆鱗ボンバー</div>	<div class='jp'><ruby><rb>究極</rb><rt>きゅうきょく</rt></ruby><ruby><rb>逆鱗</rb><rt>げきりん</rt></ruby>ボンバー</div> <div class='meaning'>Extreme Bomber (lit. 'Ultimate Wrath Bomber')</div>  <br/> <div class='stroke'>究極逆鱗</div> 
<div class='jp'>落石</div>	<div class='jp'><ruby><rb>落石</rb><rt>らくせき</rt></ruby></div> <div class='meaning'>Falling Rocks (lit. 'Falling Rock')</div>  <br/> <div class='stroke'>落石</div> 
<div class='jp'>キバ</div>	<div class='jp'>キバ</div> <div class='meaning'>Fang</div> 
<div class='jp'>魅惑</div>	<div class='jp'><ruby><rb>魅惑</rb><rt>みわく</rt></ruby></div> <div class='meaning'>Fascination (lit. 'Attraction')</div>  <br/> <div class='stroke'>魅惑</div> 
<div class='jp'>フィンガーショット</div>	<div class='jp'>フィンガーショット</div> <div class='meaning'>Finger Shot</div> 
<div class='jp'>ルーレットファイア</div>	<div class='jp'>ルーレットファイア</div> <div class='meaning'>Fire Roulette (lit. 'Roulette Fire')</div> 
<div class='jp'>火弾</div>	<div class='jp'><ruby><rb>火</rb><rt>ひ</rt></ruby><ruby><rb>弾</rb><rt>だん</rt></ruby></div> <div class='meaning'>Fire Shell (lit. 'Fire Bullet')</div>  <br/> <div class='stroke'>火弾</div> 
<div class='jp'>ファイアボール</div>	<div class='jp'>ファイアボール</div> <div class='meaning'>Fireball</div> 
<div class='jp'>一斉射撃</div>	<div class='jp'><ruby><rb>一斉射撃</rb><rt>いっせいしゃげき</rt></ruby></div> <div class='meaning'>Firing Line (lit. 'Line Fire')</div>  <br/> <div class='stroke'>一斉射撃</div> 
<div class='jp'>火炎</div>	<div class='jp'><ruby><rb>火炎</rb><rt>かえん</rt></ruby></div> <div class='meaning'>Flame (lit. 'Blaze')</div>  <br/> <div class='stroke'>火炎</div> 
<div class='jp'>炎の舞</div>	<div class='jp'><ruby><rb>炎</rb><rt>ほのお</rt></ruby>の<ruby><rb>舞</rb><rt>まい</rt></ruby></div> <div class='meaning'>Flame Dance</div>  <br/> <div class='stroke'>炎舞</div> 
<div class='jp'>百烈突き</div>	<div class='jp'><ruby><rb>百</rb><rt>ひゃく</rt></ruby><ruby><rb>烈</rb><rt>れつ</rt></ruby><ruby><rb>突</rb><rt>つ</rt></ruby>き</div> <div class='meaning'>Flaming Peck (lit. '100 Fierce Stabs')</div>  <br/> <div class='stroke'>百烈突</div> 
<div class='jp'>はばたき</div>	<div class='jp'>はばたき</div> <div class='meaning'>Flap</div> 
<div class='jp'>ふえでなぐる</div>	<div class='jp'>ふえでなぐる</div> <div class='meaning'>Flutilizer (lit. 'Flute Strike')</div> 
<div class='jp'>フライングドリル</div>	<div class='jp'>フライングドリル</div> <div class='meaning'>Flying Drill</div> 
<div class='jp'>空中ハンマー</div>	<div class='jp'><ruby><rb>空中</rb><rt>くうちゅう</rt></ruby>ハンマー</div> <div class='meaning'>Flying Hammer (lit. 'Aerial Hammer')</div>  <br/> <div class='stroke'>空中</div> 
<div class='jp'>空中混乱ハンマー</div>	<div class='jp'><ruby><rb>空中</rb><rt>くうちゅう</rt></ruby><ruby><rb>混乱</rb><rt>こんらん</rt></ruby>ハンマー</div> <div class='meaning'>Flying Muddle (lit. 'Aerial Confusion Hammer')</div>  <br/> <div class='stroke'>空中混乱</div> 
<div class='jp'>かまいたち</div>	<div class='jp'>かまいたち</div> <div class='meaning'>Flying Sickle (lit. 'Whirlwind Cut')</div> 
<div class='jp'>フライアッパー</div>	<div class='jp'>フライアッパー</div> <div class='meaning'>Flying Upper (lit. 'Fly Upper')</div> 
<div class='jp'>空中いきなりハンマー</div>	<div class='jp'><ruby><rb>空中</rb><rt>くうちゅう</rt></ruby>いきなりハンマー</div> <div class='meaning'>Flying Zip (lit. 'Aerial Sudden Hammer')</div>  <br/> <div class='stroke'>空中</div> 
<div class='jp'>空中いきなり混乱</div>	<div class='jp'><ruby><rb>空中</rb><rt>くうちゅう</rt></ruby>いきなり<ruby><rb>混乱</rb><rt>こんらん</rt></ruby></div> <div class='meaning'>Flying Zip Confu (lit. 'Aerial Sudden Confusion')</div>  <br/> <div class='stroke'>空中混乱</div> 
<div class='jp'>踏みつぶし</div>	<div class='jp'><ruby><rb>踏</rb><rt>ふ</rt></ruby>みつぶし</div> <div class='meaning'>Foot Stamp (lit. 'Trample')</div>  <br/> <div class='stroke'>踏</div> 
<div class='jp'>フォーレーザー</div>	<div class='jp'>フォーレーザー</div> <div class='meaning'>Four Laser</div> 
<div class='jp'>カエルパンチ</div>	<div class='jp'>カエルパンチ</div> <div class='meaning'>Frog Jab (lit. 'Frog Punch')</div> 
<div class='jp'>冷凍光線</div>	<div class='jp'><ruby><rb>冷凍</rb><rt>れいとう</rt></ruby><ruby><rb>光線</rb><rt>こうせん</rt></ruby></div> <div class='meaning'>Frozen Beam (lit. 'Freezing Beam')</div>  <br/> <div class='stroke'>冷凍光線</div> 
<div class='jp'>ファニーの息</div>	<div class='jp'>ファニーの<ruby><rb>息</rb><rt>いき</rt></ruby></div> <div class='meaning'>Funny Breath</div>  <br/> <div class='stroke'>息</div> 
<div class='jp'>いかり</div>	<div class='jp'>いかり</div> <div class='meaning'>Fury (lit. 'Anger')</div> 
<div class='jp'>ガス</div>	<div class='jp'>ガス</div> <div class='meaning'>Gas</div> 
<div class='jp'>切りきざみ</div>	<div class='jp'><ruby><rb>切</rb><rt>き</rt></ruby>りきざみ</div> <div class='meaning'>Gash (lit. 'Mincer')</div>  <br/> <div class='stroke'>切</div> 
<div class='jp'>ゲヘナガナー</div>	<div class='jp'>ゲヘナガナー</div> <div class='meaning'>Ghenghana (lit. 'Gehenna Ganar')</div> 
<div class='jp'>ちょうだい</div>	<div class='jp'>ちょうだい</div> <div class='meaning'>Gimme</div> 
<div class='jp'>グラスカッター</div>	<div class='jp'>グラスカッター</div> <div class='meaning'>Glasscutter (lit. 'Glass Cutter')</div> 
<div class='jp'>ご案内</div>	<div class='jp'>ご<ruby><rb>案内</rb><rt>あんない</rt></ruby></div> <div class='meaning'>Goannai (lit. 'Guidance')</div>  <br/> <div class='stroke'>案内</div> 
<div class='jp'>金山</div>	<div class='jp'><ruby><rb>金山</rb><rt>きんざん</rt></ruby></div> <div class='meaning'>Gold Mountain (lit. 'Gold Mine')</div>  <br/> <div class='stroke'>金山</div> 
<div class='jp'>ゴーレムレーザー</div>	<div class='jp'>ゴーレムレーザー</div> <div class='meaning'>Golem Laser</div> 
<div class='jp'>ゴーレムパンチ</div>	<div class='jp'>ゴーレムパンチ</div> <div class='meaning'>Golem Punch</div> 
<div class='jp'>グランドアタック</div>	<div class='jp'>グランドアタック</div> <div class='meaning'>Grand Attack</div> 
<div class='jp'>グランドパンチ</div>	<div class='jp'>グランドパンチ</div> <div class='meaning'>Grand Punch</div> 
<div class='jp'>地走り</div>	<div class='jp'><ruby><rb>地</rb><rt>じ</rt></ruby><ruby><rb>走</rb><rt>ばし</rt></ruby>り</div> <div class='meaning'>Grand Spark (lit. 'Ground Racer')</div>  <br/> <div class='stroke'>地走</div> 
<div class='jp'>グランドソード</div>	<div class='jp'>グランドソード</div> <div class='meaning'>Grand Sword</div> 
<div class='jp'>グラス突き</div>	<div class='jp'>グラス<ruby><rb>突</rb><rt>つ</rt></ruby>き</div> <div class='meaning'>Grass Punch (lit. 'Grass Thrust')</div>  <br/> <div class='stroke'>突</div> 
<div class='jp'>大旋風</div>	<div class='jp'><ruby><rb>大</rb><rt>だい</rt></ruby><ruby><rb>旋風</rb><rt>せんぷう</rt></ruby></div> <div class='meaning'>Great Gale (lit. 'Great Whirlwind')</div>  <br/> <div class='stroke'>大旋風</div> 
<div class='jp'>グリムロッド</div>	<div class='jp'>グリムロッド</div> <div class='meaning'>Grim Rod</div> 
<div class='jp'>スる</div>	<div class='jp'><ruby><rb>ス</rb><rt>す</rt></ruby>る</div> <div class='meaning'>Grind (lit. 'Pickpocket')</div> 
<div class='jp'>強化戦闘員死亡</div>	<div class='jp'><ruby><rb>強化</rb><rt>きょうか</rt></ruby><ruby><rb>戦闘員</rb><rt>せんとういん</rt></ruby><ruby><rb>死亡</rb><rt>しぼう</rt></ruby></div> <div class='meaning'>Grunt Death (lit. 'Strengthened Combatant Death')</div>  <br/> <div class='stroke'>強化戦闘員死亡</div> 
<div class='jp'>ギロチン</div>	<div class='jp'>ギロチン</div> <div class='meaning'>Guillotine</div> 
<div class='jp'>ギタービンタ</div>	<div class='jp'>ギタービンタ</div> <div class='meaning'>Guitar Slap</div> 
<div class='jp'>ホールトウィップ</div>	<div class='jp'>ホールトウィップ</div> <div class='meaning'>Halt Whip</div> 
<div class='jp'>ハンマーアタック</div>	<div class='jp'>ハンマーアタック</div> <div class='meaning'>Hammer Attack</div> 
<div class='jp'>ハンドクロウ</div>	<div class='jp'>ハンドクロウ</div> <div class='meaning'>Handclaw (lit. 'Hand Claw')</div> 
<div class='jp'>ハリアー</div>	<div class='jp'>ハリアー</div> <div class='meaning'>Harrier</div> 
<div class='jp'>ハリアービーム</div>	<div class='jp'>ハリアービーム</div> <div class='meaning'>Harrier Beam</div> 
<div class='jp'>モリ</div>	<div class='jp'>モリ</div> <div class='meaning'>Harpoon</div> 
<div class='jp'>ヘッドアタック</div>	<div class='jp'>ヘッドアタック</div> <div class='meaning'>Head Attack</div> 
<div class='jp'>首狩り</div>	<div class='jp'><ruby><rb>首狩</rb><rt>くびか</rt></ruby>り</div> <div class='meaning'>Head Hunting (lit. 'Headhunting')</div>  <br/> <div class='stroke'>首狩</div> 
<div class='jp'>大首狩り</div>	<div class='jp'><ruby><rb>大</rb><rt>だい</rt></ruby><ruby><rb>首狩</rb><rt>くびか</rt></ruby>り</div> <div class='meaning'>Head Hunting 2 (lit. 'Big Headhunting')</div>  <br/> <div class='stroke'>大首狩</div> 
<div class='jp'>ハート</div>	<div class='jp'>ハート</div> <div class='meaning'>Heart</div> 
<div class='jp'>こころない天使</div>	<div class='jp'>こころない<ruby><rb>天使</rb><rt>てんし</rt></ruby></div> <div class='meaning'>Heartless Angel</div>  <br/> <div class='stroke'>天使</div> 
<div class='jp'>ヒートウィング</div>	<div class='jp'>ヒートウィング</div> <div class='meaning'>Heatwing (lit. 'Heat Wing')</div> 
<div class='jp'>ヘビーソード</div>	<div class='jp'>ヘビーソード</div> <div class='meaning'>Heavy Sword</div> 
<div class='jp'>ヘルボンバー</div>	<div class='jp'>ヘルボンバー</div> <div class='meaning'>Hell Bomber</div> 
<div class='jp'>アワ地獄</div>	<div class='jp'>アワ<ruby><rb>地獄</rb><rt>じごく</rt></ruby></div> <div class='meaning'>Hell Bubbles (lit. 'Bubble Hell')</div>  <br/> <div class='stroke'>地獄</div> 
<div class='jp'>ヘルコンボ</div>	<div class='jp'>ヘルコンボ</div> <div class='meaning'>Hell Combo</div> 
<div class='jp'>ヘルプレス</div>	<div class='jp'>ヘルプレス</div> <div class='meaning'>Hell Press</div> 
<div class='jp'>地獄のヤリ</div>	<div class='jp'><ruby><rb>地獄</rb><rt>じごく</rt></ruby>のヤリ</div> <div class='meaning'>Hell Spear</div>  <br/> <div class='stroke'>地獄</div> 
<div class='jp'>副砲内隠し砲</div>	<div class='jp'><ruby><rb>副</rb><rt>ふく</rt></ruby><ruby><rb>砲</rb><rt>ほう</rt></ruby><ruby><rb>内隠</rb><rt>うちかく</rt></ruby>し<ruby><rb>砲</rb><rt>ほう</rt></ruby></div> <div class='meaning'>Hidden Artillery (lit. 'Cannon Hidden in the Auxiliary Cannon')</div>  <br/> <div class='stroke'>副砲内隠砲</div> 
<div class='jp'>隠者</div>	<div class='jp'><ruby><rb>隠者</rb><rt>いんじゃ</rt></ruby></div> <div class='meaning'>Hidden One (lit. 'The Hermit')</div>  <br/> <div class='stroke'>隠者</div> 
<div class='jp'>組曲ハイ＆ロウ</div>	<div class='jp'><ruby><rb>組曲</rb><rt>くみきょく</rt></ruby>ハイ＆ロウ</div> <div class='meaning'>High/Low Suit (lit. 'Musical Suite High & Low')</div>  <br/> <div class='stroke'>組曲</div> 
<div class='jp'>ハイウェイ登場</div>	<div class='jp'>ハイウェイ<ruby><rb>登場</rb><rt>とうじょう</rt></ruby></div> <div class='meaning'>Highway (lit. 'Highway Entry')</div>  <br/> <div class='stroke'>登場</div> 
<div class='jp'>なぐる</div>	<div class='jp'>なぐる</div> <div class='meaning'>Hit</div> 
<div class='jp'>かつあげ</div>	<div class='jp'>かつあげ</div> <div class='meaning'>Hold-up (lit. 'Shakedown')</div> 
<div class='jp'>角</div>	<div class='jp'><ruby><rb>角</rb><rt>つの</rt></ruby></div> <div class='meaning'>Horn</div>  <br/> <div class='stroke'>角</div> 
<div class='jp'>ホーンボンバー</div>	<div class='jp'>ホーンボンバー</div> <div class='meaning'>Horn Bomber</div> 
<div class='jp'>ホーンリフト</div>	<div class='jp'>ホーンリフト</div> <div class='meaning'>Horn Lift</div> 
<div class='jp'>温泉</div>	<div class='jp'><ruby><rb>温泉</rb><rt>おんせん</rt></ruby></div> <div class='meaning'>Hot Springs (lit. 'Hot Spring')</div>  <br/> <div class='stroke'>温泉</div> 
<div class='jp'>遠吠え</div>	<div class='jp'><ruby><rb>遠吠</rb><rt>とおぼ</rt></ruby>え</div> <div class='meaning'>Howling (lit. 'Howl')</div>  <br/> <div class='stroke'>遠吠</div> 
<div class='jp'>大津波</div>	<div class='jp'><ruby><rb>大津波</rb><rt>おおつなみ</rt></ruby></div> <div class='meaning'>Huge Tidal Wave (lit. 'Big Tsunami')</div>  <br/> <div class='stroke'>大津波</div> 
<div class='jp'>つららおとし</div>	<div class='jp'>つららおとし</div> <div class='meaning'>Icicle Drop</div> 
<div class='jp'>鉄撃震</div>	<div class='jp'><ruby><rb>鉄</rb><rt>てつ</rt></ruby><ruby><rb>撃震</rb><rt>げきしん</rt></ruby></div> <div class='meaning'>Iron Attack (lit. 'Iron Attack Quake')</div>  <br/> <div class='stroke'>鉄撃震</div> 
<div class='jp'>てっつい</div>	<div class='jp'>てっつい</div> <div class='meaning'>Iron Mallet (lit. 'Iron Hammer')</div> 
<div class='jp'>鉄球</div>	<div class='jp'><ruby><rb>鉄球</rb><rt>てっきゅう</rt></ruby></div> <div class='meaning'>Ironball (lit. 'Iron Ball')</div>  <br/> <div class='stroke'>鉄球</div> 
<div class='jp'>イソギンスモッグ</div>	<div class='jp'>イソギンスモッグ</div> <div class='meaning'>Isogin Smog (lit. 'Anemone Smog')</div> 
<div class='jp'>ジャンプアタック</div>	<div class='jp'>ジャンプアタック</div> <div class='meaning'>Jump Attack</div> 
<div class='jp'>ジャンプキック</div>	<div class='jp'>ジャンプキック</div> <div class='meaning'>Jump Kick</div> 
<div class='jp'>ジャンピングブロウ</div>	<div class='jp'>ジャンピングブロウ</div> <div class='meaning'>Jumping Blow</div> 
<div class='jp'>ジャンプ軟骨剣</div>	<div class='jp'>ジャンプ<ruby><rb>軟骨</rb><rt>なんこつ</rt></ruby><ruby><rb>剣</rb><rt>けん</rt></ruby></div> <div class='meaning'>Jumping Cutter (lit. 'Jumping Cartilage Sword')</div>  <br/> <div class='stroke'>軟骨剣</div> 
<div class='jp'>カギヅメ</div>	<div class='jp'>カギヅメ</div> <div class='meaning'>Keyclaw (lit. 'Talon')</div> 
<div class='jp'>キック</div>	<div class='jp'>キック</div> <div class='meaning'>Kick</div> 
<div class='jp'>キングテイル</div>	<div class='jp'>キングテイル</div> <div class='meaning'>King Teel (lit. 'King Tail')</div> 
<div class='jp'>ニーブレンド</div>	<div class='jp'>ニーブレンド</div> <div class='meaning'>Knee Blend</div> 
<div class='jp'>ニーファイア</div>	<div class='jp'>ニーファイア</div> <div class='meaning'>Knee Fire</div> 
<div class='jp'>ほうちょう</div>	<div class='jp'>ほうちょう</div> <div class='meaning'>Knife (lit. 'Kitchen Knife')</div> 
<div class='jp'>レベル２コンフュ</div>	<div class='jp'>レベル２コンフュ</div> <div class='meaning'>L2 Confu (lit. 'Level 2 Confu')</div> 
<div class='jp'>レベル３フレア</div>	<div class='jp'>レベル３フレア</div> <div class='meaning'>L3 Flare (lit. 'Level 3 Flare')</div> 
<div class='jp'>レベル４デス</div>	<div class='jp'>レベル４デス</div> <div class='meaning'>L4 Death (lit. 'Level 4 Death')</div> 
<div class='jp'>ラピスレーザー</div>	<div class='jp'>ラピスレーザー</div> <div class='meaning'>Lapis Laser</div> 
<div class='jp'>へばりつき</div>	<div class='jp'>へばりつき</div> <div class='meaning'>Lay Flat (lit. 'Cling')</div> 
<div class='jp'>レフトブレス</div>	<div class='jp'>レフトブレス</div> <div class='meaning'>Left Breath</div> 
<div class='jp'>ラストレフトブレス</div>	<div class='jp'>ラストレフトブレス</div> <div class='meaning'>Left Breath 2 (lit. 'Last Left Breath')</div> 
<div class='jp'>左手復活</div>	<div class='jp'><ruby><rb>左手</rb><rt>ひだりて</rt></ruby><ruby><rb>復活</rb><rt>ふっかつ</rt></ruby></div> <div class='meaning'>Left Hand Revived (lit. 'Left Hand Revival')</div>  <br/> <div class='stroke'>左手復活</div> 
<div class='jp'>怒りの触手</div>	<div class='jp'><ruby><rb>怒</rb><rt>いか</rt></ruby>りの<ruby><rb>触手</rb><rt>しょくしゅ</rt></ruby></div> <div class='meaning'>Left Thrust (lit. 'Angry Tentacle')</div>  <br/> <div class='stroke'>怒触手</div> 
<div class='jp'>なめる</div>	<div class='jp'>なめる</div> <div class='meaning'>Lick</div> 
<div class='jp'>光弾</div>	<div class='jp'><ruby><rb>光</rb><rt>こう</rt></ruby><ruby><rb>弾</rb><rt>だん</rt></ruby></div> <div class='meaning'>Light Shell (lit. 'Light Bullet')</div>  <br/> <div class='stroke'>光弾</div> 
<div class='jp'>雷撃</div>	<div class='jp'><ruby><rb>雷撃</rb><rt>らいげき</rt></ruby></div> <div class='meaning'>Lightning (lit. 'Thunder Strike')</div>  <br/> <div class='stroke'>雷撃</div> 
<div class='jp'>毒液</div>	<div class='jp'><ruby><rb>毒液</rb><rt>どくえき</rt></ruby></div> <div class='meaning'>Liquid poison (lit. 'Venom')</div>  <br/> <div class='stroke'>毒液</div> 
<div class='jp'>ロストブロー</div>	<div class='jp'>ロストブロー</div> <div class='meaning'>Lost Blow</div> 
<div class='jp'>クレージーアタック</div>	<div class='jp'>クレージーアタック</div> <div class='meaning'>Lunattack (lit. 'Crazy Attack')</div> 
<div class='jp'>魔吸軟骨剣</div>	<div class='jp'><ruby><rb>魔吸</rb><rt>まきゅう</rt></ruby><ruby><rb>軟骨</rb><rt>なんこつ</rt></ruby><ruby><rb>剣</rb><rt>けん</rt></ruby></div> <div class='meaning'>Magic Cutter (lit. 'Magic-Absorbing Cartilage Sword')</div>  <br/> <div class='stroke'>魔吸軟骨剣</div> 
<div class='jp'>魔法消滅</div>	<div class='jp'><ruby><rb>魔法</rb><rt>まほう</rt></ruby><ruby><rb>消滅</rb><rt>しょうめつ</rt></ruby></div> <div class='meaning'>Magic Extinguish (lit. 'Magic Annihilation')</div>  <br/> <div class='stroke'>魔法消滅</div> 
<div class='jp'>マグマ</div>	<div class='jp'>マグマ</div> <div class='meaning'>Magma</div> 
<div class='jp'>主砲</div>	<div class='jp'><ruby><rb>主砲</rb><rt>しゅほう</rt></ruby></div> <div class='meaning'>Main Artillery (lit. 'Main Cannon')</div>  <br/> <div class='stroke'>主砲</div> 
<div class='jp'>魔晄銃</div>	<div class='jp'><ruby><rb>魔</rb><rt>ま</rt></ruby><ruby><rb>晄</rb><rt>こう</rt></ruby><ruby><rb>銃</rb><rt>じゅう</rt></ruby></div> <div class='meaning'>Mako Gun</div>  <br/> <div class='stroke'>魔晄銃</div> 
<div class='jp'>マテリアジヤマー</div>	<div class='jp'>マテリアジヤマー</div> <div class='meaning'>Materia-jammer (lit. 'Materia Jammer')</div> 
<div class='jp'>メガトンパンチ</div>	<div class='jp'>メガトンパンチ</div> <div class='meaning'>Megaton Punch</div> 
<div class='jp'>モロトフカクテル</div>	<div class='jp'>モロトフカクテル</div> <div class='meaning'>Molotov Cocktail</div> 
<div class='jp'>モノアイレーザー</div>	<div class='jp'>モノアイレーザー</div> <div class='meaning'>Mono Laser (lit. 'Monoeye Laser')</div> 
<div class='jp'>ムーンストライク</div>	<div class='jp'>ムーンストライク</div> <div class='meaning'>Moonstrike (lit. 'Moon Strike')</div> 
<div class='jp'>ムーンワース</div>	<div class='jp'>ムーンワース</div> <div class='meaning'>Moon Wars</div> 
<div class='jp'>強奪</div>	<div class='jp'><ruby><rb>強奪</rb><rt>ごうだつ</rt></ruby></div> <div class='meaning'>Mug (lit. 'Pillage')</div>  <br/> <div class='stroke'>強奪</div> 
<div class='jp'>コンフュハンマー</div>	<div class='jp'>コンフュハンマー</div> <div class='meaning'>Muyddle Mallet (lit. 'Confu Hammer')</div> 
<div class='jp'>キック？？？？</div>	<div class='jp'>キック？？？？</div> <div class='meaning'>Mystery Kick (lit. 'Kick????')</div> 
<div class='jp'>ナパーム弾</div>	<div class='jp'><ruby><rb>ナパーム弾</rb><rt>なぱーむだん</rt></ruby></div> <div class='meaning'>Napalm Bomb</div>  <br/> <div class='stroke'>弾</div> 
<div class='jp'>針</div>	<div class='jp'><ruby><rb>針</rb><rt>はり</rt></ruby></div> <div class='meaning'>Needle</div>  <br/> <div class='stroke'>針</div> 
<div class='jp'>ニードルガン</div>	<div class='jp'>ニードルガン</div> <div class='meaning'>Needle Gun</div> 
<div class='jp'>ネオタークス光線</div>	<div class='jp'>ネオタークス<ruby><rb>光線</rb><rt>こうせん</rt></ruby></div> <div class='meaning'>Neo Turk Light (lit. 'Neo Turks Beam')</div>  <br/> <div class='stroke'>光線</div> 
<div class='jp'>通常弾</div>	<div class='jp'><ruby><rb>通常</rb><rt>つうじょう</rt></ruby><ruby><rb>弾</rb><rt>だん</rt></ruby></div> <div class='meaning'>Normal Shell</div>  <br/> <div class='stroke'>通常弾</div> 
<div class='jp'>ノーザンクロス</div>	<div class='jp'>ノーザンクロス</div> <div class='meaning'>Northern Cross</div> 
<div class='jp'>オイル</div>	<div class='jp'>オイル</div> <div class='meaning'>Oil</div> 
<div class='jp'>ペイルホース</div>	<div class='jp'>ペイルホース</div> <div class='meaning'>Pale Horse</div> 
<div class='jp'>パラテイル</div>	<div class='jp'>パラテイル</div> <div class='meaning'>Para Tail</div> 
<div class='jp'>マヒレーザー</div>	<div class='jp'>マヒレーザー</div> <div class='meaning'>Paralaser (lit. 'Paralyzing Laser')</div> 
<div class='jp'>マヒ針</div>	<div class='jp'>マヒ<ruby><rb>針</rb><rt>はり</rt></ruby></div> <div class='meaning'>Paralyzer Needle (lit. 'Paralyzing Needle')</div>  <br/> <div class='stroke'>針</div> 
<div class='jp'>くじゃく</div>	<div class='jp'>くじゃく</div> <div class='meaning'>Peacock</div> 
<div class='jp'>石化アイ</div>	<div class='jp'><ruby><rb>石</rb><rt>せき</rt></ruby><ruby><rb>化</rb><rt>か</rt></ruby>アイ</div> <div class='meaning'>Petrif-Eye (lit. 'Petrifying Eye')</div>  <br/> <div class='stroke'>石化</div> 
<div class='jp'>カエル石化</div>	<div class='jp'>カエル<ruby><rb>石</rb><rt>せき</rt></ruby><ruby><rb>化</rb><rt>か</rt></ruby></div> <div class='meaning'>Petrified Frog (lit. 'Frog Petrification')</div>  <br/> <div class='stroke'>石化</div> 
<div class='jp'>石化スモッグ</div>	<div class='jp'><ruby><rb>石</rb><rt>せき</rt></ruby><ruby><rb>化</rb><rt>か</rt></ruby>スモッグ</div> <div class='meaning'>Petrify Smog (lit. 'Petrifying Smog')</div>  <br/> <div class='stroke'>石化</div> 
<div class='jp'>プアゾシャワー</div>	<div class='jp'>プアゾシャワー</div> <div class='meaning'>Piazzo Shower (lit. 'Poisso Shower')</div> 
<div class='jp'>毒吹き</div>	<div class='jp'><ruby><rb>毒</rb><rt>どく</rt></ruby><ruby><rb>吹</rb><rt>ふ</rt></ruby>き</div> <div class='meaning'>Poison Blow (lit. 'Blow Poison')</div>  <br/> <div class='stroke'>毒吹</div> 
<div class='jp'>毒ブレス</div>	<div class='jp'><ruby><rb>毒</rb><rt>どく</rt></ruby>ブレス</div> <div class='meaning'>Poison Breath</div>  <br/> <div class='stroke'>毒</div> 
<div class='jp'>毒のキバ</div>	<div class='jp'><ruby><rb>毒</rb><rt>どく</rt></ruby>のキバ</div> <div class='meaning'>Poison Fang (lit. 'Poisonous Fang')</div>  <br/> <div class='stroke'>毒</div> 
<div class='jp'>ポイズンストーム</div>	<div class='jp'>ポイズンストーム</div> <div class='meaning'>Poison Storm</div> 
<div class='jp'>花粉</div>	<div class='jp'><ruby><rb>花粉</rb><rt>かふん</rt></ruby></div> <div class='meaning'>Pollen</div>  <br/> <div class='stroke'>花粉</div> 
<div class='jp'>プロペラ</div>	<div class='jp'>プロペラ</div> <div class='meaning'>Propeller (lit. 'Propellor')</div> 
<div class='jp'>プロペラソード</div>	<div class='jp'>プロペラソード</div> <div class='meaning'>Propeller Sword (lit. 'Propellor Sword')</div> 
<div class='jp'>パンチ</div>	<div class='jp'>パンチ</div> <div class='meaning'>Punch</div> 
<div class='jp'>乱れうち</div>	<div class='jp'><ruby><rb>乱</rb><rt>みだ</rt></ruby>れうち</div> <div class='meaning'>Quadra-cut (lit. 'Chaotic Strike')</div>  <br/> <div class='stroke'>乱</div> 
<div class='jp'>乱れ突き</div>	<div class='jp'><ruby><rb>乱</rb><rt>みだ</rt></ruby>れ<ruby><rb>突</rb><rt>つ</rt></ruby>き</div> <div class='meaning'>Rabbit Gouge (lit. 'Chaotic Thrust')</div>  <br/> <div class='stroke'>乱突</div> 
<div class='jp'>怒髪天ボンバー</div>	<div class='jp'><ruby><rb>怒髪天</rb><rt>どはつてん</rt></ruby>ボンバー</div> <div class='meaning'>Rage Bomber</div>  <br/> <div class='stroke'>怒髪天</div> 
<div class='jp'>復活魔法</div>	<div class='jp'><ruby><rb>復活</rb><rt>ふっかつ</rt></ruby><ruby><rb>魔法</rb><rt>まほう</rt></ruby></div> <div class='meaning'>Reanimagic (lit. 'Revival Magic')</div>  <br/> <div class='stroke'>復活魔法</div> 
<div class='jp'>後方マシンガン</div>	<div class='jp'><ruby><rb>後方</rb><rt>こうほう</rt></ruby>マシンガン</div> <div class='meaning'>Rear Gun (lit. 'Rear Machine Gun')</div>  <br/> <div class='stroke'>後方</div> 
<div class='jp'>レッドドラゴンブレス</div>	<div class='jp'>レッドドラゴンブレス</div> <div class='meaning'>Red Dragon Breath</div> 
<div class='jp'>赤い光</div>	<div class='jp'><ruby><rb>赤</rb><rt>あか</rt></ruby>い<ruby><rb>光</rb><rt>ひかり</rt></ruby></div> <div class='meaning'>Red Light</div>  <br/> <div class='stroke'>赤光</div> 
<div class='jp'>廃棄汚染</div>	<div class='jp'><ruby><rb>廃棄</rb><rt>はいき</rt></ruby><ruby><rb>汚染</rb><rt>おせん</rt></ruby></div> <div class='meaning'>Refuse (lit. 'Waste Disposal')</div>  <br/> <div class='stroke'>廃棄汚染</div> 
<div class='jp'>往復ビンタ</div>	<div class='jp'><ruby><rb>往復ビンタ</rb><rt>おうふくびんた</rt></ruby></div> <div class='meaning'>Repeating Slap (lit. 'Round-Trip Slap')</div>  <br/> <div class='stroke'>往復</div> 
<div class='jp'>反撃踏みつけ</div>	<div class='jp'><ruby><rb>反撃</rb><rt>はんげき</rt></ruby><ruby><rb>踏</rb><rt>ふ</rt></ruby>みつけ</div> <div class='meaning'>Revenge Stamp (lit. 'Counter Stomp')</div>  <br/> <div class='stroke'>反撃踏</div> 
<div class='jp'>ライダーブレス</div>	<div class='jp'>ライダーブレス</div> <div class='meaning'>Rider Breath</div> 
<div class='jp'>銃撃</div>	<div class='jp'><ruby><rb>銃撃</rb><rt>じゅうげき</rt></ruby></div> <div class='meaning'>Rifle (lit. 'Gun Attack')</div>  <br/> <div class='stroke'>銃撃</div> 
<div class='jp'>ライトブレス</div>	<div class='jp'>ライトブレス</div> <div class='meaning'>Right Breath</div> 
<div class='jp'>ラストライトブレス</div>	<div class='jp'>ラストライトブレス</div> <div class='meaning'>Right Breath 2 (lit. 'Last Right Breath')</div> 
<div class='jp'>右手復活</div>	<div class='jp'><ruby><rb>右手</rb><rt>みぎて</rt></ruby><ruby><rb>復活</rb><rt>ふっかつ</rt></ruby></div> <div class='meaning'>Right Hand Revived (lit. 'Right Hand Revival')</div>  <br/> <div class='stroke'>右手復活</div> 
<div class='jp'>ライジングダガー</div>	<div class='jp'>ライジングダガー</div> <div class='meaning'>Rising Dagger</div> 
<div class='jp'>石化指</div>	<div class='jp'><ruby><rb>石</rb><rt>せき</rt></ruby><ruby><rb>化</rb><rt>か</rt></ruby><ruby><rb>指</rb><rt>ゆび</rt></ruby></div> <div class='meaning'>Rock Finger (lit. 'Petrifying Finger')</div>  <br/> <div class='stroke'>石化指</div> 
<div class='jp'>投石</div>	<div class='jp'><ruby><rb>投石</rb><rt>とうせき</rt></ruby></div> <div class='meaning'>Rock Toss (lit. 'Throw Stone')</div>  <br/> <div class='stroke'>投石</div> 
<div class='jp'>石つぶて</div>	<div class='jp'><ruby><rb>石</rb><rt>いし</rt></ruby>つぶて</div> <div class='meaning'>Rockbreaker (lit. 'Stoning')</div>  <br/> <div class='stroke'>石</div> 
<div class='jp'>ロケットランチャー</div>	<div class='jp'>ロケットランチャー</div> <div class='meaning'>Rocket Launcher</div> 
<div class='jp'>ロッド</div>	<div class='jp'>ロッド</div> <div class='meaning'>Rod</div> 
<div class='jp'>ローラーダッシュ</div>	<div class='jp'>ローラーダッシュ</div> <div class='meaning'>Roller Dash</div> 
<div class='jp'>ローラースピン</div>	<div class='jp'>ローラースピン</div> <div class='meaning'>Rollerspin (lit. 'Roller Spin')</div> 
<div class='jp'>回転アタック</div>	<div class='jp'><ruby><rb>回転</rb><rt>かいてん</rt></ruby>アタック</div> <div class='meaning'>Rolling Attack (lit. 'Rotation Attack')</div>  <br/> <div class='stroke'>回転</div> 
<div class='jp'>ローリングクロウ</div>	<div class='jp'>ローリングクロウ</div> <div class='meaning'>Rolling Claw</div> 
<div class='jp'>ローリングファイア</div>	<div class='jp'>ローリングファイア</div> <div class='meaning'>Rolling Fire</div> 
<div class='jp'>ルビーの火炎</div>	<div class='jp'>ルビーの<ruby><rb>火炎</rb><rt>かえん</rt></ruby></div> <div class='meaning'>Ruby Flame (lit. 'Ruby Blaze')</div>  <br/> <div class='stroke'>火炎</div> 
<div class='jp'>ルビーレイ</div>	<div class='jp'>ルビーレイ</div> <div class='meaning'>Ruby Ray</div> 
<div class='jp'>サドインアタック</div>	<div class='jp'>サドインアタック</div> <div class='meaning'>Sadistic Attack (lit. 'Sadistic Yin Attack')</div> 
<div class='jp'>砂鉄砲</div>	<div class='jp'><ruby><rb>砂</rb><rt>すな</rt></ruby><ruby><rb>鉄砲</rb><rt>でっぽう</rt></ruby></div> <div class='meaning'>Sandgun (lit. 'Sand Gun')</div>  <br/> <div class='stroke'>砂鉄砲</div> 
<div class='jp'>サンドストーム</div>	<div class='jp'>サンドストーム</div> <div class='meaning'>Sandstorm</div> 
<div class='jp'>ノコギリ</div>	<div class='jp'>ノコギリ</div> <div class='meaning'>Sawback (lit. 'Saw')</div> 
<div class='jp'>シザーの一撃</div>	<div class='jp'>シザーの<ruby><rb>一撃</rb><rt>いちげき</rt></ruby></div> <div class='meaning'>Scissor Attack</div>  <br/> <div class='stroke'>一撃</div> 
<div class='jp'>シザーキック</div>	<div class='jp'>シザーキック</div> <div class='meaning'>Scissor Kick</div> 
<div class='jp'>ハサミスパーク</div>	<div class='jp'>ハサミスパーク</div> <div class='meaning'>Scissor Spark (lit. 'Pincer Spark')</div> 
<div class='jp'>シザートルネード</div>	<div class='jp'>シザートルネード</div> <div class='meaning'>Scissor Tornado</div> 
<div class='jp'>ハサミ</div>	<div class='jp'>ハサミ</div> <div class='meaning'>Scissors (lit. 'Pincer')</div> 
<div class='jp'>スコーピオンアタック</div>	<div class='jp'>スコーピオンアタック</div> <div class='meaning'>Scorpion Attack</div> 
<div class='jp'>スコーピオンテイル</div>	<div class='jp'>スコーピオンテイル</div> <div class='meaning'>Scorpion Tail</div> 
<div class='jp'>サソリの尾</div>	<div class='jp'>サソリの<ruby><rb>尾</rb><rt>お</rt></ruby></div> <div class='meaning'>Scorpion's Tail</div>  <br/> <div class='stroke'>尾</div> 
<div class='jp'>引っかく</div>	<div class='jp'><ruby><rb>引</rb><rt>ひ</rt></ruby>っかく</div> <div class='meaning'>Scratch</div>  <br/> <div class='stroke'>引</div> 
<div class='jp'>サーチスコープ</div>	<div class='jp'>サーチスコープ</div> <div class='meaning'>Search Scope</div> 
<div class='jp'>シード弾</div>	<div class='jp'>シード<ruby><rb>弾</rb><rt>だん</rt></ruby></div> <div class='meaning'>Seed Bullet</div>  <br/> <div class='stroke'>弾</div> 
<div class='jp'>シードシューティング</div>	<div class='jp'>シードシューティング</div> <div class='meaning'>Seed Shot (lit. 'Seed Shooting')</div> 
<div class='jp'>自爆</div>	<div class='jp'><ruby><rb>自爆</rb><rt>じばく</rt></ruby></div> <div class='meaning'>Self-destruct (lit. 'Self-Destruct')</div>  <br/> <div class='stroke'>自爆</div> 
<div class='jp'>セフィロスショック</div>	<div class='jp'>セフィロスショック</div> <div class='meaning'>Sephiroth Shock</div> 
<div class='jp'>地下水</div>	<div class='jp'><ruby><rb>地下水</rb><rt>ちかすい</rt></ruby></div> <div class='meaning'>Sewer (lit. 'Groundwater')</div>  <br/> <div class='stroke'>地下水</div> 
<div class='jp'>下水津波</div>	<div class='jp'><ruby><rb>下水</rb><rt>げすい</rt></ruby><ruby><rb>津波</rb><rt>つなみ</rt></ruby></div> <div class='meaning'>Sewer Tsunami (lit. 'Sewage Tsunami')</div>  <br/> <div class='stroke'>下水津波</div> 
<div class='jp'>怪しい息</div>	<div class='jp'><ruby><rb>怪</rb><rt>あや</rt></ruby>しい<ruby><rb>息</rb><rt>いき</rt></ruby></div> <div class='meaning'>Shady Breath (lit. 'Suspicious Breath')</div>  <br/> <div class='stroke'>怪息</div> 
<div class='jp'>シャムシール</div>	<div class='jp'>シャムシール</div> <div class='meaning'>Sham Seal (lit. 'Shamshir')</div> 
<div class='jp'>こうらぼうぎょ</div>	<div class='jp'>こうらぼうぎょ</div> <div class='meaning'>Shell Defense</div> 
<div class='jp'>シールド防御</div>	<div class='jp'>シールド<ruby><rb>防御</rb><rt>ぼうぎょ</rt></ruby></div> <div class='meaning'>Shield Defense</div>  <br/> <div class='stroke'>防御</div> 
<div class='jp'>シールド投げ</div>	<div class='jp'>シールド<ruby><rb>投</rb><rt>な</rt></ruby>げ</div> <div class='meaning'>Shield Throw</div>  <br/> <div class='stroke'>投</div> 
<div class='jp'>ハンドロッド</div>	<div class='jp'>ハンドロッド</div> <div class='meaning'>Short Staff (lit. 'Hand Rod')</div> 
<div class='jp'>ショットガン</div>	<div class='jp'>ショットガン</div> <div class='meaning'>Shotgun</div> 
<div class='jp'>ショルダーアタック</div>	<div class='jp'>ショルダーアタック</div> <div class='meaning'>Shoulder Attack</div> 
<div class='jp'>シャワー</div>	<div class='jp'>シャワー</div> <div class='meaning'>Shower</div> 
<div class='jp'>カマ</div>	<div class='jp'>カマ</div> <div class='meaning'>Sickle</div> 
<div class='jp'>糸</div>	<div class='jp'><ruby><rb>糸</rb><rt>いと</rt></ruby></div> <div class='meaning'>Silk (lit. 'Thread')</div>  <br/> <div class='stroke'>糸</div> 
<div class='jp'>シルバーホイール</div>	<div class='jp'>シルバーホイール</div> <div class='meaning'>Silver Wheel</div> 
<div class='jp'>片翼射撃</div>	<div class='jp'><ruby><rb>片翼</rb><rt>かたよく</rt></ruby><ruby><rb>射撃</rb><rt>しゃげき</rt></ruby></div> <div class='meaning'>Single Wing Fire</div>  <br/> <div class='stroke'>片翼射撃</div> 
<div class='jp'>かんぼつ</div>	<div class='jp'>かんぼつ</div> <div class='meaning'>Sinking (lit. 'Subsidence')</div> 
<div class='jp'>スケーティング</div>	<div class='jp'>スケーティング</div> <div class='meaning'>Skating</div> 
<div class='jp'>くしざし</div>	<div class='jp'>くしざし</div> <div class='meaning'>Skewer</div> 
<div class='jp'>ビンタ</div>	<div class='jp'>ビンタ</div> <div class='meaning'>Slap</div> 
<div class='jp'>眠り鱗粉</div>	<div class='jp'><ruby><rb>眠</rb><rt>ねむ</rt></ruby>り<ruby><rb>鱗粉</rb><rt>りんぷん</rt></ruby></div> <div class='meaning'>Sleep Scales</div>  <br/> <div class='stroke'>眠鱗粉</div> 
<div class='jp'>スロウダンス</div>	<div class='jp'>スロウダンス</div> <div class='meaning'>Slow Dance</div> 
<div class='jp'>有害スモッグ</div>	<div class='jp'><ruby><rb>有害</rb><rt>ゆうがい</rt></ruby>スモッグ</div> <div class='meaning'>Smog (lit. 'Harmful Smog')</div>  <br/> <div class='stroke'>有害</div> 
<div class='jp'>超有害スモッグ</div>	<div class='jp'><ruby><rb>超</rb><rt>ちょう</rt></ruby><ruby><rb>有害</rb><rt>ゆうがい</rt></ruby>スモッグ</div> <div class='meaning'>Smog Alert (lit. 'Super Harmful Smog')</div>  <br/> <div class='stroke'>超有害</div> 
<div class='jp'>スモーク弾</div>	<div class='jp'>スモーク<ruby><rb>弾</rb><rt>だん</rt></ruby></div> <div class='meaning'>Smoke Bullet</div>  <br/> <div class='stroke'>弾</div> 
<div class='jp'>スモークショット</div>	<div class='jp'>スモークショット</div> <div class='meaning'>Smoke Shot</div> 
<div class='jp'>指弾</div>	<div class='jp'><ruby><rb>指弾</rb><rt>しだん</rt></ruby></div> <div class='meaning'>Snap (lit. 'Finger Bullet')</div>  <br/> <div class='stroke'>指弾</div> 
<div class='jp'>ふぶき</div>	<div class='jp'>ふぶき</div> <div class='meaning'>Snowstorm (lit. 'Blizzard')</div> 
<div class='jp'>ソニックアタック</div>	<div class='jp'>ソニックアタック</div> <div class='meaning'>Sonic Attack</div> 
<div class='jp'>サザンクロス</div>	<div class='jp'>サザンクロス</div> <div class='meaning'>Southern Cross</div> 
<div class='jp'>スペード</div>	<div class='jp'>スペード</div> <div class='meaning'>Spade</div> 
<div class='jp'>ヒステリックボイス</div>	<div class='jp'>ヒステリックボイス</div> <div class='meaning'>Spaz Voice (lit. 'Hysteric Voice')</div> 
<div class='jp'>ヤリ攻撃</div>	<div class='jp'>ヤリ<ruby><rb>攻撃</rb><rt>こうげき</rt></ruby></div> <div class='meaning'>Spear Attack</div>  <br/> <div class='stroke'>攻撃</div> 
<div class='jp'>ダッシュパンチ</div>	<div class='jp'>ダッシュパンチ</div> <div class='meaning'>Speed Punch (lit. 'Dash Punch')</div> 
<div class='jp'>スピードスラッシュ</div>	<div class='jp'>スピードスラッシュ</div> <div class='meaning'>Speed Slash</div> 
<div class='jp'>スパイダーアタック</div>	<div class='jp'>スパイダーアタック</div> <div class='meaning'>Spider Attack</div> 
<div class='jp'>針地獄</div>	<div class='jp'><ruby><rb>針</rb><rt>はり</rt></ruby><ruby><rb>地獄</rb><rt>じごく</rt></ruby></div> <div class='meaning'>Spiky Hell (lit. 'Needle Hell')</div>  <br/> <div class='stroke'>針地獄</div> 
<div class='jp'>スピンアタック</div>	<div class='jp'>スピンアタック</div> <div class='meaning'>Spin Attack</div> 
<div class='jp'>盾回転</div>	<div class='jp'><ruby><rb>盾</rb><rt>たて</rt></ruby><ruby><rb>回転</rb><rt>かいてん</rt></ruby></div> <div class='meaning'>Spin Shield (lit. 'Shield Spin')</div>  <br/> <div class='stroke'>盾回転</div> 
<div class='jp'>スピニングターン</div>	<div class='jp'>スピニングターン</div> <div class='meaning'>Spin Turn (lit. 'Spinning Turn')</div> 
<div class='jp'>回転体当たり</div>	<div class='jp'><ruby><rb>回転体</rb><rt>かいてんたい</rt></ruby><ruby><rb>当</rb><rt>あ</rt></ruby>たり</div> <div class='meaning'>Spinning Bodyblow (lit. 'Rotation Body Blow')</div>  <br/> <div class='stroke'>回転体当</div> 
<div class='jp'>スピニングカード</div>	<div class='jp'>スピニングカード</div> <div class='meaning'>Spinning Card</div> 
<div class='jp'>回転斬り</div>	<div class='jp'><ruby><rb>回転</rb><rt>かいてん</rt></ruby><ruby><rb>斬</rb><rt>ぎ</rt></ruby>り</div> <div class='meaning'>Spinning Cut (lit. 'Rotation Slash')</div>  <br/> <div class='stroke'>回転斬</div> 
<div class='jp'>スピン</div>	<div class='jp'>スピン</div> <div class='meaning'>Spin</div> 
<div class='jp'>剣切り</div>	<div class='jp'><ruby><rb>剣</rb><rt>けん</rt></ruby><ruby><rb>切</rb><rt>ぎ</rt></ruby>り</div> <div class='meaning'>Split (lit. 'Sword Cutter')</div>  <br/> <div class='stroke'>剣切</div> 
<div class='jp'>踏みつぶす</div>	<div class='jp'><ruby><rb>踏</rb><rt>ふ</rt></ruby>みつぶす</div> <div class='meaning'>Squash (lit. 'Trample')</div>  <br/> <div class='stroke'>踏</div> 
<div class='jp'>セントエルモスファイアー</div>	<div class='jp'>セントエルモスファイアー</div> <div class='meaning'>St. Elmos Fire (lit. 'St. Elmo's Fire')</div> 
<div class='jp'>つきさす</div>	<div class='jp'>つきさす</div> <div class='meaning'>Stab</div> 
<div class='jp'>星</div>	<div class='jp'><ruby><rb>星</rb><rt>ほし</rt></ruby></div> <div class='meaning'>Star (lit. 'The Star')</div>  <br/> <div class='stroke'>星</div> 
<div class='jp'>スターダストマーチ</div>	<div class='jp'>スターダストマーチ</div> <div class='meaning'>Stardust March</div> 
<div class='jp'>にらみ</div>	<div class='jp'>にらみ</div> <div class='meaning'>Stare Down (lit. 'Glare')</div> 
<div class='jp'>スティグマ</div>	<div class='jp'>スティグマ</div> <div class='meaning'>Stigma</div> 
<div class='jp'>スティングボム</div>	<div class='jp'>スティングボム</div> <div class='meaning'>Sting Bomb</div> 
<div class='jp'>石化にらみ</div>	<div class='jp'><ruby><rb>石</rb><rt>いし</rt></ruby><ruby><rb>化</rb><rt>か</rt></ruby>にらみ</div> <div class='meaning'>Stone Stare (lit. 'Petrifying Glare')</div>  <br/> <div class='stroke'>石化</div> 
<div class='jp'>ストーンストライク</div>	<div class='jp'>ストーンストライク</div> <div class='meaning'>Stone Strike</div> 
<div class='jp'>ストップアイ</div>	<div class='jp'>ストップアイ</div> <div class='meaning'>Stop Eye</div> 
<div class='jp'>ストップウェブ</div>	<div class='jp'>ストップウェブ</div> <div class='meaning'>Stop Web</div> 
<div class='jp'>強力キック</div>	<div class='jp'><ruby><rb>強力</rb><rt>きょうりょく</rt></ruby>キック</div> <div class='meaning'>Strong Kick</div>  <br/> <div class='stroke'>強力</div> 
<div class='jp'>サブ主砲</div>	<div class='jp'>サブ<ruby><rb>主砲</rb><rt>しゅほう</rt></ruby></div> <div class='meaning'>Sub Artillery (lit. 'Sub Cannon')</div>  <br/> <div class='stroke'>主砲</div> 
<div class='jp'>ちっそくソング</div>	<div class='jp'>ちっそくソング</div> <div class='meaning'>Suffocation Song</div> 
<div class='jp'>自滅ドロップ</div>	<div class='jp'><ruby><rb>自滅</rb><rt>じめつ</rt></ruby>ドロップ</div> <div class='meaning'>Suicide Drop (lit. 'Suicidal Drop')</div>  <br/> <div class='stroke'>自滅</div> 
<div class='jp'>ヤン自爆</div>	<div class='jp'>ヤン<ruby><rb>自爆</rb><rt>じばく</rt></ruby></div> <div class='meaning'>Suicide Yang (lit. 'Yang Self-Destruct')</div>  <br/> <div class='stroke'>自爆</div> 
<div class='jp'>太陽</div>	<div class='jp'><ruby><rb>太陽</rb><rt>たいよう</rt></ruby></div> <div class='meaning'>Sun (lit. 'The Sun')</div>  <br/> <div class='stroke'>太陽</div> 
<div class='jp'>サンダイバー</div>	<div class='jp'>サンダイバー</div> <div class='meaning'>Sun Diver</div> 
<div class='jp'>スーパーノヴァ</div>	<div class='jp'>スーパーノヴァ</div> <div class='meaning'>Super Nova (lit. 'Supernova')</div> 
<div class='jp'>支援光線</div>	<div class='jp'><ruby><rb>支援</rb><rt>しえん</rt></ruby><ruby><rb>光線</rb><rt>こうせん</rt></ruby></div> <div class='meaning'>Support Beam</div>  <br/> <div class='stroke'>支援光線</div> 
<div class='jp'>スワンプシュート</div>	<div class='jp'>スワンプシュート</div> <div class='meaning'>Swamp Shoot</div> 
<div class='jp'>スイングアタック</div>	<div class='jp'>スイングアタック</div> <div class='meaning'>Swing Attack</div> 
<div class='jp'>剣攻撃</div>	<div class='jp'><ruby><rb>剣</rb><rt>けん</rt></ruby><ruby><rb>攻撃</rb><rt>こうげき</rt></ruby></div> <div class='meaning'>Sword Attack</div>  <br/> <div class='stroke'>剣攻撃</div> 
<div class='jp'>必殺剣</div>	<div class='jp'><ruby><rb>必殺</rb><rt>ひっさつ</rt></ruby><ruby><rb>剣</rb><rt>けん</rt></ruby></div> <div class='meaning'>Sword of Doom (lit. 'Deathblow Sword')</div>  <br/> <div class='stroke'>必殺剣</div> 
<div class='jp'>ソードラッシュ</div>	<div class='jp'>ソードラッシュ</div> <div class='meaning'>Sword Rush</div> 
<div class='jp'>ブレードソード</div>	<div class='jp'>ブレードソード</div> <div class='meaning'>Swordblade (lit. 'Blade Sword')</div> 
<div class='jp'>しっぽ</div>	<div class='jp'>しっぽ</div> <div class='meaning'>Tail</div> 
<div class='jp'>テイルアタック</div>	<div class='jp'>テイルアタック</div> <div class='meaning'>Tail Attack</div> 
<div class='jp'>テイルレーザー</div>	<div class='jp'>テイルレーザー</div> <div class='meaning'>Tail Laser</div> 
<div class='jp'>テイルビート</div>	<div class='jp'>テイルビート</div> <div class='meaning'>Tailbeat (lit. 'Tail Beat')</div> 
<div class='jp'>乗り移り</div>	<div class='jp'><ruby><rb>乗り移</rb><rt>のりうつ</rt></ruby>り</div> <div class='meaning'>Take Over (lit. 'Possess')</div>  <br/> <div class='stroke'>乗移</div> 
<div class='jp'>なみだ</div>	<div class='jp'>なみだ</div> <div class='meaning'>Teardrop (lit. 'Tear')</div> 
<div class='jp'>ドレイン触手</div>	<div class='jp'>ドレイン<ruby><rb>触手</rb><rt>しょくしゅ</rt></ruby></div> <div class='meaning'>Tentacle Drain (lit. 'Drain Tentacle')</div>  <br/> <div class='stroke'>触手</div> 
<div class='jp'>投げる</div>	<div class='jp'><ruby><rb>投</rb><rt>な</rt></ruby>げる</div> <div class='meaning'>Throw</div>  <br/> <div class='stroke'>投</div> 
<div class='jp'>サンダーキッス</div>	<div class='jp'>サンダーキッス</div> <div class='meaning'>Thunder Kiss</div> 
<div class='jp'>サンダーボール</div>	<div class='jp'>サンダーボール</div> <div class='meaning'>Thunderball (lit. 'Thunder Ball')</div> 
<div class='jp'>サンダーボルト</div>	<div class='jp'>サンダーボルト</div> <div class='meaning'>Thunderbolt</div> 
<div class='jp'>時間ダメージ</div>	<div class='jp'><ruby><rb>時間</rb><rt>じかん</rt></ruby>ダメージ</div> <div class='meaning'>Time Damage</div>  <br/> <div class='stroke'>時間</div> 
<div class='jp'>カエル</div>	<div class='jp'>カエル</div> <div class='meaning'>Toad (lit. 'Frog')</div> 
<div class='jp'>トンファー</div>	<div class='jp'>トンファー</div> <div class='meaning'>Tonfa</div> 
<div class='jp'>ベロ</div>	<div class='jp'>ベロ</div> <div class='meaning'>Tongue</div> 
<div class='jp'>トルネードウェイブ</div>	<div class='jp'>トルネードウェイブ</div> <div class='meaning'>Tornade Wave (lit. 'Tornado Wave')</div> 
<div class='jp'>毒吐き</div>	<div class='jp'><ruby><rb>毒</rb><rt>どく</rt></ruby><ruby><rb>吐</rb><rt>は</rt></ruby>き</div> <div class='meaning'>Toxic Barf (lit. 'Poison Vomit')</div>  <br/> <div class='stroke'>毒吐</div> 
<div class='jp'>毒粉</div>	<div class='jp'><ruby><rb>毒</rb><rt>どく</rt></ruby><ruby><rb>粉</rb><rt>ふん</rt></ruby></div> <div class='meaning'>Toxic Powder (lit. 'Poison Powder')</div>  <br/> <div class='stroke'>毒粉</div> 
<div class='jp'>激震</div>	<div class='jp'><ruby><rb>激震</rb><rt>げきしん</rt></ruby></div> <div class='meaning'>Tremor (lit. 'Severe Earthquake')</div>  <br/> <div class='stroke'>激震</div> 
<div class='jp'>トライアングルアタック</div>	<div class='jp'>トライアングルアタック</div> <div class='meaning'>Triangle Attack</div> 
<div class='jp'>サッドアイ</div>	<div class='jp'>サッドアイ</div> <div class='meaning'>Triclops (lit. 'Sad Eye')</div> 
<div class='jp'>トリプルアタック</div>	<div class='jp'>トリプルアタック</div> <div class='meaning'>Triple Attack</div> 
<div class='jp'>熱風</div>	<div class='jp'><ruby><rb>熱風</rb><rt>ねっぷう</rt></ruby></div> <div class='meaning'>Tropic Wind (lit. 'Hot Wind')</div>  <br/> <div class='stroke'>熱風</div> 
<div class='jp'>タークス光線</div>	<div class='jp'>タークス<ruby><rb>光線</rb><rt>こうせん</rt></ruby></div> <div class='meaning'>Turk Light (lit. 'Turks Beam')</div>  <br/> <div class='stroke'>光線</div> 
<div class='jp'>ツインバーナー</div>	<div class='jp'>ツインバーナー</div> <div class='meaning'>Twin Burner</div> 
<div class='jp'>アルテマビーム</div>	<div class='jp'>アルテマビーム</div> <div class='meaning'>Ultima Beam</div> 
<div class='jp'>超音波</div>	<div class='jp'><ruby><rb>超音波</rb><rt>ちょうおんぱ</rt></ruby></div> <div class='meaning'>Ultrasound (lit. 'Supersonic Wave')</div>  <br/> <div class='stroke'>超音波</div> 
<div class='jp'>ソードアッパー</div>	<div class='jp'>ソードアッパー</div> <div class='meaning'>Upper Cutter (lit. 'Sword Upper')</div> 
<div class='jp'>アッパーカット</div>	<div class='jp'>アッパーカット</div> <div class='meaning'>Uppercut</div> 
<div class='jp'>バキューム</div>	<div class='jp'>バキューム</div> <div class='meaning'>Vacuum</div> 
<div class='jp'>口先アタック</div>	<div class='jp'><ruby><rb>口先</rb><rt>くちさき</rt></ruby>アタック</div> <div class='meaning'>Verbal Attack (lit. 'Lip Attack')</div>  <br/> <div class='stroke'>口先</div> 
<div class='jp'>サーペントブレス</div>	<div class='jp'>サーペントブレス</div> <div class='meaning'>Viper Breath (lit. 'Serpent Breath')</div> 
<div class='jp'>ときのこえ</div>	<div class='jp'>ときのこえ</div> <div class='meaning'>Voice of Ages (lit. 'Voice of Time')</div> 
<div class='jp'>Ｗレーザー</div>	<div class='jp'><ruby><rb>Ｗ</rb><rt>だぶりゅー</rt></ruby>レーザー</div> <div class='meaning'>W-Laser (lit. 'Double Laser')</div> 
<div class='jp'>Ｗシールド投げ</div>	<div class='jp'><ruby><rb>Ｗ</rb><rt>だぶりゅー</rt></ruby>シールド<ruby><rb>投</rb><rt>な</rt></ruby>げ</div> <div class='meaning'>W-Shield Throw (lit. 'Double Shield Throw')</div>  <br/> <div class='stroke'>投</div> 
<div class='jp'>ダブルマシンガン</div>	<div class='jp'>ダブルマシンガン</div> <div class='meaning'>W Machine Gun (lit. 'Double Machine Gun')</div> 
<div class='jp'>Ｗロケットパンチ</div>	<div class='jp'><ruby><rb>Ｗ</rb><rt>だぶりゅー</rt></ruby>ロケットパンチ</div> <div class='meaning'>W Rocket Punch (lit. 'Double Rocket Punch')</div> 
<div class='jp'>雄叫び</div>	<div class='jp'><ruby><rb>雄叫</rb><rt>おたけ</rt></ruby>び</div> <div class='meaning'>War Cry</div>  <br/> <div class='stroke'>雄叫</div> 
<div class='jp'>水鉄砲</div>	<div class='jp'><ruby><rb>水鉄砲</rb><rt>みずでっぽう</rt></ruby></div> <div class='meaning'>Water Gun</div>  <br/> <div class='stroke'>水鉄砲</div> 
<div class='jp'>水波動</div>	<div class='jp'><ruby><rb>水</rb><rt>みず</rt></ruby><ruby><rb>波動</rb><rt>はどう</rt></ruby></div> <div class='meaning'>Water Wave (lit. 'Water Surge')</div>  <br/> <div class='stroke'>水波動</div> 
<div class='jp'>水攻め</div>	<div class='jp'><ruby><rb>水攻</rb><rt>みずぜ</rt></ruby>め</div> <div class='meaning'>Waterball (lit. 'Water Attack')</div>  <br/> <div class='stroke'>水攻</div> 
<div class='jp'>波動</div>	<div class='jp'><ruby><rb>波動</rb><rt>はどう</rt></ruby></div> <div class='meaning'>Wave (lit. 'Surge')</div>  <br/> <div class='stroke'>波動</div> 
<div class='jp'>波動砲</div>	<div class='jp'><ruby><rb>波動</rb><rt>はどう</rt></ruby><ruby><rb>砲</rb><rt>ほう</rt></ruby></div> <div class='meaning'>Wave Artillery (lit. 'Surge Cannon')</div>  <br/> <div class='stroke'>波動砲</div> 
<div class='jp'>ウィリー</div>	<div class='jp'>ウィリー</div> <div class='meaning'>Wheelie</div> 
<div class='jp'>ウイリーアタック</div>	<div class='jp'>ウイリーアタック</div> <div class='meaning'>Wheelie Attack</div> 
<div class='jp'>ムチ</div>	<div class='jp'>ムチ</div> <div class='meaning'>Whip</div> 
<div class='jp'>しびれムチ</div>	<div class='jp'>しびれムチ</div> <div class='meaning'>Whip Sting (lit. 'Numbing Whip')</div> 
<div class='jp'>アリ地獄</div>	<div class='jp'>アリ<ruby><rb>地獄</rb><rt>じごく</rt></ruby></div> <div class='meaning'>Whirlsand (lit. 'Antlion')</div>  <br/> <div class='stroke'>地獄</div> 
<div class='jp'>ワイドグレイサー</div>	<div class='jp'>ワイドグレイサー</div> <div class='meaning'>Wide Grazer</div> 
<div class='jp'>ウィングカッター</div>	<div class='jp'>ウィングカッター</div> <div class='meaning'>Wing Cut (lit. 'Wing Cutter')</div> 
<div class='jp'>ウイングカッター</div>	<div class='jp'>ウイングカッター</div> <div class='meaning'>Wing Cutter</div> 
<div class='jp'>ワイヤアタック</div>	<div class='jp'>ワイヤアタック</div> <div class='meaning'>Wire Attack</div> 
<div class='jp'>世界</div>	<div class='jp'><ruby><rb>世界</rb><rt>せかい</rt></ruby></div> <div class='meaning'>World (lit. 'The World')</div>  <br/> <div class='stroke'>世界</div> 
<div class='jp'>リストレーザー</div>	<div class='jp'>リストレーザー</div> <div class='meaning'>Wrist Laser</div> 
<div class='jp'>物理攻撃</div>	<div class='jp'><ruby><rb>物理</rb><rt>ぶつり</rt></ruby><ruby><rb>攻撃</rb><rt>こうげき</rt></ruby></div> <div class='meaning'>x (lit. 'Physical Attack')</div>  <br/> <div class='stroke'>物理攻撃</div> 
<div class='jp'>インパンチ</div>	<div class='jp'>インパンチ</div> <div class='meaning'>Ying Punch (lit. 'Yin Punch')</div> 
<div class='jp'>いきなり混乱</div>	<div class='jp'>いきなり<ruby><rb>混乱</rb><rt>こんらん</rt></ruby></div> <div class='meaning'>Zip Confu (lit. 'Sudden Confusion')</div>  <br/> <div class='stroke'>混乱</div> 
<div class='jp'>いきなりハンマー</div>	<div class='jp'>いきなりハンマー</div> <div class='meaning'>Zip Hammer (lit. 'Sudden Hammer')</div> 
