The hell are you? What're you doin' around here?	なんだお前は？こんなところで何をしている？
Where's AERIS?	AERITHはどこだ！
…	…………
AERIS? How did you know that name? You must be…	AERITH？その名を知っているとはお前まさか！？
AERIS, you mean that kid. The receptionist? I was startin' to worry about her, too.	AERITHってあのコだろ。受付の。じつはオレもあのコ気になってるんだよね
And so another rival appears on the scene, eh?	ウーン、はやくもライバル出現……
You mean, she's not? It's someone else?	え、そうじゃない？なんだ、人違いか
Oh, I see. So you must be that whatcha call it…	ハハーン……わかったぞ。さてはお前、アレだな？いまウワサの……
Shinra, Inc. Repair Division!!	神羅カンパニー修理課　！！
You know, this building looks like it's starting to fall apart.	いや～、このビルもそろそろあちこちにガタがきててなあ
This door was just pushed open. You ought to fix this right away.	この階のドア開きっぱなしなんだ。早く直してくれよな
Oh yeah, and take a look on the other floors, too.  Here, take this.	あ、そうそういちおう他の階も見回ってくれよ。これ、やるから
Received Key Item "Keycard 62"!	キーアイテム『カードキー６２』を手にいれた！
This door is stuck wide open. Better fix this right away.	この階のドア開きっぱなしなんだ。早く直してくれよな
This is the lounge floor. Above us are the special floors for the company big wigs.	ここはリフレッシュ・フロア。この上は、おえらがたがいる特別なフロアが多いからね
It's tough working under someone. It wears you out.	その下ではたらく我々もいろいろとつかれるんだよ。いろいろとね……
I thought I heard a ruckus downstairs a minute ago. Do you know what that was all about?	さっき下の方がさわがしかったけど何かあったのかしら？
No idea. But no need to worry because everything above the 60th floor is safe.	さあな。ま、６０階から上は何があっても安全だ。気にすることもないって
What's keeping her? Did she forget her keycard?	あいつ、遅いな……カードキー忘れたかな？
Even employees can't access floors above the 60th without a keycard.	社員といえど６０階から上はカードキーがないと自由に歩けないからな……
I don't remember seeing your face before… You new here?	あら、見かけない顔……新しく配属されたのね？
Say, you're cute. Let me teach you some…things.	いいわ、私がいろいろおしえてあげる♥
Things?	い、いろいろ？
Um, I'm kinda in a hurry…	急いでいるもので……
Oh? That's too bad…	あら、そう。ざんねんだわ……
Wipe that stupid look off your face. I was only going to teach you how to get to the next floor.	なーに、ヘンな顔して。教えてあげるのは、ここから上のフロアのことよ
The higher ups in the company use the floors above the 60th floor. But you can't get there without a keycard.	６０階から上は、役員クラスの社員の多い特別フロア。カードキーがないと入ることも許可されないの
Get a keycard and you can use the elevators freely.	カードキーがあれば階段もエレベーターも自由に使えるわ
…voila! Hear that sound and the door will open.	エレベーターはホラ、私の横にあるこのドアの前で【決定ボタン】　を押すの。そうすると……
Just remember there are different types of cards. One keycard alone won't let you go everywhere.	……っていう音がしてドアが開くから
For example, “'Keycard 60' only takes you to the 60th floor. 'Keycard 65' only takes you to the 65th floor.	でもね、カードキーにも何種類かあって、１枚でどこでも、ってわけにはいかないのよ
It's a security system worthy of Shinra. After all, they control everything in Midgar and in the world for that matter.	そうね、たとえば『カードキー６０』なら６０階まで。『カードキー６５』なら６５階まで。そういうことよ
Oh, I have to go. Gotta get back to work!	まあミッドガル、いえ、今や世界のエネルギー流通を一手にひきうける神羅カンパニーの本社としては、当然のセキュリティよね
Shinra Bldg. 62f.	あらやだ、長くなっちゃったわ。それじゃおたがい、お仕事がんばりましょうね♥}
Shinra, Inc.	Shinra Bldg. 62f.
Urban Dev. Research Library	神羅カンパニー
Shinra, Inc.	都市開発部門資料室
Space Dev. Research Library	神羅カンパニー
Shinra, Inc.	宇宙開発部門資料室
Peace Preservation/	神羅カンパニー
Weapon Dev. Research Library	治安維持部門・兵器開発部門資料室
Shinra, Inc.	神羅カンパニー
Scientific Research Library	科学部門資料室
Hart	ハット
How do you do?	あ、これはどうも
This is the Midgar Mayor's Office. Mayor Domino is in his office.	こちらはこのミッドガルの市長室でございます。この中にはドミノ市長がいらっしゃいます
I am the Deputy Mayor. If you should have any questions feel free to ask me…	ちなみにわたくしはミッドガルの助役です。困ったことがありましたらぜひわたくしに……
Domino	ドミノ
Hmm? Oh, and who might you be?	あ～？なんだねキミたちは？
You all must be those…ahem… Me? I'm Domino, the Mayor of Midgar.	ああ、キミらが例の……私？　私はこの魔晄都市ミッドガルの市長、ドミノだ
Actually, I'm Mayor in name only. The city and everything in it is really run by Shinra, Inc.	とは言っても名前だけ。ホントのところ、ミッドガルのすべては神羅のものだ
My only real job is watching over Shinra's documents…	今の私の仕事といったら神羅カンパニーの資料管理……
Me! The Mayor! A librarian! Ohh…	ミッドガルの市長が！神羅の資料を！ハア……
You want to get upstairs? I tell you what, if you can guess the password, I'll give you my keycard.	キミら、上へ行きたいんだろ？いいとも、私のカードキーをやろう。合言葉を言えたらな
Yes, that's it. Guess the password and I'll give you my keycard!	そう、合言葉だ。それを言えたら、カードをやろう
Get it on the first try and I'll even throw in a special item!	おまけに１回で当てたらナイスなおみやげもつけてやるぞ？
Domino	ドミノ
Got it?	合言葉がわかったのか？では言ってみたまえ
Then tell me.	合言葉は？
So, what's the password?	市長最高！！
BEST	神羅最低！！
KING	魔晄最高！！
ORBS	市長爆発！！
BOMB	魔晄爆発！！
MAKO	神羅爆発！！
HOJO	ちょっと待ってくれ
Wait a second	ドミノ
Domino	ぜんぜん違う！もっとすばらしい言葉だ！やり直し！
Nope! You're ALL wrong! It's a much better word than that! Try again!	ドミノ
[THIS VARIES, SO I AM PRESENTING IT IN THE ORDER THE ENGLISH VERSION GIVES]	市　　長　　最　　高　　！！
Domino	なんとすばらしいひびき！そのとおり！ミッドガルの市長は最高！誰が何と言おうと最高！
BEST!!	……フン、まあいいだろう。ホラ、持っていけ
God, I love the sound of that! BEST!! I AM the best…ME!! No matter what anyone else says, you'd better believe it.	ドミノ
…hmm. Well, OK. Here, take it.	神　　羅　　最　　低　　！！
Domino	なんとすばらしいひびき！そのとおり！プレジデント神羅は最低！私こそミッドガルの主！
KING!!	……フン、まあいいだろう。ホラ、持っていけ
God, I love the sound of that! KING!! President Shinra sucks! I should be King of Midgar!	ドミノ
…hmm. Well, OK. Here, take it.	市　　長　　爆　　発　　！！
Domino	なんとすばらしいひびき！そのとおり！私の怒りは最高レベルに！もう爆発しそうだ！
BOMB!!	……フン、まあいいだろう。ホラ、持っていけ
God, I love the sound of that! BOMB!! I'm so angry, I'm like a walking time bomb waiting to explode!	ドミノ
…hmm. Well, OK. Here, take it.	魔　　晄　　爆　　発　　！！
Domino	なんとすばらしいひびき！そのとおり！魔晄エネルギーを爆発させろ！そして私を真の市長に！
MAKO!!	……フン、まあいいだろう。ホラ、持っていけ
God, I love the sound of that! MAKO! If I had a lot more of it, I would be a real Mayor!	キーアイテム『カードキー６５』を手に入れた！
…hmm. Well, OK. Here, take it.	ドミノ
Received "Keycard 65"!	なんでこんなコトするか？
Domino	きまってるじゃないか。イヤガラセだよ。イヤガラセ
Why would I do something like this, you ask?	いいか、神羅はずっと私を苦しめてきたんだぞ
Revenge, of course!   Shinra's been torturing me forever.	だから私はここでキミたちをなやませ今度はキミたちが上へ行って神羅のやつらを困らせる
That's why I was a little rough on you all just now. Now go up there and really make them suffer.	どうだ、これでおあいこだろ。ヒ、ヒヒ、ヒヒヒ……
This ought to teach them! Heh heh heh…	ドミノ
Domino	言っておくが、私のカードでは６５階までしかのぼれんよ
But my card will only get you to the 65th floor.	神羅め、この私を……この私を一般社員とおなじあつかいに……
Can you believe how they treat me? …ME! Like some common employee…	ハット
Hart	市長の話はお聞きになりました？
Did you speak with the Mayor?	は？合言葉？ははあ、なるほど……
What? A password? Oh, I get it…	あの人もヒマなんですよ。なんせミッドガルの全権はほとんどプレジデント神羅のものですからね
He's got way too much time on his hands. But you can't really blame him, Everything in Midgar is controlled by President Shinra.	そういうことならわたくしがお手伝いしましょう
Maybe I can help you.	なんでもお答えしますよ？
What do you want to know?	合言葉を教えて
The password…duh!	ヒントをくれ
How about a hint?	助けなどいらない
Get out of my face	ハット
Hart	ハア、そうですか。ではしかたありませんね
…I see. Then, I guess that's that.	がんばってご自分で見つけてください
Good luck finding it on your own.	どうしてもわからなかったらまたどうぞ。いつでもお教えしますよ……
If you decide you want help. I'll just be right over here. Ready to tell you anytime…	ハイハイ。何がお望みで？
What can I do for you?	さっきのヒントをもう１度
Give me the hint again	次のヒントを
Give me the next hint	なんでもない
Uh, nothing	ハット
Hart	ええ、いいですとも。いいですとも
Sure, sure. All right.	市民のみなさんにサービスすることこそわたくしたち役人のよろこび
As a public servant, it's my job to serve the needs of the people.	こころよくヒントをお教えしましょう！「……５００ギルで
So here's a hint…	金をだそう
…for 500 gil.	ふざけるな！
Give him the money	……１０００ギルで
Forget it!	金をだそう
…for 1000 gil.	ふざけるな！
Give him the money	……２０００ギルで
Forget it!	金をだそう
…for 2000 gil.	ふざけるな！
Give him the money	……５０００ギルで
Forget it!	金をだそう
…for 5000 gil.	ふざけるな！
Give him the money	……１５０００ギルで
Forget it!	金をだそう
…for 15000 gil.	ふざけるな！
Give him the money	ハット
Forget it!	なんでもお答えしますよ？
Hart	助けてくれ
What do you want to know?	助けなどいらない
HELP	ハット
Forget it	おやおや。お金がたりないようですが？
Hart	今どきスラムの道具屋だってツケはききませんよ……
Hey now! You're a bit short.	ハット
No one works on credit nowadays… not even stores in the slums.	しかし、これだけのヒントでもわからないとは……
Hart	あなたがた、やっぱりスゴイ人だ。いろんなイミで
I can't believe it! I gave you all these hints, and you STILL don't get it?	こうなったらもうズバリ合言葉をお教えします！ハット「これはこれは……ありがとうございます。「いいですか。このフロアには神羅カンパニーの４つの部門の資料室があります
You guys are amazing!  Really, amazing…	合言葉はその４つの資料室にかくされています
Well, seeing as things have come to this, I might as well just tell you.	各部屋の資料をよ～く調べてみてください
Hart	資料室の名前はドアの横のプレートに書いてあります
Oh, my…well, Thank you very much.	いいですか。どの資料室にも１つだけ他の部の資料がまぎれこんでいるはずです
Now listen. On this floor are four research libraries for four different sections of Shinra, Inc….	その資料の数字とファイル名をよく見ると……
Parts of the password are hidden in each of the libraries.	いいですか。すべての資料には数字がついています
Pay careful attention to the files in each room.	各部屋にまぎれこんでいる資料の名前を、その数字と見くらべてください
The name of each library is written on the plaque outside the door.	『４』と書いてある資料なら名前の４文字目を……もう、おわかりでしょ？
Now, in each library will be one file mixed in from another library.	ハット
Look carefully at the numbers on each file.	次のヒントって……もう、ズバリ答えを言っちゃったじゃないですか！
There is a number at the beginning of each file name.	……わかりました。特別にわたくしのカードキーをさしあげましょう！
Look at the number on the files that don't belong in that library.	ハット
Match the number with the letters in the title of the file.	もしプレジデント神羅に会っても、わたくしのことは言わないでくださいよ
If the file starts with a 4, then check the fourth letter and… well, you get the idea.	これ以上神羅にイジメられるのはゴメンですからね……
Hart	ドミノ
What do you mean the next hint? I've practically told you, didn't I?	なんと、１回でズバリあてるとは……
…all right. Since this seems like a special case, I'll give you MY key card!	ひとは見かけによらないものだ。まあいい、約束は約束だ。これもやろう
Hart	『ぞくせい』のマテリアを手にいれた！
If you run into President Shinra, please don't tell him about this.	これいじょうマテリアは持てません。
I can't be a partner to anymore trouble for Shinra.	なにかマテリアをすててください。
I never thought you'd get it on the first try…	ドミノ
Just goes to show you can't judge a book by its cover. Oh well, a promise is a promise. Take this, too.	……なんだ、アレはいっぱいか。アレに空きができたら、またきたまえ
Received "Elemental" Materia!	『エリクサー』を手にいれた！
You cannot take on any more Materia.	『エーテル』を手にいれた！
Please discard some Materia.	『ポーション』を手にいれた！-
Domino	ドミノ
What…full already? Come back again when it's empty.	フン、そこそこ頭ははたらくようだ
Received "Elixir"!	いいだろう、これをうけとりたまえ
Received "Ether"!	ドミノ
Received "Potion"!	なるほど……ま、キミらならこんなものかな
Domino	それでは、キミたちにあげるのもこんなものだ
Hmm. It appears you're not completely stupid.	ドミノ
Fine then, take this.	やれやれ、やっとあてたか……
Domino	やはり頭を使うのは苦手かね？
I see… For you…this might be best.	……まあいい。とっておきたまえ}
Then, this is for all of you.	ここは科学部門の資料室です。
Domino	他の３つの資料室にはそれぞれ……
Hoo boy! You finally got it?	都市開発部門
You all really don't use your heads much, do you?	治安維持・兵器開発部門
……What the hey. Here, just take it anyway.	宇宙開発部門
This is the Scientific Research Library.	の資料が保管されています。
Materials for the…	持ちだし禁止！
Urban Dev. Library	このフロアの資料はすべて
Peace/Weapon Dev. Library	外部に持ちだすことを
Space Dev. Library	禁じられています。
are held in their respective libraries…	２　神羅プレート都市の
Materials are non-circulating!	設計とその間題点
Please do not remove any	２　魔晄炉建造工事
Materials from this floor.	都市部着工予定表
2Problems with Plate	８　魔晄炉建造工事
 construction in Midgar	都市部着工予定表
5Reactor Construction Chart	６　魔晄兵器の長期使用に
6Reactor Construction Chart	関する特別規定
4Ranks and extended use	１　魔晄兵器の長期使用に
of Mako weaponry	関する特別規定
24Ranks and extended use	４　ミッドガル区分地図
  of Mako weaponry	０番街～４番街
4Midgar City map: Sectors 0-4	５　ミッドガル区分地図
9Midgar City map: Sectors 5-8	５番街～８番街
3An illustrated guide to	６　　図説　カトー式都市空間工法
City Planning	１　　ジェノバプロジェクト
4The Jenova Project	経過報告書
6Data on experimental	神羅カンパニー科学部門
animals living near Midgar	２　ミッドガル周辺に生息する
3File on Dr. Gast, Biologist	突然変異生物実験データ
14The Ancients in History	３　　　　ガストファイル
8New plans for Urban Planning	生物博士ガスト・ファレミス
10New plans for Urban Planning	７　　　歴史の中の古代種
4Report on high Mako levels	生物博士ガスト・ファレミス
in living beings	３　新都市建設計画書
2Mako energy and the rise	１　新都市建設計画書
in life forms	５　生物体の高レベル魔晄による
8Final evolutionary stages	影響に対する調査
in land dwelling life	４　生物の爆発的進化と
1Biological characteristics	魔晄エネルギー
of the Ancients	６　地上生物の最終進化論
10Biological characteristics	８　伝承における古代種の
of the Ancients	生物学的特性
16Modern history of	[COULDN'T FIND IT]
Midgar space program vol. 1	[COULDN'T FIND IT]
19Modern history of the	２　　宇宙開発部門
Midgar Space Dev Program Vol. 2	栄光の歴史　上巻
7Diminishing Mako energy	４　　宇宙開発部門
and Planet movements	栄光の歴史　下巻
1Results of failed space mission	９　魔晄エネルギーの低下と
"YA-79"	惑星運動
6Shinra rocket space travel	５　大型飛行機械ヨナイ７９式
7Economic report: Space Dev Program	宇宙進出計画の失敗
10Materia production and its military uses	６　神羅ロケットエンジンと
3Special peace keeping law	大陸間航行機
1Heidegger's Shinra peace keeping law	１　　最終予算報告書
1Breakdown of SOLDIER members by class	神羅宇宙開発部門
3Plan for new land weapons	１　　マテリアの製造および
4Midgar crime white paper	その軍事的利用に関する権利
2Problems with Plate	２　特別治安維持法
construction in Midgar	ハイデッカー私案
This is the Space Dev Research Library.	１　神羅特別治安維持法
Click on the plate in front of	ハイデッカー私案
each library to see which it is.	３　クラス別ソルジャー配備データ
This is the Public Order/Weapon	４　新式地上兵器開発プラン
Development Library.	６　ミッドガル治安白書
Return materials where you found them.	反神羅勢力の現状
Do not mix materials from other libraries.	７　神羅プレート都市の
16Modern history of	設計とその間題点
Midgar space program vol. 1	ここは宇宙開発部門資料室です。
17Modern history of	各資料室の場所については
Midgar space program vol. 2	部屋の前にあるプレートを
1Results of failed space mission "YA-79"	ごらんください。
6Shinra rocket space travel	ここは治安維持部門および
8Final evolutionary stages	兵器開発部門の資料室です。
in land dwelling life	せいりせいとんを忘れずに！
2Economic report: Space Dev Program	他の部門の資料と
10Materia production and its military uses	間違えないようにしましょう。
3Special peace keeping law	２　　宇宙開発部門
14Heidegger's Shinra peace keeping law	栄光の歴史　上巻
1Breakdown of SOLDIER members by class	４　　宇宙開発部門
2Plan for new land weapons	栄光の歴史　下巻
7Economic report: anti-Shinra activities	５　大型飛行機械ヨナイ７９式
2Construction of Midgar city	宇宙進出計画の失敗
plates and their problems	６　神羅ロケットエンジンと
5Reactor construction chart	大陸間航行機
24Ranks and extended use of Mako weaponry	６　地上生物の最終進化論
4Ranks and extended use of Mako weaponry	１　　最終予算報告書
4Midgar City Map: Sectors 0 - 4	神羅宇宙開発部門
9Midgar City Map: Sectors 5 - 8	５　　マテリアの製造および
3An illustrated guide to city planning	その軍事的利用に関する権利
1Jenova Project	２　特別治安維持法
6Data on experimental animals	ハイデッカー私案
living near Midgar	１　神羅特別治安維持法
4File on Dr. Gast, biologist	ハイデッカー私案
4File on Dr. Gast, biologist	３　クラス別ソルジャー配備データ
10New plans for urban planning	４　新式地上兵器開発プラン
4Report of high Mako levels in life forms	７　ミッドガル治安白書
2Mako energy and the rise in life forms	反神羅勢力の現状
6Biological Characteristics of the Ancients	２　神羅プレート都市の
15Diminishing Mako energy and	設計とその間題点
Planet movements	２　魔晄炉建造工事
"…beep…beep…	都市部着工予定表
Open the door?"	６　魔晄兵器の長期使用に
Yes	関する特別規定
No	１　魔晄兵器の長期使用に
"…beep…beep…	関する特別規定
…verifying keycard…	４　ミッドガル区分地図
………	０番街～４番街
"Level B employee: verified.	５　ミッドガル区分地図
You are permitted to open doors	５番街～８番街
on this floor up to three times."	６　　図説　カトー式都市空間工法
"blip…	１　　ジェノバプロジェクト
If you receive an item coupon,	経過報告書
remember to exchange it for an item."	神羅カンパニー科学部門
"…Warning…do not enter the	２　ミッドガル周辺に生息する
air conditioning ducts,	突然変異生物実験データ
they are very dangerous..."	３　　　ガストファイルα
"…ga…	生物博士ガスト・ファレミス
…gaga…ga..."	４　　　ガストファイルβ
"…bing…bing…	生物博士ガスト・ファレミス
Enter command	３　新都市建設計画書
All Clear	５　生物体の高レベル魔晄による
Coupon Change	影響に対する調査
"You can exchange your coupons	４　生物の爆発的進化と
for items. Here are	魔晄エネルギー
the items you can have..."	６　伝承における古代種の
"A coupon…'Star Pendant'	生物学的特性
B coupon….'Four Slots'	９　魔晄エネルギーの低下と
C coupon….'All' Materia"	惑星運動}
"Please use caution…once you have	ピピッ……このドアをあけまスか？
exchanged coupons for items you	あける
may not select 'All Clear'."	やめておく
"Exchange coupon?"	ピピッ……カードキー照合……………………「Ｂランク社員ト確認。アナタは、このフロアのドアを３回まで開けルことが許可されましタ
Yeah……	チュウイ。アイテムクーポンをもラったらわすれズに、アイテムと交換しまショう
Naw	ケイコク。キケンですからむやみに通気ダクトをのぞクのはやめまショウ
"………	……ガ…………ガガ……ガ……
Coupon exchange complete."	ピピッ……コマンドを入力してくだサい
"…bing…bing…	オールクリア
Start again from the beginning?"	クーポンチェンジ
"The information and materials you	クーポンをアイテムにかえることができまス。もラえるアイテムは……
received on this floor	Ａクーポン……『星のペンダント』Ｂクーポン……『フォウスロット』Ｃクーポン……マテリア『ぜんたいか』
will all be cleared."	ただし、クーポンチェンジ後のオールクリアはでキません。ゴちゅういくださイ
"Clear them?"	クーポンチェンジしまスか？
Yeah…	ああ……
No	やめておく
"………	………………クーポンチェンジ完了
Cleared."	ピピッ……もう一度ハジメからやりなおしまスか？
"You are permitted to open	ただしこのフロアで手にいれタ記録、資料などもすべてクリアされまス
 any door on this floor up to three times."	クリアしまスか？
"Bi, bing…	ああ……
 You have opened three doors."	やめておく
"If you access the computer,	………………クリア完了
You can begin	アナタは、このフロアのドアを３回まで開けルことが許可されましタ
this process one more time."	ピピッ……アナタはすでに３回ドアをあけていまス
Received "Star Pendant"!	コンピュータにアクセスすればもう１度ハジメからやりなおすことができまス
Received "Hourglass"!	『星のペンダント』を手にいれた！
Received "All" Materia!	『きんのすなどけい』を手にいれた！
Received "Four Slot"!	『ぜんたいか』のマテリアを手にいれた！
Received "Glow Lance"!	『フォウスロット』を手にいれた！
CLOUD	『グローランス』を手にいれた！
An air-duct… It doesn't look like I can climb in here.	CLOUD
CLOUD	通気ダクトか……こちらからはもぐりこめそうにないな
An air-duct…	CLOUD
Climb in and look around	通気ダクトか……
Leave it alone	もぐりこんでみるか
Received Key Item "A Coupon "!	ほうっておこう
Received Key Item "B Coupon "!	キーアイテム『Ａクーポン』を手にいれた！
Received Key Item "C Coupon "!	キーアイテム『Ｂクーポン』を手にいれた！
"…beep…beep…	キーアイテム『Ｃクーポン』を手にいれた！
You do not have any coupons."	ピピッ……あなタはクーポンをもっていまセん
"…beep…beep…	ピピッ……クーポンチェンジ後のオールクリアはでキません
After you have exchanged coupons	これいじょうマテリアは持てません。
you may no longer use 'All Clear'."	なにかマテリアをすててください。
You cannot take on more materia.	マテリア『ぜんたいか』をＣクーポンにもどしましタ}
Please discard some materia.	ハーハー……最近おなかのあたりが気になりだして……
"Your 'All' Materia was	フーフー……つかれたらとなりの部屋でやすむといいわよ
returned for a C Coupon."	フンッ、フンッ……このビルの警備をあずかる者として、体力には気をつかっているのだ
…huff…wheeze… I'm trying to get rid of my love-handles…	ビジターの方でございますね。あいているマシンはご自由にご利用ください
…huff…puff… If you get tired, you can rest up in the next room.	CLOUD
Hmph, hmph… I'm head of building security so stamina's very important to me.	仮眠室か……
You must be a visitor. Feel free to use any open machine.	休んでいこう
CLOUD	先を急ごう
A nap room…	グーゴー……たのむ……からゆっくりねかせてくれ……
Let's get some rest	『フェニックスの尾』を手にいれた！
Let's move on	『エーテル』を手にいれた！
…zzz… Please…let me… get some…rest…	『マーベラスチアー』を手にいれた！
Received "Phoenix Down"!	CLOUD
Received "Ether"!	何だこれ……メガホン？
Received "HP Shout"!	こんなもの持っていってもしょうがないな
CLOUD	カギがかかっている……　　
What is this…a Megaphone?	中にはなにもない……　　
Hanging on to this won't do any good…	故障中です
Locked…	他の階をご利用下さい
There's nothing inside…	神羅カンパニー修理課
Out of Order	体力回復にこの１本！！『神羅ジム特製ドリンク』
Please use a different floor	２５０ギルにて発売中！！
Shinra Company Repair Management Department	買ってみるか
Take one to restore your energy!! 'Shinra Gym Health Drink'	やめておこう
Only 250 gil!!	CLOUD
Try it out	……何もでてこないな
Don't try it	…………
CLOUD	CLOUD
…Nothing…	……こわれているのか？
…	ガンガンたたく
CLOUD	あきらめよう
…Is it broken?'	ちょっと、なにするんですか！乱暴はやめてください！
BANG on it	『マインドアップ』を手にいれた！
Give up	『スピードアップ』を手にいれた！
Sir, what are you doing!? No violence here, please!	CLOUD
Received "Mind Source"!	…………
Received "Speed Source"!	やってみようか？
CLOUD	バカバカしい
….	CLOUD
Should I try it?	フウ……
This is so stupid	そろそろやめよう
CLOUD	もうすこしつづけよう
Whew…	CLOUD
Better quit	ほんのすこし身が軽くなったような……気がするな}
Just a bit longer	カギがかかっている……}
CLOUD	CLOUD
I think I feel a little lighter… Maybe just a bit…	ミッドガル……魔晄エネルギーを吸い出し生きつづける都市の模型か……
Locked…	模型が価けている……
CLOUD	ミッドガルパーツをはめよう
A model of Midgar…a city born from the earth's Mako.	ほうっておこう
Some parts are missing…	CLOUD
Insert the Midgar parts	……なにかが開いたような音がしたな……
Leave it alone	キーアイテム『カードキー６６』を手にいれた！
CLOUD	CLOUD
…Sounds like something opened up…	ミッドガル……魔晄エネルギーを吸い出し生きつづける都市の模型か……
Received Key Item "Keycard 66"!	この建設中の６番街が完成したとき、神羅の野望も完全なものとなる
CLOUD	その野望のためにAERITHを……？}
Midgar…a city born from the earth's Mako. A model of the city…	 “They're having another executive meeting.
When construction of Sector 6 finishes, Shinra's plan will be complete.	I wonder if it's about that Plate incident.”
That must be why he took AERIS…	 “Sittin' here facing the monitor…day in, day out…
 They're having another executive meeting. I wonder if it's about that Plate incident.	I kinda feel……forced…into doing it.
Sittin' here facing the monitor…day in, day out… I kinda feel……forced…into doing it. And I just don't have any motivation.	And I just don't have any motivation.”
Hey, when you're in the bathroom, do you ever hear whispers coming from somewhere?	 “Hey, when you're in the bathroom, do you ever
Is it just me or does the Conference Room smell? There's some sort of stench coming from somewhere…	hear whispers coming from somewhere?”
It gives me the feeling that I AM alive. The feeling of moving this world, just with my hands.	 “関係ないけどよ。
Whew, I'm so sick of carrying all these files…	あの会議室って、何か臭くないか？
But I get to meet lots of guys. I guess that's the benefit of being a secretary!	どこかから臭ってくるんだよな…… END}
Hello…!! (Looks so serious.  I guess it means the man's fastidious.)	なんかこう、生きがいってものを感じるよな。世界をこの手で動かしているっていうこの感じEND}
Hello…!! (He's kinda cute. But looks like that girl's  with him…  But that's kinda exciting!)	 “はぁ～
Hello…!!  (Wow, Pee-U! No thanks.)	 もうファイル運びはうんざり……」{NewScreen}
Hello…!! (Just concentrate on work…)	でもいろんな男の人との出会いがある。それがOLの特権ね！END}
Come on, we're building the future of Mako!	 “Hello…!!
……………………  ……………………  ……………………  ……………………  ……………………  ……………………  “Phew!	 “Hello…!!
BARRET	 “Hello…!!
Geez--! That's a lotta suits!	 “Hello…!!
Reeve	 “さあ、私たちで魔晄の未来をつくるのよ！”
We have the damage estimates for Sector 7.	 “……………………
Considering those factories we already set up and all the investments, the damage is estimated at approximately 10 Billion gil…	 ……………………
Reeve	 ……………………
The estimated cost to rebuild Sector 7 is…	 ……………………
President Shinra	 ……………………
We're not rebuilding.	 ……………………
Reeve	………………ふう”
What?	BARRET
President Shinra	ヒュ～！ そうそうたる顔ぶれだぜ
We're leaving Sector 7 as it is.	Reeve
And restarting the Neo-Midgar plan.	７番街の被害報告が出ました　NewScreen}
Reeve	すでに稼動していた工場部分と現在までの投資額を考えると 我が社の損害は100億ギルはくだらないかと……END}
…then the Ancients?	リーブ
President Shinra	また７番プレートの再建にかかる費用は……
The Promised Land will soon be ours.	プレジデント神羅
President Shinra	再建はしない”
I want you to raise the Mako rates 15% in every area.	リーブ
Palmer	は？END}
Rate hike! Rate hike! Tra, la, la! And please include our Space Program in the budget!	プレジデント神羅
President Shinra	７番プレートはこのまま放っておく
Reeve and Scarlet will divide the   extra income from the rate increase.	そのかわりに ネオ・ミッドガル計画を再開するEND}
Palmer	リーブ
Oh man!	……では、古代種が？END}
Reeve	プレジデント神羅
Sir. If you raise the rates, the people will lose confidence…	約束の地はまもなく我々のものになるだろうEND}
President Shinra	プレジデント神羅
It'll be all right.	それから各地の魔晄料金を15％値上げしたまえEND}
The ignorant citizens won't lose confidence, they'll trust Shinra, Inc. even more.	パルマー
Heidegger	値上げ値上げ！ うひょひょひょひょ！ ぜひ我が宇宙開発部にも予算を！
Ha ha ha!	プレジデント神羅
After all, we're the ones who saved Sector 7 from AVALANCHE!	魔晄料金値上げによる差益は リーブくんとスカーレットくんで分配したまえ
BARRET	パルマー
That dirty #$*$^	いいないいな！END}
President Shinra	リーブ
Hojo. How's the girl?	プレジデント。これ以上の魔晄料金の値上げは住民の不満をまねき……
Hojo	プレジデント神羅
As a specimen, she is inferior to her mother. I'm still in the process of comparing her to her mother, Ifalna, but for now the difference is 18 %.	だいじょうぶだ（NewScreen）
President Shinra	おろかな住民たちは不満をどころか ますます神羅カンパニーに信頼をよせることになるEND}
How long will the research take?	ハイデッカー
Hojo	ガハハハハ！NewScreen}
Probably 120 years. It's probably impossible to finish in our lifetime. Or in the lifetime of the specimen too, for that matter.	テロリストどもから７番街の市民を救ったのは 神羅カンパニーですからな！END}
Hojo	BARRET
That's why we're thinking of breeding her. Then we could create one that could withstand our research for a long time.	汚ねえ……
President Shinra	プレジデント神羅
What about the Promised Land? Won't it hinder our plans?	おお、宝条くん。あの娘はどうかね
Hojo	宝条
That's what I need to plan. The mother is strong… and yet has her weaknesses.	サンプルとしては母親におとる。母親イファルナとの比較中だが初期段階で相違が18％
CLOUD	プレジデント神羅
They were talking about AERIS…right?	その検査にはどれくらいかかる？
BARRET	宝条
I dunno.	ざっと、120年。我々が生きてるあいだは無理だろう。もちろんあのサンプルもな
TIFA	宝条
Probably.	だから古代種を繁殖させようと思うのだ。しかも、長命で実験に耐えうる強さを持たせることができる
CLOUD	プレジデント神羅
Let's follow 'em.	約束はどうなる？ 計画に支障はでないのか？END}
Scarlet	Hojo
Something stinks…	……そのつもりだ。母は強く……そして弱みを持つEND}
President Shinra	CLOUD
That concludes our meeting.	いまのはAERITHの話……だよなEND}
Flush?	BARRET
Climb up?	わかんねえEND}
Get out of here	TIFA
CLOUD	たぶん、ねEND}
Hojo…huh…?	CLOUD
BARRET	あとをつけようEND}
I remember him.	スカーレット
BARRET	臭うわね……END}
That Hojo guy. He's in charge of the Shinra's Science Department. CLOUD, don't you know him?	神羅
CLOUD	では、会議を終わるEND}
This is the first time I've actually ever seen him. So…that's what he looks like…	汚いから長そうか？
Is this today's specimen?	登ってみようか？
Hojo	やっぱり出よう
Yes. We're starting right away. Raise it to the upper level.	CLOUD
Hojo	宝条……ってやつか……END}
My precious specimen…	BARRET
TIFA	思い出したぜEND}
Precious specimen…?	BARRET
TIFA	あの宝条ってやつ。神羅の科学部門の責任者だ。CLOUD、知らねえのか？END}
Is it going to be used for a biological experiment?	CLOUD
CLOUD	じっさい見るのは初めてだ。そうか……あいつが……END}
……A monster.	今日の実験サンプルはそいつですか？END}
TIFA	宝条
You all right?	そうだ。すぐ実験にとりかかる。上の階をあげてくれEND}
CLOUD	宝条
Jenova…	かわいいサンプルよ……END}
CLOUD	TIFA
Jenova… Sephiroth's… So…they've brought it here.	かわいいサンプルよ…かEND}
TIFA	TIFA
CLOUD, be strong!	生物実験に使われるのかな？END}
CLOUD	CLOUD
Did you see it?	“……A monster.”
BARRET	TIFA
See what?	“You all right?”
CLOUD	CLOUD
It's moving……still alive?	ジェノバ……END}
BARRET	CLOUD
Where's its $#&*&@ head? This whole thing's stupid. Let's keep goin'.	ジェノバ…… セフィロスの…… そうか……ここに運んだのかEND}
Let's see… The specimen Hojo asked me for is…	TIFA
That elevator back there is only to transport Specimens. You can't use it. It would be a lot easier if it led to the 68 Floor Research Lab.	CLOUD、しっかりして！END}
CLOUD	CLOUD
AERIS!	見たか？END}
Hojo	BARRET
AERIS? Oh, is that her name? What do you want?	何を？END}
CLOUD	CLOUD
We're taking AERIS back.	動いてる……生きてる？END}
Hojo	BARRET
Outsiders……	何だい、この首なしは？ けっ、バカバカしい。さっさと行こうぜEND}
BARRET	 “さて……と
Shoulda noticed it earlier, you…	宝条さんに頼まれた
Hojo	サンプルわ……と
There's so many frivolous things in this world.	奥のサンプル運搬用エレベーターは使用禁止だよ。６８階の研究室に直結しているから便利なんだけどね
Hojo	CLOUD
Are you going to kill me? I don't think you should.	“AERITH!”
The equipment here is extremely delicate. Without me, who could operate it? Hmm?	宝条
CLOUD	AERITH？ ああ、この娘の名前だったな。何か用か？END}
Ugh.	{CLOUD
Hojo	AERITHを返してもらおうEND}
That's right. I recommend you think things out logically before you make any rash moves.	宝条
Hojo	…………部外者だなEND}
Now, bring in the Specimen!	BARRET
CLOUD	最初に気づけよEND}
What do you think you're doin'?	宝条
Hojo	世の中にはどうでもいいことが多いのでなEND}
Lending a helping hand to an endangered species… Both of them are on the brink of extinction…	宝条
Hojo	私を殺そうというのか？ それはやめた方がいいなNewScreen}
If I don't help, all these animals will disappear.	ここの装置はデリケートだ。私がいなくなったら操作できまい？　ん？END}
TIFA	CLOUD
…animal? That's terrible! AERIS is a human being!	くっEND}
BARRET	宝条
You're gonna pay!	そうそう。こういう時こそ論理的思考によって 行動することをおすすめするよEND}
AERIS	宝条
CLOUD, help!	さあ、サンプルを投入しろ！END}
CLOUD	CLOUD
BARRET! Can't you do anything?	何をする気だ！END}
BARRET	宝条
Awright!! Step back!	滅びゆく種族に愛の手を…… どちらも絶滅まぢかだEND}
Hojo	宝条
Stop!!	私が手を貸さないと この種の生物は滅んでしまうからなEND}
Hojo	TIFA
Wh…what are you do-- Oh! My precious specimens…	……生物？　ひどいわ！ AERITHは人間なのよ！END}
Hojo	BARRET
Take care of the rest!	許せねえ！END}
Hojo	AERITH
This is no ordinary specimen. This is a very ferocious specimen!	CLOUD、助けて！END}
CLOUD	CLOUD
Now's our chance to get AERIS!	BARRET！ 何とかならないのか？END}
AERIS	BARRET
Thanks, CLOUD.	ええい！！ さがってろ！END}
TIFA	宝条
CLOUD…what's wrong?	やめろ！！END}
CLOUD	宝条
…The elevator is moving.	な、なんていうことだ。大事なサンプルが……END}
BARRET	Hojo
Oh shit… We're surrounded.	“Take care of the rest!”
He's rather strong. I'll help you all out.	宝条
TIFA	今度はこんなハンパな奴ではないぞ。もっと凶暴なサンプルだ！END}
It talked!?	CLOUD
I'll talk as much as you want later, Miss.	今のうちにAERITHを！END}
CLOUD	AERITH
We'll take care of that monster.	ありがと、CLOUDEND}
Somebody take AERIS somewhere safe…	TIFA
   TIFA, I'm countin' on you!	どうしたの？　CLOUD……END}
   BARRET, take care of her!	CLOUD
CLOUD	……エレベーターが動いてるEND}
What's your name?	BARRET
{Red XIII}	“Oh shit…
Hojo has named me, Red XIII. A name with no meaning whatsoever to me. Call me whatever you wish.	あいつは少々手強い。私の力を貸してやるEND}
CLOUD	TIFA
Come on!	しゃべった！？END}
You must be the leader? Come on!	あとでいくらでもしゃべってやるよ、おじょうさんEND}
BARRET	CLOUD
I'll take AERIS!	あの化け物は俺たちがかたづけるNewScreen}
TIFA	誰かAERITHを安全な所へ……EOL}
I'll take AERIS!	   TIFA, I'm countin' on you!
CLOUD	   BARRET, take care of her!
AERIS, you all right?	CLOUD
TIFA	おまえの名前は？END}
She seems all right, …in many ways.	RED XIII
{Red XIII}	宝条は私をRED XIIIと名づけた。私にとって無意味な名前だ。好きなように呼んでくれEND}
I have a right to choose, too. I don't like two-legged things.	CLOUD
BARRET	さあ、かかってこい！END}
What are you?	 “You must be the leader? Come on!”
{Red XIII}	BARRET
An informed question. But difficult to answer. I am what you see.	“I'll take AERITH!”
{Red XIII}	TIFA
…You must have many questions, but first, let's get out of here. I'll lead the way.	“I'll take AERITH!”
AERIS	CLOUD
CLOUD… so you did come for me.	AERITH、だいじょうぶか？END}
AERIS	TIFA
Eaaaaghhh!	だいじょうぶみたいよ。……いろんな意味でねEND}
{Red XIII}	RED XIII
I apologize for what happened back there. I was merely acting to throw Hojo off guard……	……私にも選ぶ権利がある。二本足は好みじゃないEND}
AERIS	BARRET
…….	おまえ、なんだ？END}
TIFA	RED XIII
Let's go!	興味深い問いだ。しかし、その問いは答え難いな。私は見てのとおり、こういう存在だ
BARRET	RED XIII
Now we've saved AERIS, ain't no need to be in this buildin'! So let's get the hell outta here!	……いろいろ質問もあるだろうが とりあえずここから出ようか。道案内くらいなら付きあってやるEND}
CLOUD	AERITH
If all five of us go together, we'll be noticed. Let's break up in two groups.	CLOUD…… やっぱり、来てくれたのねEND}
AERIS	AERITH
I'll see you later!! We'll be waiting at the 66th Floor Elevator.	Eaaaaghhh!
TIFA	RED XIII
We'll be going first! Meet at the 66th Floor Elevator.	さっきは失礼したな。宝条を油断させるために演技をしたつもりだったが……END}
BARRET	AERITH
Later! Meet up at the 66th Floor Elevator!	“…….”
{Red XIII}	TIFA
Don't be late. Do you know where the Elevator is? The 66th Floor!	“Let's go!”
No! Please don't kill me. I only did what Hojo told me to do.	BARRET
To prove it to you…here, this is the key card to the 68th Floor. Would I be doing this if I was the enemy?	さあ、AERITHを助ければもうこんなビルには用はない！ さっさと出ちまおうぜEND}
BARRET	CLOUD
Damn, down.	５人で行動していたら目立つ。二手に別れようEND}
TIFA	AERITH
Hurry up!	“あとでね！
{Red XIII}	【66階エレベーター】で待ってるから”
It'll come soon.	TIFA
BARRET	先に行くわよ！
Alright, let's go!	集合は【66階エレベーター】よ”
TIFA	BARRET
Let's go!	あとでな！　【66階エレベーター】で合流だ！END}
BARRET	RED XIII
Where you goin'? Everyone's waitin' at the 66th Floor Elevator.	遅れるなよ。【エレベーター】の場所はわかっているな？ 【66階】だぞEND}
TIFA	ひゃっ！殺さないで
Where are you going? Everyone's waiting for us at the 66th Floor Elevator.	宝条博士に言われてやっただけなんだ　
AERIS	そのしょうこに……ほら
Not that way! Everyone's on the 66th Floor Elevator.	６８階までのドアロックキーを
{Red XIII}	君たちにあげるよ。
You don't have a Card Key	敵だったらこんな事するはずないだろ？
CLOUD	……ねっ？
H, hey! What is it?	BARRET
Rude	“Damn, down.”
Would you press 'Up' please?	TIFA
CLOUD	“Hurry up!”
Turks! Must be a trap…	RED XIII
Tseng	“It'll come soon.”
This must've been a real thrill for you… Did you enjoy it?	BARRET
CLOUD	“Alright, let's go!”
Ggh…	TIFA
Cloud}	“Let's go!”
They got you, too?	BARRET
CLOUD	どこ行くんだい？【６６階エレベーター】でみんな待ってるぜ
Where is AERIS!?	TIFA
President Shinra	どこ行くの？【６６階のエレベータ】でみんな待っているわよ
In a safe place.	AERITH
President Shinra	そっちじゃない！みんなは【６６階エレベータ】で待っているわ
She's the last surviving Ancient…	RED XIII
President Shinra	}
Don't you know? They called themselves the Cetra, and lived thousands of years ago. Now they are just a forgotten page in history.	カードキーを手にいれてません
{Red XIII}	CLOUD
Cetra…that girl is a survivor of the Cetra?	お、おい！　何だ？
President Shinra	ルード
Cetra, or the Ancients, will show us the way to the 'Promised Land'. I'm expecting a lot out of her.	上を押してもらおうか？
{Red XIII}	CLOUD
The Promised Land? Isn't that just a legend?	タークス？ワナ……か
President Shinra	ツォン
Even so, it's far too appealing not to pursue.	スリリングな気分をあじわえたと思うが……楽しんでもらえたかな？
It's been said the Promised Land is very fertile.	CLOUD
…If the land is fertile…	くっ……}
BARRET	CLOUD
then there's gotta be Mako!	みんなもつかまったのか………………？
President Shinra	CLOUD
Exactly. That is why our money making Mako Reactor is necessary.	AERITHはどこだ！
The abundant Mako will flow out on its own.	プレジデント神羅
President Shinra	安全な場所にいる
That is where Neo-Midgar will be built. Shinra's new glory…	プレジデント神羅
BARRET	あれは貴重な古代種の生き残りだからな
@$#*^%! Quit dreamin'!	プレジデント神羅
President Shinra	知らんのか？自らをセトラと呼び、数千年の昔に生き今は歴史の中に埋もれてしまった種族
Oh really, don't you know? These days all it takes for your dreams to come true is money and power.	RED XIII
President Shinra	セトラ……あの娘がセトラの生き残り？
Well, that is all for our meeting.	プレジデント神羅
BARRET	セトラ、すなわち古代種は我らに『約束の地』を教えてくれる。彼女には期待しているのだ
Hold it! I got a lot to say to you!	RED XIII
President Shinra	約束の地？それは言い伝えではないか？
If there's anything else… talk to my secretary.	プレジデント神羅
Rude	だからといって放っておくにはあまりにも魅力的だ
Come on! Outta his way!	約束の地は途方もなく豊かな土地と言われているからな
I wonder how BARRET is doing	……土地が豊かだということは
I wonder how {Red XIII} is doing	BARRET
I wonder how AERIS is doing	魔晄エネルギーだな！
I wonder how {Red XIII} is doing	プレジデント神羅
I wonder how AERIS is doing	そのとおり。そこでは金喰い虫の魔晄炉など必要ないのだ
I wonder how BARRET is doing	豊富な魔晄エネルギーが勝手に吹き出してくる
I wonder how AERIS is doing	プレジデント神羅
I wonder how AERIS is doing	そこに建設されるネオ・ミッドガル。我が神羅カンパニーのさらなる栄光……
I wonder how BARRET is doing	BARRET
I wonder how {Red XIII} is doing	ケッ！夢みてんじゃねえよ！
Let's just get some sleep	プレジデント神羅
I wonder how {Red XIII} is doing	おやおや、知らないのか？最近では金と力さえあれば夢はかなうのだ
Let's just get some sleep	プレジデント神羅
I wonder how BARRET is doing	さて、会見はこれで終わりだ
Let's just get some sleep	BARRET
Let's just get some sleep	待ちやがれ！テメエには言いたいことが山ほどあるんだ！
TIFA	プレジデント神羅
Psst (Can we get out?)	何かあるなら……秘書をとおしてくれたまえ
(Leave it to me)	ルード
(Kinda hard)	さあ！　さがれ！}
TIFA	BARRETはどうしてるかな
Psst (CLOUD, you're so brave!)	RED XIIIはどうしてるかな
TIFA	AERITHはどうしてるかな
Psst (Don't give up!)	RED XIIIはどうしてるかな
BARRET	AERITHはどうしてるかな
Hey!	BARRETはどうしてるかな
BARRET	AERITHはどうしてるかな
AERIS is an Ancient and the real name of the Ancients is Cetra.	AERITHはどうしてるかな
The Ancients know where the Promised Land is and the Shinra is searching for that Promised Land.	BARRETはどうしてるかな
BARRET	RED XIIIはどうしてるかな
I only heard stories 'bout the Promised Land. I don't know if it really exists.	とりあえず眠っておこう
BARRET	RED XIIIはどうしてるかな
Is that right?	とりあえず眠っておこう
BARRET	BARRETはどうしてるかな
The Shinra believe that the Promised Land is full of Mako energy.	とりあえず眠っておこう
BARRET	とりあえず眠っておこう
Which means, if the Shinra get there, they'll suck up all the Mako energy.	TIFA
BARRET	ヒソヒソ（逃げられるかな？）EOL}
…and the land'll wither away. The Planet's gonna get weaker.	TIFA
BARRET	ヒソヒソ（CLOUD、たのもしい！）
I can't just leave 'em be. I'm recruitin'new members!!	TIFA
Me, TIFA, CLOUD… and AERIS too.	“ヒソヒソ(弱気にならないでよ！}
BARRET	BARRET
How 'bout you?	おい}
BARRET	BARRET
You're so damn boring.	AERITHは古代種で 古代種の本当の呼び名はセトラNewScreen}
{Red XIII}	それで古代種は約束の地って場所を知っていて、神羅はその約束の地が欲しい、とEND}
…………Grandpa.	BARRET
BARRET	でも、約束の地ってのは 言い伝えに出てくるだけで 本当にあるのかどうかはわからねえ}
Grandpa!?  Ha, ha, ha…… Grandpa, hmm……ha, ha, ha……	BARRET
{Red XIII}	これでいいのか？}
What's so funny?	BARRET
BARRET	約束の地には豊富な魔晄エネルギーがあると 神羅の連中は考えてる}
Nothin'……ha, ha	BARRET
AERIS	ってえことは、神羅はそこに行ったら また魔晄エネルギーをガンガン吸い上げちまうってことだ.”
CLOUD, are you there?	BARRET
CLOUD	……そこも土地が枯れちまうな。星が……病んでいくわけだ}
AERIS!? You safe?	BARRET
AERIS	放っちゃおけねえ！ アバランチ、メンバー募集だNewScreen}
Yeah, I'm all right.	オレ、TIFA、CLOUD…… それにAERITHもだなEND}
AERIS	BARRET
I knew that CLOUD would come for me.	おめえ、どうだ？}
CLOUD	BARRET
Hey, I'm your bodyguard, right?	つまんねえやろうだぜ}
AERIS	RED XIII
The deal was for one date, right?	……………………じっちゃん}
TIFA	BARRET
…………oh, I get it.	じっちゃん！？　へへへへ じっちゃん、ねえ……へへへへ}
AERIS	RED XIII
…!? TIFA! TIFA, you're there too!	なにがおかしい}
TIFA	BARRET
EXCUSE me.	いや、べつに……へへへ
TIFA	AERITH
You know, AERIS. I have a question.	CLOUD、そこにいるの？}
AERIS	CLOUD
What?	AERITH！？　無事か？}
TIFA	AERITH
Does the Promised Land really exist?	うん、だいじょぶ}
AERIS	AERITH
…I don't know.	きっと、CLOUDが来てくれるって思ってた}
AERIS	CLOUD
All I know is…	ボディーガード、依頼しただろ？}
The Cetra were born from the Planet, speak with the Planet, and unlock the Planet.	AERITH
And……then…	報酬はデート１回、だったよね？}
The Cetra will return to the Promised Land. A land that promises supreme happiness.	TIFA
TIFA	…………………なるほど}
…What does that mean?	AERITH
AERIS	……！？　TIFA！ TIFAもそこにいるの！}
More than words……I don't know.	TIFA
CLOUD	すいませんねえ}
…Speak with the Planet?	TIFA
TIFA	あのね、AERITH。質問があるんだけど}
Just what does the Planet say?	AERITH
AERIS	な～に？}
It's full of people and noisy. That's why I can't make out what they are saying.	TIFA
CLOUD	約束の地って本当にあるの？}
You hear it now?	AERITH
AERIS	……わからない｣}AERITH「わたし、知ってるのは……}
I, I only heard it at the Church in the Slums. Mother said that Midgar was no longer safe. That is…my real mother.	『セトラの民、星より生まれ 星と語り、星を開く』NewScreen}
AERIS	えっと……それから……”{NewScreen}
Someday I'll get out of Midgar… Speak with the Planet and find my Promised Land.	『セトラの民、約束の地へ帰る。至上の幸福、星が与えし定めの地』END}
…That's what mom said.	TIFA
I thought I would stop hearing her voice as I grew up, but…	……どういう意味？}
CLOUD	AERITH
What's happened?	言葉以上の意味、知らないの}
CLOUD	CLOUD
The door's open… When did it open?	……星と語り？}
TIFA	TIFA
……	星が何か言うの？}
CLOUD	AERITH
TIFA… Wake up!	人が大勢いて、ざわざわしてるかんじ。だから何を言ってるのか よくわからないの}
TIFA	CLOUD
What's wrong?	今も聞こえるのか？}
CLOUD	AERITH
Something's wrong. Look outside.	わたし、聞こえたのはスラムの教会だけ。ミッドガルはもうダメだって 母さん……本当の母さんが言ってた}
TIFA	AERITH
This's kinda eerie…	いつかミッドガルから逃げなさい。星と話して、AERITHの約束の地 見つけなさいNewScreen}
TIFA	……母さんが言ってたNewScreen}
I wonder what happened…	大人になったら聞こえなくなるんだと思ってたけど……END}
CLOUD	CLOUD
He should have the key on him…	どうしたんだ？}
CLOUD	CLOUD
Come on, TIFA, get AERIS. I'll go help BARRET and the others.	ドアが開いている…… いつの間に？}
CLOUD	TIFA
AERIS	“……”
AERIS	CLOUD
…What happened?	TIFA……起きろ！}
AERIS	TIFA
Must've been attacked by…	どうしたの？}
CLOUD	CLOUD
BARRET, {Red XIII} …come with me. Something's wrong.	ようすがおかしい。外を見てみろ}
BARRET	TIFA
How'd you get in? Why's the door open!?	一体何があったのかしら……}
BARRET	TIFA
The hell's goin' on!?	なんだか恐いわ……}
{Red XIII}	CLOUD
No human could've done this.	きっとここのカギを持っているはずだ……}
{Red XIII}	CLOUD
I'll go on ahead.	ほら、TIFAはAERITHを。俺はBARRETたちを助ける}
BARRET	CLOUD
I'll clean up back here, so you guys go ahead. And don't get caught by Shinra!	“AERITH”
TIFA	AERITH
Come on, let's follow {Red XIII}!	何かに襲われた……？}
{Red XIII}	AERITH
Jenova Specimen… Looks like it went to the upper floor using that elevator for the specimens.	“Must've been attacked by…”
{Red XIII}	CLOUD
It looks like it leads up…	BARRET、RED XIII……来てくれ。ようすが変なんだ}
CLOUD	BARRET
…Did it get away? Jenova…?	どうやって入ってきた？ どうして扉が開いているんだ！？}
CLOUD	BARRET
Jenova too…	どうしちまったんだよ？}
BARRET	RED XIII
He's dead… The head of Shinra is dead…	人間の仕業ではないな}
TIFA	RED XIII
Then this sword must be…	私がこの先の様子を見てくる}
CLOUD	BARRET
Sephiroth's!!	こいつの後始末はオレにまかせて おまえらは先に行け。神羅に見つからねえうちによ！}
TIFA	TIFA
…Sephiroth is alive?	さ、RED XIIIの後を追いましょう}
CLOUD	RED XIII
…Looks like it. Only Sephiroth can use that sword.	ジェノバ・サンプル…… 察するに上の階に向かったようだ。奥のサンプル用エレベーターを使ってな}
BARRET	RED XIII
Who cares who did it!? This is the end of the Shinra!	何か目的に向かっているような…… 上に……？}
Uh!	CLOUD
Palmer	“…Did it get away?
P, p, p, please, don't kill me!	Jenova…?
CLOUD	CLOUD
What happened?	“Jenova too…”
Palmer	BARRET
Se…Sephiroth. Sephiroth came.	死んでる……神羅カンパニーのボスが死んだ……
CLOUD	TIFA
Did you see him? Did you see Sephiroth?	この刀は？！
Palmer	CLOUD
Yeah, I saw him! With my own eyes!	セフィロスのものだ！！
CLOUD	TIFA
You really saw him?	……セフィロスは生きているのね？
Palmer	CLOUD
Uh! Would I lie at a time like this!? I heard his voice, too!	……そうみたいだな。この刀を使えるのはセフィロスしかいないはずだ
Palmer	BARRET
Um, he said something about not letting us have the Promised Land.	誰がやったっていいじゃねえか！これで神羅も終わりだぜ！
TIFA	うひょ！
Then does that mean	パルマー
the Promised Land really does exist and that Sephiroth's here to save it from Shinra?	こここここころさないでくれ！
BARRET	CLOUD
So he's a good guy then?	何があったんだ？
CLOUD	パルマー
Save the Promised Land? A good guy? No way!!	セ、セフィロス。セフィロスが来た
It's not that simple! I know him! Sephiroth's mission is different!	CLOUD
BARRET	見たのか？　セフィロスを見たのか？
Rufus! &*%$! I forgot about him!	パルマー
TIFA	ああ、見た！　この目で見た！
Who's that?	CLOUD
BARRET	本当に見たんだな？
Vice President Rufus. The President's son.	パルマー
{Red XIII}	うひょっ！こんな時にウソなんか言わない！それに声も聞いたんだ、うひょっ！
I only know his name.	パルマー
BARRET	えっと『約束の地は渡さない』ってブツブツ言ってた
I heard that he'd been assigned somewhere else for a long time…	TIFA
TIFA	それじゃあ、なに？
I wonder what sort of person he is?	約束の地っていうのは本当にあってセフィロスは約束の地を神羅から守るためにこんなことを？
AERIS	BARRET
I've heard that no one's ever seen him bleed or cry.	いいやつじゃねえのか？
Rufus	CLOUD
So… So Sephiroth was actually here. …By the way,	約束の地を守る？いいやつ？　ちがう！！
Rufus	そんな単純な話じゃない！俺は知ってるんだ！セフィロスの目的はちがう！
just who are you?	BARRET
CLOUD	ルーファウス！しまった！　アイツがいたか！
I'm CLOUD, ex-SOLDIER, First Class!	TIFA
BARRET	誰なの？
I'm from AVALANCHE!	BARRET
TIFA	副社長ルーファウス。プレジデントの息子だ
Me too!	RED XIII
AERIS	名前だけなら、私も知っている
A flower girl from the slums.	BARRET
{Red XIII}	長期出張中だって聞いてたぜ……
A Research Specimen.	TIFA
Rufus	どんな人なのかしら……
What a crew.	AERITH
Rufus	血も涙もない、そう聞いたこと、あるけど
Well, I'm Rufus. The President of Shinra, Inc.	ルーファウス
BARRET	そうか……やはりセフィロスは生きていたか。……ところで
You're only President 'cause yer old man died!	ルーファウス
Rufus	おまえたちはなんだ？
Correct. I'll let you hear my inauguration speech.	CLOUD
Rufus	元ソルジャー・クラス１ＳＴ。CLOUDだ！
…Father tried to control the world with money and that worked for him.	BARRET
Rufus	アバランチだ！
The people believed that Shinra would protect them.	TIFA
Rufus	同じく！
Work at Shinra, get your pay. If terrorists attack, the Shinra army will help you.	AERITH
It looked perfect on the outside.	……スラムの花売り
Rufus	RED XIII
But, I do things differently.	……実験サンプル
I'll control the world with fear. It's too much to do it like my old man.	ルーファウス
Rufus	おかしな組み合わせだ
A little fear will control the minds of the common people. There's no reason to waste good money on them.	ルーファウス
TIFA	さて、私はルーファウス。この神羅カンパニーの社長だ
He likes to make speeches just like his father.	BARRET
CLOUD	オヤジが死んだらさっそく社長か！
Get AERIS outta the building!	ルーファウス
BARRET	そうだ、社長就任のあいさつでも聞かせてやろうか
What?	ルーファウス
CLOUD	……オヤジは金の力で世界を支配しようとした。なるほどうまくいっていたようだ
I'll explain later! BARRET! This is the real crisis for the Planet!	ルーファウス
BARRET	民衆は神羅に保護されていると思っているからな
The hell's that supposed to mean?	ルーファウス
CLOUD	神羅で働き、給料をもらいテロリストがあらわれれば神羅の軍隊が助けてくれる
I'll explain later! Just take my word for now! I'll go after I take care of him!	一見完璧だ
BARRET	ルーファウス
Alright, CLOUD!	だが私のやりかたはちがう
Rufus	私は世界を恐怖で支配する。オヤジのやりかたでは金がかかりすぎるからな
Why do you want to fight me?	ルーファウス
CLOUD	恐怖はほんの少しで人の心を支配する。おろかな民衆のために金を使う必要はない
You want the Promised Land and Sephiroth.	私はオヤジとはちがうのだ
Rufus	TIFA
That's right.	演説好きなところはそっくりね
Rufus	CLOUD
Did you know that Sephiroth is an Ancient?	AERITHを連れてビルから出てくれ！
CLOUD	BARRET
…Whatever, I can't let either you or Sephiroth have the Promised Land!	なに？
Rufus	CLOUD
I see. I guess we won't be allies.	説明はあとだ！BARRET！　本当の星の危機だ！
Access Menu with [MENU]	BARRET
Remove Materia from members with [SWITCH]	なんだそりゃ？
End with [START].	CLOUD
Access Menu with [MENU]	あとで話す！いまは俺を信じてくれ！俺はこいつを倒してから行く！
End with [START]	BARRET
TIFA	わかったぜ、CLOUD！
Where's Rufus?	ルーファウス
CLOUD	なぜ私と戦うのだ？
I couldn't finish 'em. This is gonna get complicated.	CLOUD
AERIS	おまえは約束の地を求めてセフィロスを追う
CLOUD… I just thought of something.	ルーファウス
TIFA	ふむ、その通り
…I'll wait for CLOUD! Everyone, get to the elevator!	ルーファウス
AERIS	ん？　おまえ、セフィロスが古代種だと知っているのか？
Hmm, it's going to get pretty ugly from here on. We should check on our equipment.	CLOUD
CLOUD and	……いろいろあってな。とにかく、おまえにもセフィロスにも約束の地はわたせない！
TIFA's Materia…	ルーファウス
(Remove)	なるほど。友だちにはなれないようだな
(Leave it)	【△ボタン】でメニューをひらく
Shinra Bldg. 3f. Lobby	【□ボタン】で他のメンバーのマテリアをはずす
Hardy Datona	【スタートボタン】で終了
AERIS	【△ボタン】でメニューをひらく
Quickly, we have to get out of here…	【スタートボタン】で終了
Shinra Bldg. 2f. Lobby	TIFA
AERIS	ルーファウスは？
Quickly, we can escape this way…	CLOUD
BARRET	とどめはさせなかった。面倒なことになりそうだ
I'll go on ahead!	AERITH
BARRET	CLOUD、なんか、思いつめてた
*&^%(*… We're surrounded!	TIFA
If I was alone this wouldn't be a thing, but I gotta reputation to protect.	……私、CLOUDを待つわ！みんなはエレベーターで先に！
AERIS	AERITH
You all get out while you can.	さあ、この先きっとガードがきびしくなるわ。装備をととのえておいたほうがいいわね
It's not you they're after… it's me.	CLOUD、TIFAのマテリアを……
BARRET	【はずす】
Yeah, well that ain't happenin'.	【そのまま】}
You got caught up in this over Marlene. Now, it's my turn to help you!	神羅ビル・３階ロビー
BARRET	ハーディ＝デイトナ　　
OK, playtime's over jackasses…	AERITH
AERIS	はやく、ここから逃げなくちゃ……}
…Thank you, Mr. BARRET!	神羅ビル・２階ロビー
BARRET	AERITH
Who you callin' Mr. BARRET? That don't sound right!	はやく、ここから逃げなくちゃ……}
{Red XIII}	BARRET
Well then…	オレが先に行くぜ！
If you are through talking, may I suggest that we think of a way to get out of here.	BARRET
BARRET	チッ……！すっかりかこまれてやがる
Huh? Oh, oh yeah… You're cold, man. Just like someone else 'round here I know.	オレひとりならともかくこのメンツじゃ……
{Red XIII}	AERITH
Did you say something?	……やっぱり、あなたたちだけ逃げて
BARRET	あの人たちがねらっているのはわたし。あなたたちだけなら……
Notta thing. So what're we gonna do?	BARRET
TIFA	ヘッ、そうはいかねえな
BARRET!!	アンタはマリンを守るためにヤツらに捕まった。今度は、オレがアンタを守る番だ
BARRET	BARRET
TIFA! Where's CLOUD?	これ以上ヤツらの……神羅の好き勝手にはさせねえ
TIFA	AERITH
Everyone! Over here!	……ありがと、BARRETさん
BARRET	BARRET
Huh? What's up? Where's CLOUD?	へヘッ、よしてくれよ。『BARRETさん』なんてオレのガラじゃねえや
TIFA	RED XIII
He's coming! Hurry, Hurry!!	……さて
AERIS	キミたちの話が終わったならそろそろここから逃げ出す方法を考えてみないか？
Quickly! We'll escape this way…	BARRET
CLOUD	ん？あ、ああ……チェッ、いやに冷静なやつだな。どこかの誰かさんみたいだぜ
Nope. Have to find another way up, I guess…	RED XIII
[the movie continues]	なにか？
[Shinra S-27]	BARRET
[Shinra PA-86]	いや、なんでもねえよ。さて、どうするか……
[Shinra S-510]	TIFA
[Shinra SA-37]	BARRET！！
Turtle's Paradise Newsletter	BARRET
No. 2	TIFA！CLOUDは！？
The end of another hard day. Wouldn't you	TIFA
like to sit back with a tall cool one?	みんな、こっち！
You can at the Turtle's Paradise!!	BARRET
Stop in today!	ええ！？どうしたんだよ？CLOUDは？
There's nothing like	TIFA
a smooth one after work!	話は後！いいから早く！！
Shinra, Inc.	AERITH
Our slogan is:	はやく、ここから逃げなくちゃ……
Shinra's Future Is	CLOUD
The World's Future!!	反応がない……他のルートを探さなければ……
Mako Energy For A	ムービーへ続くのだ！
Brighter World!!	『　神羅　　Ｓー２７式　』
Control the bike with the [Directional buttons]	『　神羅　　ＰＡー８６式　』
 and save your friends in the truck	『　神羅　　Ｓー５１０式　』
from the Shinra pursuit troops.	『　神羅　　ＳＡー３７式　』
[OK]	【かめ道楽　通信】
Attack on right	ナンバー２
[SWITCH]	きびしい仕事で
Attack on left	おつかれのアナタ……
  [MENU]Menu	ぜひいちど
  [CANCEL]Form Party	居酒屋『かめ道楽』へ！！
[START]Start Game	仕事の後の
BARRET	一杯は最高ですよ！
Well, what do we do now?	神羅カンパニー
CLOUD	今週の標語
Sephiroth is alive. …I have to settle the score.	神羅の未来は
BARRET	世界の未来！！
Will that save the Planet?	魔晄の光で
CLOUD	明るい世の中！！}
…It seems so.	指示があるまで、ディスクホルダーを開けないで下さい
BARRET	バイクを【方向キー】で操作して
Then, I'm going!	神羅の追撃隊から
AERIS	仲間の乗るトラックを守って下さい
I'll go, too. There are things I need to know.	○ボタン
CLOUD	右の敵を攻撃する
About the Ancients?	□ボタン
AERIS	左の敵を攻撃する
…Many things.	△ボタン　　　メニュー
TIFA	×ボタン　　　パーティ編成
I guess it's good bye, Midgar.	スタートボタン　　ゲーム開始
BARRET	BARRET
We told AERIS's mom to go somewhere safe, so Marlene should be safe, too.	さて、どうするよ？
Yeah, she should be	CLOUD
Hmm, I don't know	セフィロスは生きている。俺は……あのときの決着をつけなくてはならない
AERIS	BARRET
She said she didn't want to stay in Midgar anymore. …Maybe it's for the best.	それが星を救うことになるんだな？
AERIS	CLOUD
Stop it, CLOUD! I'm worried, too.	……おそらく、な
AERIS	BARRET
You know what? This is the first time I've ever left Midgar…	おっし、オレは行くぜ！
Really? Are you worried?	AERITH
It's dangerous. Are you sure you want to go?	わたしも、行く。……知りたいこと、あるから
AERIS	CLOUD
A little…no, maybe a lot. But I have a bodyguard, right?	古代種のことか？
AERIS	AERITH
I thought you'd say that!	……いろいろ、たくさん
TIFA	TIFA
…I guess this is the start of our journey…	さらばミッドガル、ね
You hate traveling?	BARRET
It's dangerous. You sure you want to go?	AERITHのおふくろさんには安全な場所に移るようにって言っといたからマリンも安全だな
TIFA	そうだな
…I don't know. But, I don't have anywhere else to go. So I guess it doesn't really matter whether I like to travel or not.	さ～て、どうかな
TIFA	AERITH
…Hmm. But you know, it should be all right if you keep your promise.	もう、ミッドガルはイヤだって言ってた……ちょうど良かったかな
{Red XIII}	AERITH
I'm going back to my hometown. I'll go with you as far as that.	やめてよ、CLOUD！わたしだって心配なんだから
CLOUD	AERITH
Then…	そういえば、わたしミッドガル出るの、初めて……
Let's stay here for a while	そうか……不安か？
Let's go!	危険だぞ、いいのか？
BARRET	AERITH
To the Northeast, there's a town called Kalm.	ちょっと、う～ん、かなり、かな。でも、なんでも屋さんがいっしょだし、ね？
The food at the Inn's good. Why don't we head there first?	AERITH
AERIS	言うと思った！
You're right. I've heard about that town before. CLOUD?	TIFA
BARRET	……旅がはじまるのね
About Sephiroth, and about the crisis of the Planet…	旅はきらいか？
CLOUD	危険だぞ、いいのか？
You're right. We need to know where Sephiroth went.	TIFA
BARRET	……どうかな。でも、もう帰るところないもの。旅が好きとかキライとか関係ないわ
We need a leader for our journey. 'Course that could only be me.	TIFA
TIFA	……う～ん。でもほら、CLOUDが約束守ってくれればだいじょうぶよね、きっと
You think so?	RED XIII
AERIS	私は故郷に帰るつもりだ。それまではいっしょに行ってやる
I think it should be CLOUD.	CLOUD
BARRET	さて……
^#$^%…alright. Go Northeast to a town called Kalm. If something happens, we'll meet up there.	もう少しここにいよう
BARRET	行こうか！
'Sides, we can't have five people strolling around out there. It's too dangerous. Let's split into two parties…	BARRET
Access Menu with [MENU],	ここから北東に行くとカームって町があるんだ
Change with [CANCEL],	宿屋のメシがうまくてなあ。とりあえずそこに行かねえか？
End with [SELECT],	AERITH
AERIS	そうね。聞きたいこと、いろいろあるしね。CLOUD？
…That's an unexpected	BARRET
TIFA	セフィロスのこと、そして星の危機……
…combination.	CLOUD
TIFA	そうだな。セフィロスの行方の情報も必要だからな
Well, have fun…boys.	BARRET
TIFA	ここから先団体行動にはリーダーが必要だ。リーダーといえばオレしかいねえ
We'll see you at Kalm!	TIFA
BARRET	そうかしら……
…Thought you'd do that.	AERITH
BARRET	どう考えてもCLOUD、よね
Later, at Kalm!	BARRET
That's funny…I dropped the key to this gate…somewhere. Must've been on that excavation tour.	チッ…………わかったよ。ここから【北東にカームって町】があるんだ。何かあったらそこを集合場所にしよう