Wedge	ウェッジ
“CLOUD never came.”	「CLOUDさん
	こなかったっすね」
Biggs	ビッグス
“CLOUD…	「CLOUD……
Think he was killed?”	やられちまったのかな」
BARRET	BARRET
“No way!!”	「ケッ……！！
	あの野郎が金ももらわねえで
	いなくなるわけねえだろ！！」
Jessie	ジェシー
“CLOUD…”	「CLOUD……」
Biggs	ビッグス
“Say, do you think CLOUD's…	「なあ、CLOUDってさ…
going to stay on and fight	最後まで、おれたち…
for AVALANCHE!?”	アバランチのために
	戦ってくれんのか？」
BARRET	BARRET
“How the hell would I know!?	「さあな……
Do I look like a mind reader?”	知らねえよ」
“Hmph!!	「チッ！！
If y'all weren't such screw-ups…”	おまえらがもうすこし
	たよりになりゃよ……」
[EMPTY LINE]	「あんな野郎、やとわねえでも
	いいんだがな…」
Wedge	ウェッジ
“Hey, BARRET!	「あ、BARRETさん
What about our money?”	俺たちの給料……」
“Uh, nothin'…sorry.”	「や、なんでもないっす…」
	
Wedge	ビッグス
“CLOUD!!”	「CLOUD！！」
CLOUD	CLOUD
“Looks like I'm	「約束の時間に
a little late.”	遅れたようだ」
BARRET	BARRET
“You damn right, you're late!!”	「おい！　遅刻野郎！！」
“Come waltzin' in here	「ずいぶん派手な
makin' a big scene!”	おでましじゃねぇか」
CLOUD	CLOUD
“It's no big scene.	「そうでもない。
Just what I always do.”	ふつうだ」
BARRET	BARRET
“(*^%!”	「ケッ！！」
“Havin' everyone worried like that.	「心配させやがって
You don't give a damn 'bout	勝手な野郎だ！」
no one but yourself!”	
CLOUD	CLOUD
“Hmm…	「ほう……？
You were worried about me?”	心配してくれたのか」
BARRET	BARRET
“Wha!?”	「なにっ！！」
“That's comin' outta	「チッ…刻のぶんは
your share, hot shot! ”	報酬からひくからな」
BARRET	BARRET
“Wake up!”	「おい、おめえら！」
“We're movin' out!	「場所変えるぞ。
Follow me!”	ついてこい！」
Wedge	ウェッジ
“Hey, CLOUD!!	「あっ、CLOUDさん！！
You were great back there!”	おつかれっす！」
Biggs	ビッグス
“Heh heh…CLOUD!	「へへ……CLOUD！
We'll do even better next time.”	次の作戦も、がんばろうな」
Jessie	ジェシー
“Careful,	「あぶないから
I'll shut this.”	閉めとくね」
Jessie	ジェシー
“Oh, CLOUD!!	「やだ！　CLOUD！！
Your face is pitch-black…”	顔、まっくろ……」
Jessie	ジェシー
“There you go!”	「はい、できあがり！」
Jessie	ジェシー
“Say, thanks for helping me	「ね、魔晄炉で助けてくれて
back there at the reactor!”	ありがとう！」
CLOUD	CLOUD
“Yeah…”	「ああ……」
That's OK	気にするな
Quit thanking me	礼なんかやめてくれ
CLOUD	CLOUD
“Don't mention it.”	「気にするな。
	当然のことをしたまでさ」
CLOUD	CLOUD
“It bugs me when you thank me.	「感謝などされても困る。
It's just a part of my job.”	これも仕事のうちだからな」
Jessie	ジェシー
“But, I…	「でも、私……
I was just glad…”	ほんとにうれしかったから…」
Jessie	ジェシー
“CLOUD……”	「CLOUD……」
“You're right.	「そうだね、私たち
We're just partners.”	ただの仕事仲間ね…」
CLOUD	CLOUD
“It's not ready yet…	「まだできてないんだ…
Whoa!!”	ウオオ…！！」
Shut-off the switch in this position.	「このまま、スイッチをお切りください」
We can escape from the train event…	「列車イベントをぬけるのだが……」
Did it!!	大成功！！
4th failure	失敗４回目
3rd failure	失敗３回目
2nd failure	失敗２回目
1st failure	失敗１回目
Escaped	ぬけちゃう！
Last Train from Midgar	ミッドガル発最終列車
Inside Train	客車内
BARRET	BARRET
“Look…you can see the surface now.	「見ろよ…地上が見えてきたぜ。
This city don't have no day or night.”	ひるも夜もねえ、オレたちの街がよ」
“If that plate weren't there…	「ミッドガルのプレートさえなけりゃなぁ…。
we could see the sky.”	でっけえ空がおがめんのになあ」
CLOUD	CLOUD
“A floating city…	「空中に浮かぶ都市か……。
Pretty unsettling scenery.”	おちつかない風景だな」
BARRET	BARRET
“Huh?	「はあ？
Never expect ta hear that outta	あんたがそんなふうに感じるとはな」
someone like you.”	
“…You jus' full of surprises.”	「……意外だぜ」
BARRET	BARRET
“The upper world…a city on a plate…”	「上の世界……プレート都市……」
“It's 'cuz of that &^#$# 'pizza'	「あのくさったピザのせいで
that people underneath are sufferin'!”	下の人間がどんなに
	苦しんでることか……」
BARRET	BARRET
“All the pollution from Mako energy above	「上の世界で汚された魔晄エネルギーが
falls down on the world below.”	下の世界に降りてくる」
BARRET	BARRET
“And the city below is full of polluted air.”	「下の世界は今じゃあ
	汚された空気のたまり場だ」
BARRET	BARRET
“On top'a that,	「おまけに魔晄炉はどんどんエネルギーを
the Reactor keeps drainin' up	くみ上げちまう」
all the energy.”	
“Thanks to that, the land is dying.”	「おかげで土地は枯れる一方だ。
	空気をきれいにする力もなくしちまった」
CLOUD	CLOUD
“Then why doesn't everyone	「どうしてみんな上へ
move onto the Plate?”	移らないんだろう……」
BARRET	BARRET
“Dunno.	「さあな。
Probably 'cuz they ain't got no money.	金がないからだろ。
Or, maybe…”	いや、それとも……」
“'Cuz they love their land,	「どんなに汚れていても
no matter how polluted it gets.”	地ベタが好きなのかもな」
CLOUD	CLOUD
“I know…	「わかってるさ…。
no one lives in the slums	好きでスラムに住んでるやつなどいない」
because they want to.”	
“It's like this train.	「みんな、この列車とおなじ。
It can't run anywhere except	敷かれたレールには逆らえないんだ」
where its rails take it.”	
BARRET	BARRET
“Stop actin' like a damn kid.	「子供じゃねえんだ。
Siddown an' shu'up!”	じっとしてろよ」
Jessie	ジェシー
“Hey, CLOUD.	「ね、CLOUD。
You want to look at this with me?”	いっしょに見ない？」
“It's a map of the Midgar Rail System.	「ミッドガル列車路線図ディスプレイ。
Let's look at it together.	二人で見ればきっと楽しいと思うの。
I'll explain it to you.”	私、説明してあげるね」
To the Route Map Screen	『ルートマップ画面へ』
Jessie	ジェシー
“I like this kinda stuff.	「私、こういうの好きなのよ。
Bombs and monitors…you know,	爆弾とかモニタ画面とかハイテク関係」
flashy stuff.”	
Jessie	ジェシー
“I know!”	「そうだ、CLOUD」
“Next time,	「今度、私の手作り作品を
I'll make one just for you.”	プレゼントしちゃおうかな」
Thanks anyway	えんりょしとくよ
Looking forward to it	楽しみにしてるよ
Jessie	ジェシー
“Oh yeah, you might regret it.	「そう、きっと後悔するかもよ。
I'm the type who takes things personal.”	私、ズガッ～ンと根にもつタイプなの」
Jessie	ジェシー
“Okay, then I'll put a little extra effort in	「うん、じゃ、腕によりをかけて
and make it with a BANG.”	ドッカ～ンと制作するわ」
Jessie	ジェシー
“We're almost there.	「もうすぐ駅に着くね。
After talking with you,	CLOUDといっぱい話せて燃えたわ。
I'm ready to try!	私、導火線に火がついたかもよ」
I think you've lit my fuse!”	
Jessie	ジェシー
“Speak of the devil…”	「噂をすれば、ね」
“That light means that	「この光がＩＤ検知エリア通過の
we're in the ID Security Check area.”	サインなの」
“…whisper…whisper…	「ひそひそ……
(When the lights go off,	（暗くなるからチカンが多いのよ。
you never know what kind of	ＩＤ検知エリアは……）」
creeps'll come out.)”	
“…We're almost back now.	「ま、それはさておき。
What a relief.”	もうすぐ地上に帰れるってわけ。
	なんだか、ホッとするね」
Biggs	ビッグス
“This train hasn't switched	「まだ列車の非常警備体制には
to security mode yet.”	移行してないみたいだな」
“I'm sure that will change by tomorrow.”	「明日はそうはいかないだろうけどな」
Biggs	ビッグス
“…YAWN…that sure took its toll on me.	「さすがにつかれたよ。
I'm gonna sleep till we get to the station.”	駅に着くまで、眠らせてくれ」
Biggs	ビッグス
“…snore…heebeebeeheebee…snore…	「スースー……ムニャムニャ…。
(Don't act so damn big,	（BARRET、いばってんじゃねえぞ…）」
BARRET…snooze…)”	
Wedge	ウェッジ
“Someday AVALANCHE's gonna be famous	「アバランチで名をあげて
…and me, too!”	いつか俺だって……っす！」
Wedge	ウェッジ
“CLOUD!!”	「CLOUDさんっ！！」
“Don't ya think I got a bright	「俺にも明るい未来がまってるっすよね？」
future ahead of me?”	
What do you have in mind?	なにを期待してる？
Don't hold your breath	無理だな
Wedge	ウェッジ
“All my life, I felt like nothin' but a sidekick.”	「俺、いままでずっと人生ワキ役って
	感じで生きてきたっすよ」
“But, after joinin' AVALANCHE and	「でも、アバランチにはいって、星の生命を救えば
tryin' to save the Planet,	こんな俺でも……いろいろとね」
I feel like I can do lots of things.”	
Wedge	ウェッジ
“Oh man,	「ああ、ひどいなあ、CLOUDさん。
that's pretty harsh. CLOUD.	やっぱダメっすかね、そうすかね」
You really think I won't?”	
Wedge	ウェッジ
“I'm seein' stars.	「目がチカチカしたっす。
This sucks. I hate the dark.”	俺、暗いのだめっす。苦手っす」
Last Train from Midgar	路線図
Jessie	ジェシー
“CLOUD!	「さ、CLOUD！
Look over here.”	こっちむいて」
Jessie	ジェシー
“Okay, it's about to start.”	「さ、はじめるわよ」
Jessie	ジェシー
“This is a complete model	「これが魔晄都市ミッドガルの
of the city of Midgar.”	全景フレームモデルね」
“It's about a 1/10000 scale.”	「スケールはだいたい１／１００００って
	とこかな」
“The top plate is about 50 meters	「上のプレートは、地上から
above ground.”	約５０Ｍ離れているの」
“A main pillar supports	「プレートを支えてるのは中心の大きな支柱と
the plate in the center,	各区画に建てられた柱……。
and there are other support pillars	柱は、機械塔とも呼ばれてるわ」
built in each section…”	
“Psst…whisper…whisper…	「ヒソヒソ……
(The No. 1 Reactor we blew up	（爆破した壱番魔晄炉が北のはずれにあるの）」
was in the northern section.)”	
“Then there's No. 2, No. 3 all the way up to	「そこから順番に２、３……８番魔晄炉まで」
the No. 8 Reactor.”	
“The 8 Reactors provide Midgar	「８つの魔晄炉がミッドガルの電力供給を
with electricity.”	支えているのよ」
“Each town used to have a name,	「それぞれの街には、名前もあったんだけど
but no one in Midgar remembers them.”	ミッドガルに住む人は誰も覚えちゃいないわ」
“Instead of names, we refer to them	「名前なんかより、番号で呼ぶの。
by numbered sectors.	そういうところなのよ、ここは」
That's how things turned out.”	
Jessie	ジェシー
“Phew, look what's	「ふぅ…、次はこれ！
next! Look!”	ほら、見て」
Jessie	ジェシー
“This is the route this train is on.”	「私たちがいま乗ってる列車のルートが
	これよ」
“The route spirals around	「プレートを支えている大きな柱に
the main pillar.”	螺旋状にレールが通っているの。」
“We should be coming around	「いまは柱のちょうど真ん中あたりね」
the center, right now.”	
“Each checkpoint has	「各通過ポイントにはＩＤ検知エリアが
an ID sensor device.”	設置されてるの」
“It checks the identities and	「乗客すべての身分やなにから全部！
backgrounds of each	神羅ビルのホストコンピュータと連動して
passenger on the train	チェックされちゃうわけよ」
and is linked up to the central data	
bank at Shinra headquarters.”	
“Whisper…whisper…	「ひそひそ……
(We definitely look suspicious,	（私たちはどう見たって不審人物だから
so we're using fake IDs.)”	ニセのＩＤで通過してるの）」
Sector 7 Station	７番街スラム駅
	
BARRET	BARRET
“Yo!!	「おう！！
Get over here, all'ya!!”	みんな、集まれ！！」
BARRET	BARRET
“This mission was a success.	「今回の作戦は成功だ。
But don't get lazy now.”	だがな、気を抜くなよ」
“The hard part's still to come!	「本番はこれからだ！
Don't y'all be scared of that explosion!”	あんな爆発でびびるな！」
BARRET	BARRET
“Cause the next one's	「次はもっと派手にかますぞ！」
gonna be bigger than that!”	
BARRET	BARRET
“Meet back at the hideout!!	「アジトに集合だ！！
Move out!”	いくぞ！」
BARRET	BARRET
“Yo, CLOUD!	「よう！CLOUDさんよ！
You lissen up!”	あんたも聞いとけ！」
BARRET	BARRET
“Yo! What're ya doin' now?”	「おう！！
	なにしてやがる！」
Biggs	ビッグス
“uh, BARRET…	「あ、BARRET…
We, uh…”	おれたち……」
Wedge	ウェッジ
“We can't do it.	「ダメだったっす。
We just can't do it.”	俺たちには、できないっす」
Jessie	ジェシー
“Don't worry!	「気にしない！
Don't get all worried!”	気にしない！」
Jessie	ジェシー
“CLOUD!	「CLOUD！
Let's make the mission work!”	作戦がんばろうね！」
Jessie	ジェシー
“CLOUD?	「ね、CLOUD？
When this mission's over…”	作戦終わったらさぁ」
“Why don't all of us take a long vacation.	「みんなでお休みとって
Maybe we could go to a hot springs somewhere?”	温泉でもいかない？」
Yeah…	ああ……
I don't know…	わからないな
CLOUD	CLOUD
“Yeah…	「ああ……。
If I feel like it.”	気がむいたらな」
Jessie	ジェシー
“Alrighty then!	「うん！
It's a date!”	CLOUD、約束ね」　
CLOUD	CLOUD
You never know what lies ahead.	「先のことなんか、わからないな」
Jessie	ジェシー
…how lovely.	「……いいわ」
“I might just have to tempt you, then.”	「またそのときになったら
	誘惑する」
BARRET	BARRET
Yo, you all done flappin' your gums!?	「よし、気がすんだか！！」
“Go!	「いけ！
Get on that train!”	列車にのりこめ！」
TIFA	TIFA
“CLOUD…	「ね、CLOUD。
Don't be so distant.”	あんまり冷たくしないで」
“Everyone wants to be your friend.	「みんな、CLOUDと
I'm sure…”	仲良くなりたいんだよ。
	きっと…」
BARRET	BARRET
“Damn, man!!	「ケッ！！
I'm here to fight!”	オレたちは戦ってんだぞ！」
“Don't care 'bout bein' nobody's friend.”	「ともだちになることなんか
	ねえんだ」
BARRET	BARRET
“Let's go!	「オレたちもいくぞ！
Don't be late!”	遅れんな」
My husband never came back.	夫は帰ってこなかった。
I wonder if something happened to him?	夫の身になにかあったんだろうか？
No, I'm sure his leave was just canceled.	いや、休暇が取り消しになっただけかもしれない。
I went to the station everyday.	それからわたしは毎日駅へ行ったんだ。
Then, one day…	ある日……
“You used to see that kind of thing	「戦争中はよくある風景だったね。」
a lot during the war.”	
Please take AERIS somewhere safe.	AERISを安全なところへ。
That's the last thing she said before she died.	そう言い残して彼女は死んだ。
My husband never came back, and I had no child.	わたしの夫は帰らず、子供もいない。
I think I must have been very lonesome.	わたしもさびしかったんだろうね。
So I took AERIS home with me.	AERISを家に連れて帰ることにしたんだ。
	
“I'm not letting you go tonight.”	「今夜は帰さないよ」
“Wow!”	「エェ！」
“Isn't there somewhere	「ね、どっかで休んでいこう」
we could go to be alone?”	
“There's only the train graveyard around here.	「でも、このあたり
And they say there's ghosts around too!”	列車基場しかないし。
	オバケでるっていうし」
“…damn.”	「……しまった」
“What?”	「え？」
“Hey, come over here.”	「ね、もっとそばにおいでよ」
“But people will…”	「だって…」
“Who cares?”	「いいだろ？」
“But…	「でも…
There's a weirdo over there.”	そこの変な人」
“Huh?”	「ん？」
“Say, you're pretty gutsy.”	「きみ、ずいぶん
	どうどうとしてるね」
“Why don't you go snoop somewhere	「のぞきはえんりょして
else, Romeo?”	くれないかな？」
“I've had it!”	「僕、もうたえられない」
“Me too.”	「いいわ…
	わたしもよ」
“You know this is the first time	「はじめてだね。
we've ever agreed on something.”	意見があったの…」
“Yes…”	「ええ…」
“Well then, shall we?”	「それじゃ…」
“urggh…”	「グゥグゥ……」
“…huff…wheez”	「スゥスゥ……」
“When you've been a train man as long as I have,	「長い間、駅員をしてますとね。
you see a lot of people	いろんな人生の場面を目撃することになります」
and a lot of lives.”	
“People meeting, parting, joy, sadness…	「出会い、別れ、よろこび、悲しみ……
After a while,	少々のことじゃおどろきません」
it doesn't even get to you anymore.”	
“I wonder how long it's been…	「いつごろからですかね…。
There's an invisible rail	お客さんと私の間にね
between me and the passengers.”	見えないレールを敷いてしまうんですよ」
“I could never live their lives.	「お客さんの人生には立ち入らないようにね。
I'm just a train man plain and simple.	私なんぞは、ただの駅員。
It's easier that way.”	そういう生き方が楽なんですかね」
“That's not to say that the crossing gate	「それでもね、心のふみきりが
of my heart doesn't hurt now and again.”	痛むときはありましたよ」
“Back during the war, I remember there	「戦争中のことでしたね。
was a lot of painful scenes then.”	あのころは、つらい場面が多かったです…」
“But, that's a story for	「いや、その話は
another day…”	またの機会に……」
“First train leaves Midgar at 05:04am.”	「始発の出発時刻は
	ミッドガル時０５時０４分になります」
“Morning.	「おはようございます。
Dawn comes and things never change.”	一夜明けても、あいかわらずですね」
“You be careful not to get hurt.	「けがしないよう、お気をつけて。
Come on back again, hear?”	いってらっしゃい」
“ALL ABOARD!	「さあ、おはやく御乗車ねがいます。
The train is about to depart.”	もうすぐ出発しますよ」
“I heard a rumor	「プレートが落ちるって噂を聞きましたです。
that the plate was going to fall,	長年親しんだこの駅ですから
crushing this station,	どうしてもはなれられません……」
I've worked at so many years.”	
“But I just can't bear to leave here.”	「いったい、どうして……？
	うそであってほしいです」
Sector 7 Slums	７番街スラム
	
BARRET	BARRET
“Don't get all slaphappy just 'cause	「作戦ひとつうまくいったぐらいで
today's mission went well!!”	うかれてんじゃねえぞ！！」
BARRET	BARRET
“Yo, CLOUD!	「おい、CLOUD
Over here, now!”	こっちだ！」
Sector 7 Mechanized Tower	７番街機械塔
Sector 7 Slums	７番街スラム
	
BARRET	BARRET
“All right!!	「よし！！
You losers go on ahead!!”	おめえら、先入ってろ！！」
BARRET	BARRET
“OK!	「よし！
Go on ahead.”	先に入ってろ」
BARRET	BARRET
“Heh heh…”	「へへ……」
“You wanna meet your little baby?”	「幼なじみにはやく会いてえか？」
Little baby?	幼なじみ？
Out of my way!	そこ、どいてくれ
BARRET	BARRET
“Heh!	「ヘッ！
Jus' calm down.”	まあ、落ちつけよ」
“Can't have people suspectin' us.”	「街のやつらにあやしまれると
	まずいからな…」
BARRET	BARRET
“Hey!	「ヘッ！！
Don't act like you don't know what I mean!”	とぼけちゃってよ」
“I'm tellin' you…”	「いいのかねえ…」
BARRET	BARRET
“You! CLOUD!!	「よう！！　CLOUD！！
Get off your slow-movin' ass!!”	チョロチョロすんじゃねぇ！！」
BARRET	BARRET
“The hell're you doin', boy?	「なにやってんだ！！
The operation's already started!!”	作戦は始まってんだぞ！！」
“I'm not opening up.	「開けないよ！！
Go away!!”	帰ってちょうだい」
“Oh &$#&@!!	「まったくよぉ！！
What the hell's wrong tonight!!”	今夜はどうなってんだかよ！！」
“I thought that long blackout	「さっきまでずいぶん長く停電してたから
was strange.”	みょうだと思ってたらよ」
“They say a Mako Reactor was	「上で、魔晄炉爆破テロがおきたって
destroyed above.”	いうじゃねぇか」
“I was jes sittin' here drinkin',	「酒かっくらいながら、ニュースを見てりゃよ。
watchin' the news by myself.	突然、店を追い出される。
n' all of a sudden	たまんねぇよなぁ！！」
I get kicked outta the &*%$ store.	
What's up with that!?”	
“Woo…ah geez, I'm blitzed.	「ウウ……よっぱらっちゃった。
I jes love them homemade cocktails.	手作りカクテル、おいしいんだもんなあ。
But they sure do creep up on ya.”	きついんだもんなあ」
“Did you hear?”	「ねぇ、ねぇ、知ってる？」
Don't care	興味ないね
No, what?	知らないよ
“There's a news update.	「ニュースの速報が入ったのよ。
They say that there was a terrorist explosion	上で爆弾テロがあったっていうじゃない。
up above, and that this time	それも、魔晄炉の爆発！！」
it was a Mako Reactor!!”	
“You know what this means?”	「これがどんなに大変なことかわかる？」
Don't care	興味ないね
No, what?	わからないよ
“Ya see, I keep on top of these things,	「事情通の私にいわせればね」
an' if ya ask me…”	
“if you knock out Midgar's power,	「ミッドガルの電力がマヒしちゃったら
then all of its computers and signals are	コンピューターとか信号とか
going to be knocked out, too.”	いろいろ止まっちゃうじゃない」
“Financially there must've been about	「経ざい的損失は、ん～～
a billion gil worth of damage.”	１０億ギルはくだらないし」
“An' that ain't all!!	「それに！！
A lotta innocent people got killed, too!”	たくさんの罪なき人々が死んだと思うのよ」
“If the explosion had been in the middle	「爆破が真夜中だったから、まだいいわ。
of the night, that woulda been one thing.	眠ってた人はそのまま目が覚めないだけね」
At least the people coulda gone in their sleep.”	
“This Mako explosion has really	「とにかく、魔晄炉の爆発でミッドガルは
sent Midgar into a fit.”	大混乱らしいの」
“Oh, well excuse ME!”	「あ、そ！」
“Explosions! Explosions!	「爆発！！　爆発！！
Oh Man!	スゲッー！
AVALANCHE is so cool!”	アバランチ、かっくいー！」
“Hey!!	「あっ！！
Heh heh heh…	ウヘヘヘヘ……
Say, you're kinda cute.	やっぱ、かわいいなぁ。
Cutie pie…”	マイラブリーエンジェルちゃん…」
“I wasn't even done with my drink.	「酒、飲みかけだったのによ。
I didn't even pay my bill…”	あっ、かんじょうもまだだ…」
“All's quiet!!	「異常なし！！
Shh, I'm spying now!”	ただいま、スパイ中！」
“OH!!	「ああ！！
There's something!!	なんか、でてきました！！
DANGER!!  ALERT!!”	報告～！！　報告～！！」
“Did you hear?”	「あなた、知ってる？」
Bout what?	なにを……
Don't care	興味ない
“About that little girl named TIFA	「あのTIFAちゃんのお店のことよ。
and that bar called '7th Heaven'.”	『セブンスヘブン』って酒場」
“I'm not only informed, I'm kinda nosey too.	「私は事情通のうえに、おせっかいだから
Anyhow, I got the scoop.”	いろいろ知ってるのよね」
“You wanna hear?”	「聞きたいでしょう？」
You bet!	すごく聞きたい
Don't care	興味ない
“That BARRET and	「あの酒場の名物BARRETと手下の３人。
three of his henchmen	ときどき、こうなのよ」
are like this sometimes.”	
“Suddenly, they throw out a customer and	「突然、お客を追い出して
start talking trash to him.	ゴチャゴチャやってるの。
It's strange, if you ask me.	なんか、あやしいのよ。
And that place always smells like gun powder.”	火薬のにおいとかするのよね」
“It's dangerous, I tell you.	「危ないわ。
They must be doing terrible things in there.”	きっと、いけないことをしてるにちがいないわ」
“Oh really?	「あ、そ！
Well, aren't you a cool one!”	あなたってクールなのね」
“There's a TV in there, but	「この家にはテレビがあんだけどよ。
my cheap aunt won't let me in the house.	ケチなおばさんがいれてくんねぇのさ。
Look for yourself.”	まあ、見てろって」
“Now that you mention it,	「そういえばよ。
there used to be an outside TV monitor	この７番街スラムにも
here in the slums.”	街頭テレビがあったんだけどよ」
“But that BARRET,	「そいつをぶっこわしたのがあのBARRETさ」
busted it up.”	
“Shot it up with that	「ガンガンガンガンガンガン！！
weird machine gun hand of his.	って、例の腕ガンでいきなりだぜ！」
Blam, blam, blam.”	
“I think it was when President Shinra was on.”	「あんときは、たしかプレジデント神羅が
	出演してたな」
“He was on again this morning, too, you know.”	「今日のニュースでもプレジデント神羅が
	出るだろうからよ」
“TIFA better	「こりゃ、TIFAちゃんのお店のテレビも
watch out for her TV. ”	やばいかもな」
“Hey!! Open up!	「ヘイ！！　あけてくれってんだよ！
C'mon baby!!”	ベイビー！！」
“It's me! Johnny!	「俺だよ！　ジョニーだよ！
Mom!!”	かあちゃ～ん！！」
“SHHH!!	「おい！！
Wait a minute!!”	ちょっとまてよ！！」-
Johnny	ジョニー
“I thought you were something	「おまえ、ただもんじゃねぇと思ったが
a little better than this,	幼なじみだったのかよ…」
but you're just a punk kid after all.”	
“Just what the hell do you think	「俺のTIFAちゃんと……
you're doing	そんで、お前は俺のTIFAちゃんの
with my little TIFA?”	いったいなんなんだよ」
“And now?”	「いまはさ？」
We're just friends.	ただの幼なじみだ
What's it to you?	おまえたちには関係ないだろ
“But TIFA doesn't think so.”	「でもよ、TIFAちゃんは
	そう思ってねぇぜ」
“Why does she ask you n' not me?”	「なんで、俺じゃなくて
	お前にたのむんだよ」
“If TIFA's in trouble	「TIFAちゃんが困ってんなら
then I'LL help her.”	俺が助けんだ！」
“But then I guess not.	「だけど、そうはいかねぇよな。
She's nothing to me.”	俺にはなんもねぇ」
“Not those memories beneath	「星空の下の思い出も
the stars when we were kids	子供のころの夢の話もな」
or all the stuff we talked about.”	
“About all I got is the sake	「せいぜいあるのは、毎日お店に通って
that she poured me everyday	お酒ついでもらったことぐらいさ」
I went to the bar.”	
“Crap!”	「くやしい！」
“Hey! You!	「おい！　幼なじみ！
Don't think you can just walk outta here	このまま立ちさるなんてゆるさねえ！」
like that!”	
“Shhi-! You busted a promise!!	「クッ～！！　約束かわしたんだろ！！
n' you made TIFA cry!!”	TIFAちゃんを泣かせんなよ！」
Johnny	ジョニー
“Oh yeah!?”	「そうかよ！！」
“That may be but you ain't walkin' away	「でもよ
from here!”	このまま立ちさるなんてゆるさねえ！」
“Urgh! You made a promise, didn't ya!?	「んがっ～！　約束したんだろ！！
n' don' you fergit that TIFA	TIFAちゃんは
like an angel.	スラムの街の天使だってこと忘れんなよ！」-
An angel of this slum!”	
Johnny	ジョニー
“I'm leaving. Goin' faraway.	「俺、男をみがく旅に出っからよ！
But when I come back	これで、さよならだぜ！」
I'll be a better man! This is goodbye!”	
“Hey! Childhood friend!	「やい！　幼なじみ！！
You better take	TIFAちゃんを大切にな！」
good care of TIFA!”	
“Cause, I'll be back!!	「ぜ～ったい、もどってやれよ！！
Don't make her cry, dammit!!”	いいな、泣かせんなよ！！」
“I'll be back, I say!!	「ぜ～ったい、もどってやれよ！！
n' don' fergit it!”	いいな、忘れんなよ！！」
“I hope he doesn't get hurt.”	「ジョニー、悪い女にだまされたり
	しなけりゃいいけど」
“That worries me the most.”	「それだけが、気がかりだなあ」
“Ah…Johnny's gone.	「はぁ……　ジョニーのやつ、行っちまった。
You look a little disappointed.”	なんだか急にはりあい
	なくなっちゃったよ」
“I don't like to say it myself but,	「俺って自分で言うのもなんだけど
I'm just a lonely guy	酒飲んでないと、さびしがりやさんなわけよ」
when I'm not drinking.”	
“Yesterday, everyone in town was	「きのう、お店の外からあなたたちのこと
peeking at the two of you	街のみんなでのぞき見してたのよ」
from outside the bar.”	
“TIFA's childhood friend.	「TIFAちゃんの幼なじみだなんて
That's a good one!”	にくいにくい！」
“Listen!	「もう！！！
If there isn't anyone to listen,	話を聞いてくれる人がいないと
what's the use of	情報を集めてもしかたないのよね！」
getting gossip on everyone!?”	
“Yeah, and you Mr. I-don't-care!”	「そうだ、あなた！
	興味ない男さん！」
“I'll get a little more information that would	「今度はきっと、あなたでも興味のわく
pique even your interest.	すご～い情報を集めておくから
You wait and see!”	楽しみにしておいて」
“H, hey!!	「おっおい！
Keep your mitts off of Marlene!!”	マリンちゃんには
	手を出すなよ！！」
“Ahh!	「あ～あ！
Now I ain't got no one to pick on!”	いじめる相手が
	いなくなっちゃうよ！」
“When it comes down to it…I'm gutless.	「ああ～、いざとなると勇気がでない。
I'm still just a no-good kid.”	だめだな、ボクって。
	まだ子供だな～」
“We're closed today.	「本日は閉店いたしました。
Come back tomorrow.”	またのご来店をおまちしております」
“Don't be taken in by the Shinra.	「神羅にだまされるな！
Mako energy will not last forever.	魔晄エネルギーは永遠ではない！
Mako is the life of the Planet	魔晄は星の命！
and that life is finite.	いつか終わりがやってくる！
The end is coming.	
Saviors of the Planet:  AVALANCHE”	星の救世主：アバランチ」
CLOUD	CLOUD
“What crappy handwriting.	「きたない字だな。
And look at all this graffiti!”	おまけに、いたずら書きだらけだ」
7th Heaven	セブンスヘブン
	
“Papa!!”	「とうちゃん！！」
“Marlene!	「ほら、マリン！
Aren't you going to say anything	CLOUDに
to CLOUD?”	おかえりなさいは？」
“Welcome home, CLOUD.	「おかえりなさい、CLOUD。
Looks like everything went well.”	作戦はうまくいったみたいね」
“Did you fight with BARRET?”	「BARRETとはケンカしなかった？」
Yeah	やっちゃった
Not this time	ガマンした
“I should have known.”	「やっぱり？」
“He's always pushing people around,	「BARRETはあんな人だし
and you've always been in fights	CLOUDは子供のころから
ever since you were little.”	ケンカばかりしてたしね」
“I was worried.”	「……ちょっと、心配だったんだ」
“Hmm.	「ふ～ん。
You've grown up.	CLOUDもおとなになったのね。
When you were little you used to get into	子供のころは、すぐケンカだったのに」
fights at the drop of a hat.”	
“Enter name”	『TIFA名前入力』
TIFA	TIFA
“Flowers?	「あら？
How nice…”	お花なんてめずらしいわね」
“You almost never see them	「スラムじゃ、めったにさかないのよ」
here in the slums.”	
TIFA	TIFA
“But…”	「でも……」
“A flower for me?	「プレゼントに、お花なんて
Oh CLOUD, you shouldn't have…”	CLOUD、そうなんだ～」
CLOUD	CLOUD
“…”	「そんなんじゃないさ」
Give it to TIFA	TIFA、あげる
Give it to Marlene	マリン、あげる
TIFA	TIFA
“Thank you, CLOUD.	「ありがとう、CLOUD。
It smells wonderful.”	ん～、いいかおり！」
“Maybe I should fill the store	「お店を花でいっぱいに
with flowers.”	しちゃおうかな」
Thudthudthud!!	『ドカドカドカ！！　というＳＥがはいるよてい』
Marlene	マリン
“Papa, welcome home!”	「とうちゃん、おかえり！」
TIFA	TIFA
“You all right, BARRET?”	「BARRET、ごくろうさま」
BARRET	BARRET
“Great!!”	「おう！！」
BARRET	BARRET
“Get in here, fools!!	「おめえら！！
We're startin' the meetin'!!”	会議をはじめっぞ！！」
TIFA	TIFA
“Everyone is down below.”	「みんなは下にいるわよ」
BARRET	BARRET
“Yeah.”	「おう、ただいま」
BARRET	BARRET
“Huh?	「ん？
Where'd you get that flower?”	どうしたんだ、その花は？」-
Marlene	マリン
“CLOUD gave it to me.”	「……CLOUDにもらったの」
BARRET	BARRET
“Oh…”	「そうか……」
BARRET	BARRET
“Did you thank him?”	「マリン、ありがとうは
	言ったのか？」
Marlene	マリン
“…”	「…………」
Marlene	マリン
“Thank you, CLOUD.”	「お花、ありがとうね、CLOUD」
“We'll take care of you.”	「ちゃんとお世話するからね」
TIFA	TIFA
“CLOUD…	「CLOUD……
come over here.”	こっちにきて」
TIFA	TIFA
“Sit down.”	「どうぞ、すわって」
TIFA	TIFA
“How about…	「ねえ……
…something to drink?”	何かのむ？」
I don't feel like it	いまはそんな気分じゃないな
Give me something hard	キツイの、くれないか
TIFA	TIFA
“OHH!!”	「も～う！！」
“I can make a drink just	「私だってちゃんとお酒ぐらい
as good as anyone else.”	つくれるようになったのよ」
“Everyone says my drinks taste the best!”	「お客さんだって、TIFAちゃんの
	つくるお酒はおいしいよって
	いってくれるんだから！」
TIFA	TIFA
“Just a minute.	「まってて。
I'll make one for you.”	いまつくるから」
TIFA	TIFA
“You know, I'm relieved you made it back	「なんだか、ほっとしちゃった。
safely.”	CLOUDが無事もどってきて」
CLOUD	CLOUD
“What's with you all of a sudden?	「急にどうした？
That job wasn't even tough.”	あのていどの仕事、なんでもないさ」
TIFA	TIFA
“I guess not…”	「そうね……」
“You were in SOLDIER.”	「CLOUD、ソルジャーに
	なったんだもんね」--
TIFA	TIFA
“Make sure you get your pay	「……今回の報酬なんだけど
from BARRET.”	BARRETからもらってね」
CLOUD	CLOUD
“Don't worry.	「そうするよ。
Once I get that money, I'm outta here.”	報酬をもらえば、また、お別れだな」
TIFA	TIFA
“CLOUD.	「ねえ、CLOUD。
Are you feeling all right?”	気分はどう？」
CLOUD	CLOUD
“…Yeah…	「……ふつうさ。
Why?”	どうしてそんなことを聞く？」
TIFA	TIFA
“No reason.	「ううん、なんでもない。
You just look a little tired I guess.”	ただ、つかれてないのかなって…」-
TIFA	TIFA
“You'd better go down below.”	「みんなのところに行ってあげて」
AVALANCHE Hideout	アバランチアジト
	
BARRET	BARRET
“Yo, CLOUD!	「おい、CLOUDさんよ。
There's somethin' I wanna ask ya.”	聞きたいことがあるんだ」
“Was there anyone from SOLDIER	「きょう、オレたちが戦った相手に
fighting us today?”	ソルジャーはいたのか？」
CLOUD	CLOUD
“None.	「いや、いなかった。
I'm positive.”	それは確実だ」
BARRET	BARRET
“You sound pretty sure.”	「ずいぶんと自信たっぷりじゃねえか」
CLOUD	CLOUD
“If there was anyone from SOLDIER	「もしソルジャーと戦っていたら
you wouldn't be standing here now.”	あんたたちが生きてるはずないからな」
BARRET	BARRET
“Don't go thinkin' you so bad jus' cuz	「自分が元ソルジャーだからって
you was in SOLDIER.”	えらそうに言うんじゃねえよ！」
CLOUD	CLOUD
“…”	「…………」-
BARRET	BARRET
“Yeah, you're strong.”	「確かにおまえは強い」
“Probably all them guys in SOLDIER are.”	「おそらくソルジャーってのは
	みんな強いんだろうさ」
“But don't forget that	「でもな、おまえは
your skinny ass's workin'	反乱組織アバランチにやとわれてる身だ。
for AVALANCHE now!	神羅のかたを持つんじゃねえ！」
Don't get no ideas	
bout hangin' on to Shinra.”	
CLOUD	CLOUD
“Stayin' with Shinra?	「神羅のかたをもつ？
You asked me a question	俺はあんたの質問に答えただけだ」
and I answered it…that's all.”	
CLOUD	CLOUD
“I'm going upstairs.	「俺は上で待っている。
I want to talk about my money.”	報酬の話がしたい」
TIFA	TIFA
“Wait, CLOUD!”	「待って、CLOUD！」
BARRET	BARRET
“TIFA!	「TIFA！
Let him go!”	そんなヤツ放っておけ！」
“Looks like he still misses the Shinra!”	「どうやら神羅に
	未練タラタラらしいからな！」
CLOUD	CLOUD
“Shut up!”	「だまれ！」
“I don't care about neither Shinra	「俺は神羅にもソルジャーにも
nor SOLDIER!”	未練はない！」
“But don't get me wrong!”	「でも、かんちがいするな！」
“I don't care about AVALANCHE or	「星の命にも
the Planet for that matter!”	おまえたちアバランチの活動にも
	興味はない！」
Wedge	ウェッジ
“You think I'm a little too uptight?”	「もしかして、俺、カタマってます？」
Yeah…	ああ……
No…	いや……
“The next mission will be	「次の作戦は、五番魔晄炉爆破！！
to blow up the Sector 5 Reactor.”	俺、緊張しちまって、ガチガチなんすよ」
“CLOUD, you're great!	「CLOUDさんは、さっすがすね～。
Don't you ever get nervous?”	ぜんぜん緊張とかしないでしょ？」
“Or are you like, impervious to feelings?	「もしかして何も感じないとか？
Naw, that couldn't be it.”	エヘヘ…そんなわけないっすよね」
“Well, that's OK. Don't worry about me.	「いや～、いいっすよ。
I don't look like it,	気を使ってくれなくても。
but I'm a coward at heart.”	俺、体に似合わず、小心者っすから」
Wedge	ウェッジ
“…CLOUD.”	「……CLOUDさん」
“You say you don't care,	「興味ないとかいいながら…
but you came to talk to me.”	俺に話しかけてる」
“CLOUD…	「CLOUDさん……
You just want friends.”	ほんとは友だちほしいんっすよね」
“Isn't that right?”	「ね、そうなんでしょ？」
Blow off	冗談じゃない
I really don't care	やっぱり興味ない
“Yeah, well.	「そうかなあ。
You look kind of lonely to me.”	なんか、さびしそうなんだけど」
“If you ever got anything you want to	「俺みたいなのでよかったら
get off your chest,	いつでもＯＫっすから」
you can always talk to me.”	
“You're terrible.	「ひどいなあ。
Real cold-blooded.”	冷たいなあ」
Jessie	ジェシー
“Oops…”	「うかつ……」
“Hey, look at the news…	「見てよ、このニュース……。
What a blast.”	こんなに爆発してる」
“Think it was all because of my bomb?	「やっぱり、私の爆弾のせい？
But all I really did was just make it	でも、このコンピューターの指示通り
like the computer told me.”	作っただけなのに」
“Oh no!	「やだ！
I must've made a miscalculation somewhere.”	どっかで計算まちがったかしら」
Jessie	ジェシー
“Hey, that was my first bomb.	「でも、私の爆弾の晴れぶたい。
Makes me kinda proud.”	ちょっと、うれしいんだ」
Jessie	ジェシー
“Money…”	「報酬……」
“Oh my.	「ああ、まいったわ。
It must have been for a lot of it.”	たしか、高額って約束よね」
“Sure!	「う～ん！
Well, what the hell? It's a verbal agreement.	ま、いいか、口約束だし。
Now let me figure this out.”	さ、計算しなきゃ…」
“Oh stop it, CLOUD!	「やだ！　CLOUD！
Did you hear me?”	聞こえちゃったかしら」
President Shinra	プレジデント神羅
“…today the No.1 Reactor was bombed.	「……壱番魔晄炉破壊事件に関して
The terrorist group AVALANCHE has claimed	アバランチと名乗る組織から
responsibility for the bombing.”	犯行声明が出されています」
“It is expected that AVALANCHE will	「声明によるとアバランチは
continue its reign of terror.”	今後も同様のテロを続けることを
	予告しております」
“But citizens of Midgar, there is no	「しかし、ミッドガル市民のみなさん
need to fear.”	安心して下さい」
“I have immediately mobilized SOLDIER to protect	「我々神羅カンパニーはこのような
our citizenry against this senseless violence.	暴力からみなさんを守るために
Thank you and good night.”	ソルジャーの投入を決定しました。
	これで……」
Marlene	マリン
“Papa,	「とうちゃ～ん
you're so great!”	かっこいい！」
BARRET	BARRET
“Shucks!!	「チッ！！
…money…”	……………ほ、報酬かよ…」
TIFA	TIFA
“Straighten things up	「みんなには、あやまっておくね」
with everyone for me.”	
“Save Point”	【セーブポイント】
“Access the menu	「メニューを開いて　セーブ　を選ぶと
and select [SAVE] to save your game.”	ゲームの状態を保存できます。」
TIFA	TIFA
“Listen, CLOUD. I'm asking you.	「CLOUD、おねがい。
Please join us.”	力をかして」
CLOUD	CLOUD
“Sorry TIFA…”	「TIFA……わるいけどさ」
TIFA	TIFA
“The Planet is dying.	「星が病んでるの。
Slowly but surely, it's dying.”	このままじゃ死んじゃう」
“Someone has to do something.”	「誰かがなんとかしなくちゃならないの」
CLOUD	CLOUD
“So let BARRET and his buddies	「BARRETたちがなんとかするんだろ？
do something about it.	俺には関係ないさ」
It's got nothin' to do with me.”	
BARRET	BARRET
“You damn right we'll do something about it.	「ああ、オレたちがなんとかする。
N' you stay outta this TIFA!”	TIFA、もうやめとけ」
President Shinra	プレジデント神羅
“The terrorist group called AVALANCHE	「……壱番魔晄炉破壊事件に関して
has claimed responsibility for today's bombing	アバランチと名乗る組織から
of the No. 1 Mako Reactor.	犯行声明が出されています。
It is also predicted	声明によるとアバランチは
that they will continue with similar terrorist	今後も同様のテロを続けることを
activities in the future.”	予告しております。」
“But I want the citizens of Midgar to be assured.”	「しかし、ミッドガル市民のみなさん
	安心して下さい」
“Shinra, Inc. has mobilized SOLDIER to protect	「我々神羅カンパニーはこのような
you from any violence and thereby…”	暴力からみなさんを守るために
	ソルジャーの投入を決定しました。
	これで……」
TIFA	TIFA
“Will you please come back?	「CLOUD！　もどってくれるの？
Ah, wait. Please wait.”	あ、でも、ちょっとまって」
“The president of Shinra	「プレジデント神羅の発表が
is going to read a statement.”	ニュースで読まれるの」
TIFA	TIFA
“The next time we'll be up against…SOLDIER.”	「私たち……次はソルジャーと戦うのね」
TIFA	TIFA
“CLOUD, then you'll help us?”	「CLOUD、助けてくれるのね？」
A promise is a promise	約束だからな
But I still hate BARRET	でも、BARRETがきらい-
TIFA	TIFA
“I hate BARRET.”	「ありがとう、CLOUD」
TIFA	TIFA
“You came to tell me that?”	「そんなこと言いにきたの？」
TIFA	TIFA
“He's not a bad person.”	「……悪い人じゃないわ」
TIFA	TIFA
“Don't worry.	「だいじょうぶ。
I'll talk to him.”	私からちゃんと話しておくから」
TIFA	TIFA
“Come on. Let's go below!”	「さあ、下へいきましょ！」
TIFA	TIFA
“Good Morning! CLOUD!”	「おはよ！　CLOUD！」
“Did you sleep well?”	「よく、眠れた？」
BARRET's snoring kept me up….	BARRETのイビキがうるさくて…
Next to you, who wouldn't?	TIFAがそばにいたから…
TIFA	TIFA
“…psst…”	「ひそひそ……」
“(keep it down, they'll hear you.	「（ダメ……聞こえちゃうよ。
BARRET's always edgy	BARRET、作戦前は気が立ってるから）」
before an operation.)”	
TIFA	TIFA
“I don't know what you mean.”	「それどういう意味かしら」
TIFA	TIFA
“I'm going this time.”	「今回は私も行くね！」
TIFA	TIFA
“Marlene,	「マリン、お店たのむね！」
you watch the store while we're gone!”	
Marlene	マリン
“All right!!	「うん！！
Good Luck.”	お仕事がんばってね」
Marlene	マリン
“Take care!”	「いってらっしゃい」
TIFA	TIFA
“Sorry, CLOUD.	「CLOUD、ごめんね。
Marlene seems a little shy.”	マリン、てれちゃってるみたい」-
Marlene	マリン
“…”	「…………」
Biggs	ビッグス
“Aaah!!	「ああ～！！
Nothin' like that first drink after a job.”	仕事の後の一杯はこたえらんねぇなぁ」
Biggs	ビッグス
“Hic!!”	「ヒック！！」
“Why don't you have one too?”	「CLOUDさんも、おひとつどうですか？」
No	いらないな
Yeah, why not?	そうだな、もらおうか
Biggs	ビッグス
“Oh!!	「おっ！！
That's more like it!!”	いい心がけじゃねぇか！！」
“Even if you were with SOLDIER,	「元ソルジャーでもここじゃおめえも新人だ。
you're still a rookie here.	新人にとっちゃ先輩の言うことは
So you'd better listen to whatever I tell ya!”	絶対だからな！」
“What!? You tellin' me	「なに～！！
you're too good to drink with me?”	おれさまの酒がのめないってかぁ？」
“Don't act big-headed jus' because you were	「元ソルジャーだからって
in SOLDIER!”	お高くとまってんじゃねえぞ！」
Biggs	ビックス
“Hic!!”	「ウィッ……！！」
“Oh…	「あっ……
don't tell BARRET what I jus' said.”	BARRETにはないしょだぞぉ」
Wedge	ウェッジ
“Oh, CLOUD!”	「あ、CLOUDさん！」
“TIFA really knows how to cook.	「TIFAちゃんの料理って
	おいしいっすねえ。
Mmm…”	パクパク……」
“Anyway, let me tell you somethin'.”	「でも、聞いてくれます？」
About what?	なにを
I'm not interested in your stories	お前の話なんて興味ないね
“TIFA always lets me	「TIFAちゃんって
taste her cooking.”	いつも俺に、料理の味見させるっすよ」
“And look at me now, I'm rolly-polly.”	「おかげでほら、俺、こんなまるっこく
	なっちゃって」
“Don't know whether I should be happy or sad.	「うれしいやら、悲しいやら。
But it's the good food and drinks that make	おいしい料理とお酒が評判で
this shop famous.”	お店ははんじょうしてるんですけどね」
“Oh well…	「CLOUDさん……。
forget it then.”	……いや、なんでもないっす」
Jessie	ジェシー
“Hey Wedge,	「う♥か♥つ♥……
you're getting all excited.”	なんだか、ドキドキしてる」
“Stop making such a mess!”	「なぜなの…？」
Biggs	ビックス
“You know, CLOUD.	「あのさ、CLOUD！
BARRET says those things, but…”	BARRETは、あんなこと言ってるけど…」
“We're really unstable right now.	「おれたち、ほんとは不安なんだ。
If SOLDIER were to show up, they'd whoop us.”	ソルジャーが出てきたら
	おれたち、みんなやられちまう」
Wedge	ウェッジ
“CLOUD, ya gotta help us.	「CLOUDさん、手貸してくださいよ。
I'm really scared.”	俺、こわいっす」
Jessie	ジェシー
“CLOUD….	「CLOUD……
It's painful.”	なんだか、せつないよ」
“Why is that?”	「どうしてなの？」
CLOUD	CLOUD
“What's goin' on?	「どうなってる……？
It's really shakin' a lot…”	やけにゆれるな……」
CLOUD	CLOUD
“TIFA?	「TIFA……？
Where?”	どこだ？」
CLOUD	CLOUD
…I'm going out…	「……俺はどこへ向かっている……」
“Received BARRET's stash, 1500 gil!”	「BARRETのへそくり
	１５００ギル手にいれた！」
TIFA	TIFA
“So!	「あ～あ！
You're really leaving!?”	本当に行っちゃうんだ！」
TIFA	TIFA
“You're just going to walk right out	「かわいい幼なじみのたのみも
ignoring your childhood friend!?”	きかずに行っちゃうんだ！」-
CLOUD	CLOUD
“What?”	「ん……？」
How can you say that!	よくいうぜ！
…Sorry	……わるいな
TIFA	TIFA
“….You forgot the promise, too.”	「……約束も忘れちゃったんだ」
CLOUD	CLOUD
“Promise?”	「約束？」
TIFA	TIFA
“So you DID forget.”	「やっぱり忘れてる」
TIFA	TIFA
“Remember? CLOUD,	「思い出して……CLOUD。
it was seven years ago…”	あれは７年前よ……」
TIFA	TIFA
“You remember now, don't you?	「思い出してくれたみたいね
Our promise?”	約束」
TIFA	TIFA
“Look, the well.”	「ほら、村の給水塔」
“Do you remember?”	「覚えてる？」
CLOUD	CLOUD
“Yeah…back then.”	「ああ……あの時か」
CLOUD	CLOUD
“I thought you would never come, and	「TIFA、なかなか来なくて
I was getting a little cold.”	ちょっと寒かったな」
TIFA	TIFA
“Sorry I'm late.”	「お・ま・た・せ」
TIFA	TIFA
“You said you wanted to	「な～に？
talk to me about something?”	話があるって」
CLOUD	CLOUD
“Come this Spring…I'm leaving	「俺……春になったら村を出て
town for Midgar.”	ミッドガルへ行くよ」
TIFA	TIFA
“All the boys are leaving town.”	「……男の子たちって
	み～んな村を出てっちゃうね」
CLOUD	CLOUD
“But I'm different from them.	「俺はみんなとはちがう。
I'm not just going to find a job.”	ただ仕事をさがすだけじゃない」
CLOUD	CLOUD
“I want to join SOLDIER.”	「俺、ソルジャーになりたいんだ」
CLOUD	CLOUD
“I'm going to be the best there is,	「セフィロスみたいな
just like Sephiroth!”	最高のソルジャーに」
TIFA	TIFA
“Sephiroth…	「セフィロス……
The Great Sephiroth?”	英雄セフィロス、か」
CLOUD	CLOUD
“I thought about Sephiroth all the time.	「あのころの俺は、ねてもさめても
Even in my sleep.	セフィロス、セフィロス……
My mom had given up on me.”	母さんもあきれていたな」
TIFA	TIFA
“I had no idea you were planning on that.”	「私、CLOUDが
	そんなこと考えてたなんて
	ぜんぜん知らなかった……」
TIFA	TIFA
“But, what about our promise?”	「ね、それより約束は？」
TIFA	TIFA
“Isn't it hard to join SOLDIER?”	「ソルジャーになるのって
	難しいんでしょ？」
CLOUD	CLOUD
“…I probably won't be able to come	「……しばらくのあいだ
back to this town for a while.”	村にはもどれないな、きっと」
CLOUD	CLOUD
“…Huh?”	「……うん？」
TIFA	TIFA
“If you make it, will you be in the newspapers?”	「大活躍したら
	新聞にものるかな？」
CLOUD	CLOUD
“I'll try.”	「がんばるよ」
TIFA	TIFA
“Hey, let's make a promise.”	「ね、約束しない？」
TIFA	TIFA
“Umm…if you get really famous and	「あのね、CLOUDが有名になって
I'm ever in a bind…”	その時、私が困ってたら……」
“you'll come save me, all right?”	「CLOUD、私を助けに来てね」
CLOUD	CLOUD
“What?”	「はぁ？」
TIFA	TIFA
“If I'm ever in trouble, my hero will	「私がピンチのときに
come and rescue me.”	ヒーローがあらわれて助けてくれるの」
“I want to experience that at least once.”	「一度くらい経験したいじゃない？」
CLOUD	CLOUD
“Ha, ha, ha!	「ハハハハ！
What's that?”	なんだよ、それ！」
TIFA	TIFA
“You're laughing at me!”	「笑ったわね！」
TIFA	TIFA
“Come on!	「いいじゃないのよ～！
Promise me!”	約束しなさい～！」
CLOUD	CLOUD
“All right…I promise.”	「わかった……約束するよ」
CLOUD	CLOUD
“I'm not a hero and I'm not famous.	「俺は英雄でも有名でもない。
So I can't keep our promise.”	約束は……守れない」
TIFA	TIFA
“But you got your childhood dream, didn't you?	「でも子供のころの夢を実現したでしょ？
You joined SOLDIER.”	ちゃんとソルジャーになったんだもの」
TIFA	TIFA
“So come on!	「だから、ねっ！
You've got to keep your promise…”	今度こそ約束を……」
BARRET	BARRET
“Wait a sec big-time SOLDIER!”	「おいちょっと待て！
	ソルジャーさんよ」
CLOUD	CLOUD
“This is my pay?	「こんな、しけた報酬
Don't make me laugh.”	じょうだんじゃないな」
TIFA	TIFA
“What? Then you'll…”	「え？それじゃ！！」
CLOUD	CLOUD
“You got the next mission lined up?	「次のミッションはあるのか？
I'll do it for 3000.”	倍額の３０００でうけてやってもいい」
BARRET	BARRET
“What!?”	「なんだと！……！」
TIFA	TIFA
“It's OK, it's OK.”	「いいからいいから」
TIFA	TIFA
“…psst….	「ヒソヒソ……
(We're really hurting for help, right?)”	（人手に困ってるってのが本音でしょ？）」
BARRET	BARRET
“Uh….ugh….	「う……ぐぅ……
(That money's for Marlene's schoolin'….)”	（残りのへそくりはマリンの学費だぞ……）」
BARRET	BARRET
“2000!”	「２０００だ！」
TIFA	TIFA
“Thanks, CLOUD.”	「ありがとう、CLOUD」
BARRET	BARRET
“Our target's the Sector 5 Reactor.	「標的は【五番魔晄炉】だ。
Head for the station first.”	まず、駅へ行く」
“I'll fill you in on the train.”	「くわしい作戦は列車の中でな」
BARRET	BARRET
“Yo, CLOUD.”	「おい、CLOUD」
“Got a message from the old man	「武器屋２階のオヤジからの伝言だ！
at the weapon shop upstairs!	いいもんあげるからとりにこい……
Said he's got somethin' special	たしかに伝えたぞ！」
so come and get it!”	
“Yo! If you pull somethin' funny…	「おう！　おかしなマネをしたら……
you now what I'll do to ya, right?”	わかってんだろうな」
BARRET	BARRET
“Whoa, wait a damn minute.	「おい、ちょっと待て。
CLOUD!!”	CLOUDさんよ！！」
BARRET	BARRET
“A promise is a promise!	「約束は約束だからな！
Here!!”	ほら、金だ！！」
TIFA	TIFA
“I'm so glad everyone's safe.”	「よかった、みんな、無事で」
BARRET	BARRET
“Yo! CLOUD!”	「おう！　CLOUD！」
“Before the next mission,	「作戦の前にひとつ
I got somethin' I wanna ask you!”	おまえさんに聞きたいことがある！」
“I, uh…	「じつはな……
I don't really know how to use Materia!”	オレはマテリアの使い方をよくしらねえ！」
“I'll give you that Materia we found.	「ひろったマテリアはおまえにくれてやる。
Just teach me how to use it!”	だから、教えろ！」
CLOUD	CLOUD
“…sigh…”	「さて……」
OK, I'll explain it	面倒だが説明しよう
You wouldn't understand	面倒くさい……-
BARRET	BARRET
“So this is what makes them guys	「ソルジャーさんたちの秘密ってわけか」
in SOLDIER so great, huh!?”	
“Ok. I'll ask Jessie again later.	「まあ、いいだろう。
But you're in charge of the Materia!”	あとで、ジェシーにでも聞いておくからな。
	だがな、マテリアはおまえが管理しろ！」
BARRET	BARRET
“&$*#! What's this,	「ケッ！　なにが……
It wasn't that tough!' crap?”	『それほど、むずかしくはないだろう』だ！」
“I don't get it!….”	「ぜんぜんわかんねえ……」
“You just handle the Materia, CLOUD!”	「まあ、いいだろう。
	マテリアはおまえが管理しとけ！」
TIFA	TIFA
“CLOUD! I got a message	「CLOUD！
from the Weapon Shop man upstairs.”	武器屋２階のおじさんから伝言よ」
“He has something he wants to give you.	「あげたいものがあるからお店によって
Don't forget!”	……だって。
	わすれないでね！」
[Materia System]	【マテリアシステム】
“Access the menu	メニューを開いて「マテリア」を選ぶことによって
and select [Materia] to equip Materia.”	マテリアの付け替えができるようになります。
Sector 7 Item Store	７番街・道具屋
	
“Ahh…	「フーッ……
Another slow day…”	今日もひまひま……」
“If this keeps up, this store's goin' under…”	「もうこの店もダメかのう…」
“Can't sell any really good medicine	「こんなスラムじゃ
in a slum like this.”	まともなクスリは売れんなあ」
“Oh!! Look at this!	「おっ！！こりゃこりゃ！
This doesn't happen everyday.	こりゃ、めずらしい。
Are you…a customer?”	あんた、まさか客かね？」
“Yes!! Welcome!!	「はい！！　いらっしゃい！！
We sell!	売りますよ！
We buy!”	買いますよ！」
“By the way, you wouldn't happen to be…	「ところで、あんた。
	もしかして……」
Naw, never mind.	……いや、なんでもないよ。
Forget it.	失礼、失礼」
Sector 7 Weapon Shop	７番街・武器屋１階
	
“He, HEY! Waitaminit you!!”	「んっ！！
	おい、客！！」
“You can't just walk outta here	「買わねえとどんなめにあうか……
without buyin' somethin'!”	
“Might be unhealthy fer ya,	想像してみりゃ、わかるよな」
if ya know what I mean.”	
“Hey!! What the--YOU!?”	「よう！！
“Anyone talking to me must be a novice.”	なんだ、おまえ？」
Yep, that's me	「俺に話しかけるってことは、しろうとだな？」
I used to be in SOLDIER,	素人だ。
the name's CLOUD	俺は元ソルジャーのCLOUDだ。
CLOUD	CLOUD
“So what.	「それがどうした。
Everyone's gotta start sometime.”	誰だって最初は素人だろ」
CLOUD	CLOUD
“The name's CLOUD.	「俺は元ソルジャーのCLOUDだ。
Used to be with SOLDIER,	おまえに用などない」
I got no business with you.”	
“Hmmph!!	「フン！！
Well, I never heard of ya!”	おまえの名前なんて聞いてねぇよ」
“Don't act so big, amateur.	「素人のくせにいばるんじゃねぇ。
Seein' as how I'm such a warm hearted guy,	親切な俺様が
I'll show ya the ropes.”	こんせつていねいに教えてやるぜ！」
“You come back here tomorrow.	「明日の朝に顔あらってでなおしてきな。
I got some things I gots ta do.”	俺様だって準備が必要だからな」
“Heh heh…He'll forget about it.	「てへへ…一晩じゃ、おぼえきれんぜ。
OH, you!!”	おう！素人！！
“Get my friend on the second floor	悪いが、二階のあいぼうから教わってくれ」
to teach ya.”	
“Crap!! Watch it, you old guy!”	「チッ！！　おっさん！！
	気をつけてくれよ！」
“I was just about to rip up that smooth	「あんたのツンツン頭を
little head of yours!”	ブチぬいちまうとこだぜ！」
“In the slums	「スラムじゃ、自分の身は自分で守る。
ya gotta take care of yourself first.”	ガキのころから、そんな生き方さ」
“I been livin' like that ever since I was a kid.”	「オレみたいにタフな男の子になりたかったら
“You wanna be tough like me?	いかす武器を選ぶこったな」
Then you gotta pick out some good weapons.”	
“Oh and uh, by the way	「でな、おっさん。
old guy…”	相談なんだが……」
“You can see this store don't have no customers…	「見ての通り、この武器屋には客がいない。
and even tough guys like me	タフな男の子のこのオレもびんぼうってわけさ」
could use a buck or two…”	
“Ya think you could spare some cash?”	「というわけで……
	このオレに、こづかいくれないかな？」
Give him some	金渡す
Don't give him any	あげない
“YESSS…”	「しめしめ……」
“Damn, man!!	「チッ！！
Ya chinsey old %*&!”	おっさん、しけてんな」
“Hey old guy! I got a good-lookin' sister!!”	「オレの姉キは美人だぞ！！
	おっさん！！」
Give him some	金渡す
Forget it	あげない
“What's the matter, old dude?	「おっ！！
You don't like women?”	おっさん、美人に興味なし、と」
“You dried up old geez.	「チッ！！
You tired?”	おっさん、しけたツラしてんな。
	もしかして、つかれてんじゃないの？」
“Why don't you rest up	「家の３階で休ませてあげても
on the third floor of my house?”	いいけど…」
“There's just one condition.”	「それにはひとつ条件があるぜ」
“You gotta give me some cash.”	「このオレにこづかいくれるならな」
1 gil	１ギル
10 gil	１０ギル
nothin'	あげない
“Damn, man!! Just forget about it!”	「チッ！！　おっさん。
	この話はなかったことにしてくれ」
“Oh man, oh man…”	「しめしめ……」
“Go ahead 'n' help yourself to the room.”	「いいぜ、部屋は自由に使ってくれ」
“Cheap %#*^…”	「そりゃ、ドケチってやつだぜ。
	おっさん」
“Geez, dude, you're really old.	「おっさん、やきがまわったな。
You sure you ain't poorer than me?”	オレよりびんぼうじゃねえか」
“Use whatever bed you want.	「すきなベッドで休んでいきな。
Sleep tight, old guy.”	いい夢見なよな、おっさん」
Weapons Shop 3rd Floor	７番街・武器屋３階
	
“This is a slum, so don't think you can stay	「ただで休めるほど
for free.”	スラムの街はあまくはないぜ」
“What are you going to do?”	「どうすんだい？」
“Doesn't just seeing the bed make you sleepy?”	「ベッドを見たら眠くなってきただろ」
10 gil	１０ギル
no way	休まない
“Tough guy, huh!?	「強情だな！　もうっ！
You'd better sleep when you can.”	休めるときに休む」
“You'd better save when you can.”	「セーブできるときに
	セーブする」
“That's the trick to being tough.	「これがタフに生きてく基本だぜ！
Remember that, old dude.”	おっさん、覚えときな」
“Sweet dreams, pops.”	「いい夢見なよな、おっさん」
“Rough times, huh pop?	「おっさん、苦労してんだな。
Not a dime on you?”	金もってないじゃないか！」
CLOUD	CLOUD
“Hoo…”	「フゥッ……」
“Save Point”	【セーブポイント】
	
Sector 7 Slums, Weapons Shop Floor 2	７番街・武器屋２階
Beginner's Hall	初心者の館
	
“Unn!!	「ん………！！
Who the hell are you!?	なんだ、てめぇは？
No unauthorized access.”	ここは部外者立ち入り禁止だぞ」
“Do you know about what's been going on?”	「あんたも、知ってるか？」
What, that again?	また、その話か
…	…………。
“You must be sick of hearing it…	「そうか、もう聞きあきちまったか…。
But it's been so long	ひさしぶりのでかいニュースだからよ。
since there was any real news here.”	先行きが、気になるよな」
“You're worried where it's all heading, right?	「なんでもよう……
Everyone's in a buzz 'bout that	アバランチとかいうテロ集団が
terrorist group AVALANCHE	壱番魔晄炉を爆破したって話だ」
blowin' up the Sector 1 Mako Reactor.”	
“On the surface they say	「おもてむきは、反神羅がどうしたとかって
they're an anti-Shinra group,	声明がでてるらしいがよ。
but in reality…”	真相はな……」
“they say they're just out to kill	「無差別大量殺人が目的だってうわささ」
as many people as they can.”	
“Since today's special,	「まあ、今日は特別だ。
I'm gonna let you in on a juicy bit of news.	ここだけの話。
But you gotta keep it to yourself.”	いいニュースがあったからな」
“Haaa, haaa, haaa!!”	「ガハハハハ！！」
“That's a good one, ain't it!?	「笑わせてくれるじゃねぇか！？
While they're bustin' things up on top,	上でゴタゴタやってくれりゃよ。
the only ones makin' out	武器屋としては大助かりってやつよ」
good are us weapon stores!”	
“Now, if we can just get rid of this back stock,	「この在庫の山もはけちまえばいいがな」
we'll be doin' OK.”	
“I welcome everything going to pot!”	「俺っちは、ぶっそうな世の中を
	歓迎するぜ！」
“GO!! GO!! AVALANCHE!!	「ゴー！！ゴー！！
That's what I say!”	アバランチ！！ってやつだな」
“You know what I do?	「オレの仕事わかります？
I'll bet you don't.”	わかんねえだろ～な」
“You come here tomorrow and I'll tell you.”	「明日になれば、わかりますから
	また来てくださいね」
“Ahh, there just ain't no good jobs	「はぁ～
here in the slums.”	スラムじゃ、まともな仕事に
	ありつけやしない」
“I wanna go to the upper world.”	「上の街にいきたいなあ」
“This is the Beginner's Hall.”	「まいどおなじみ初心者の館だよ～ん！」
“You say you're a beginner?	「あんたが、素人だってか。
But your eyes say you're not.”	その目は、そうじゃないって言ってるぜ」
CLOUD	CLOUD
“Don't mess with me. I used to be in SOLDIER.	「元ソルジャーをなめるな。
I'll tell you how much I know…	どれだけ物知りか、教えてやる。
an' for free too!”	しかも、無料でだ！」
CLOUD	CLOUD
“What do you want to know?”	「なにが知りたいんだ？」
How to save?	記録を残すには？
How to heal your allies?	傷ついた味方を回復するには？
Curative Magic?	魔法を使った回復
Weapons and armor?	武器、防具の使い方
How to apply Materia?	マテリアの装着
Effective ways to use Materia?	マテリアの高度な使い方
How to form your battle party?	戦闘時の隊形について
How to check your status?	現在の自分の状態をチェック
About Limit status?	リミット技の使い方
Other things to watch for?	その他の注意
That's all	もう教えることはない
CLOUD	CLOUD
“First, you need Potions.”	「説明にあたって、ポーションが必要だな」
“You're a stingy one.	「せこいなあ、元ソルジャーさん。
Here, I'll give you ONE Potion.”	そらポーションの一個くらい、さしあげますぜ」
“I don't have any extra Potions on me.	「俺もポーションの手持ちがないよ。
Why don't you go buy some?”	買ってきたらどうだい？」
CLOUD	CLOUD
“Sorry.	「悪いな。
I'll have to go get my money.”	報酬だと思ってもらっておく」
CLOUD	CLOUD
“You probably know all this.	「常識なのでわかっているとは思うが
But just in case, I'll go over it.”	念のため、言っておく」
“Until you get instructions,	「指示があるまで、ディスクホルダーを開けたり
don't open or take discs	他のものと取りかえたりするな」
out of the CD drive.”	
“After you open up the CD drive,	「ディスクホルダーを開けた場合
I can't guarantee what'll happen.	後のことは保証できない。
That's all.”	以上」
You cannot take on any more Materia.	これいじょうマテリアは持てません。
Please discard some Materia.	なにかマテリアをすててください。
Received "All" Materia!	『ぜんたいか』のマテリアを手にいれた！
[Save Point]	【セーブポイント】
Received "Ether"!	『エーテル』を手にいれた！
“Hey!!	「おっ！！
You got one right off!”	さっそく手にいれましたね！」
“That was Materia.	「いまのはマテリアですよ。
Next, take this [treasure chest]!”	こんどはこの【たからばこ】をどうぞ！」
“Now listen,	「いいですか？
hidden in these treasure chests	こ～んな【たからばこ】にはお得なアイテムが
are a lot of items.”	かくされてます」
“There are box types and bag types,	「ボトルタイプやふくろタイプなど
so make sure you don't overlook any.”	ほかにもしゅるいがありますから
	お見のがしないように」
“This is the fabled [Save Point]!!”	「うっとり……くるくる……
	これがうわさの【セーブポイント】！！」
“At a [Save Point]	「【セーブポイント】では……
you can use a [tent] and/or select 'SAVE'.”	『テント』を使って休むこと
	セーブ　することができちゃいます」
“You can also do something else	「ほんとは、もうひとつあるんだけど
there, but right now it's a secret.”	いまは秘密♥　楽しみに待っててね♥」
“Even if you are wiped out, if you've	「も～し、全滅しても、　セーブ　しておけば
saved, you can restart	その場所から復活することができちゃうの。
from that same point.	これなら、安心して全滅できるわよね」
That way you don't have to worry	
when you've been wiped out.”	
	
“This is jumping ahead a little but,	「ちょ～っと、先の話になるけど
when you leave Midgar…”	ミッドガルを出ることになったら……」
“and you get to the world map,	「地和線まで広がる【ワールドマップ】で
you can save anywhere you like.	好きなだけ　セーブ　することができるの。
Remember that.”	そのときがきたら、思い出してね」
“That should be all you need to know about	「ただいま、ごしょうかいにあずかりました
the Save Point.	あっしが【セーブポイント】でござんす！
I'll probably see you again somewhere	旅先行き先先々でお目にかかることと思いますが
down the road.	今後ともよろしゅうおねがいもうしあげます！」
Take care!”	
I'm a [treasure chest]!!	俺様が、【たからばこ】だ！！
Beginners, make sure and keep an eye out for me!!	「初心者のキ・ミ・た・ち！
	俺様をしっかりとさがしてくれよ！！」
“Hey SOLDIER!!	「物知り元ソルジャーさん！！
Tell us about battles!	バトルのことをオレたち３人組に教えてくださいよ！
We'll even pay you!”	報酬はずみますから！」
	
CLOUD	CLOUD
“What do you want to know?”	「なにを教えてほしいんだ？」
About ATB	【ＡＴＢ】について
About numbers on the screen	【飛び出す数字】について
About [Change] and [Defend]	【チェンジ】と【ぼうぎょ】について
About [Escape]	【逃げる】について
About [Gauges]	【ゲージ】について
About [Status]	【ステータス】について
About [Elementals]	【属性】について
About [Help]	【ヘルプ】について
That's all the time I have for you!	もうひまつぶしは終わりだ
CLOUD	CLOUD
“I'm not hard up enough	「おまえたちから金をとるほど
to take money from guys like you.	落ちぶれちゃいない。
But I'll rap with you for a while.”	ひまつぶしにつきあってやる」
CLOUD	CLOUD
“ATB or Active Time Battle is a system	「【ＡＴＢ】、すなわち【アクティブタイムバトル】は
that is always in operation during battle.”	戦闘中、つねに時間が流れているシステムだ」
“Select [Wait] from ATB on the Config Menu	「メニューのコンフィグでＡＴＢを【ウェイト】にすると……
and time will stop	戦闘中、魔法やアイテムを選んでいる間
when you select magic or items during battle.”	時間が止まる」
“This gives you time to pick out your commands.	「コマンドをゆっくり選べるというわけだ。
This is especially helpful to beginners.”	おまえたち、初心者にはおあつらえむきだな」
“Selecting [Recommended] ATB	「同じくコンフィグでＡＴＢを【おすすめ】にすると……
in the config menu can stop time	戦闘中、魔法やアイテムのエフェクトが出ている間
while the effects of spells and items are	時間が止まる」
taking place during battle.”	
“This lets you take your time looking over	「戦闘の様子をゆっくり見られるというわけだ。
the progression of the battle.	落ちついて戦いたいときはこれだな」
When you don't want to rush in battle,	
this is for you!”	
“Personally, I always use [Active],	「俺はいつでも【アクティブ】だが
but you can use whichever you like.”	気にするな、好きなものを選ぶといい。
	以上だ」
CLOUD	CLOUD
“White numbers appearing on the screen	「バトルの時に、【ピロンと飛び出す数字】は
in battle are damage points.	白がダメージ、緑が回復していることを
Green numbers show restorative points.”	表している」
“You better watch these	「全滅したくなければ
if you don't want to get wiped out.”	注意することだな」
CLOUD	CLOUD
“The [Change] command can move characters	「【チェンジ】のコマンドで
to and from the front and back rows.”	戦闘隊形の前列・後列を入れかえられる」
“In the back row, the damage received is less,	「後列にすると受けるダメージが減るが、攻撃力も減る。
but the attacking power is less.”	【チェンジ】は、戦闘コマンドを選ぶときに
	【方向キーの左】を押すと可能だ」
“You can make a [Change]	「同じく戦闘コマンドを選ぶときに
by pressing the Directional button in battle.	【方向キーの右】を押すと
Pushing the Directional button	【ぼうぎょ】だ」
the other direction during battle	
accesses [Defend].”	
“Selecting [Defend] reduces the damage	「【ぼうぎょ】のコマンドを選ぶと
you receive by half	次のコマンド入力までのあいだ
until the next command.”	ダメージを半分にすることができる」
“If you're up against a strong enemy,	「手強い相手には無理せず
don't hesitate to use this one.	【ぼうぎょ】することが必要だ。
Of course, I never need it.”	むろん、俺には関係ないことだがな」
CLOUD	CLOUD
“I don't really remember ever having	「俺は、戦闘中、【逃げる】ことなど
to use the [Escape] command…	めったにないから、くわしくは覚えていないが…
but you'll probably need it.”	おまえたちには必要だろう」
“Push [PAGEUP] and [PAGEDOWN] together,	「Ｌ１ボタンとＲ１ボタンを押しっぱなしにしていると
hold them down, and you can escape.”	逃げられたはずだ」
CLOUD	CLOUD
“During battle,	「いまは確認できないからわかりにくいかもしれんが
there are several [Gauges] displayed.	とにかく、聞いておけ。
You can't check them now,	戦闘中、いくつか表示されている【ゲージ】のことだ」
so just remember what I tell you.”	
“[time gauge] displays the time	「【ＴＩＭＥゲージ】は
remaining until your	戦闘中、次のコマンド入力が回ってくるまでの
next turn while in battle.”	待ち時間をあらわしている」
“When the gauge is full,	「ゲージがいっぱいになるとコマンドの入力が可能だが
you can make your command.	もし入力したくなければ、【△ボタン】で次のやつに
If you don't want to make one,	順番をまわすこともできる。
push [MENU]	BARRETをこきつかいたい時などに便利だ」
and you can move to	
the next character.	
It's convenient when you wanna make	
BARRET work.”	
“The [limit gauge] increases every time	「【ＬＩＭＩＴゲージ】は
you sustain damage.	ダメージを受けるごとにのびていくはずだ。
When it is full,	これがいっぱいになると、【リミット技】が使える」
you can use the [limit technique].”	
“This gauge is not cleared after each battle,	「【ＬＩＭＩＴゲージ】は、各戦闘ごとにクリアされず
but gradually builds up over time.”	数をこなしただけ、たまっていくタイプだ」
“It takes a while for it to build up,	「たまったからといって、すぐにつかわず
so you have to think about which	【リミット技】の使いどころを見極めることが
times are the best to use it.”	大切なのは言うまでもない」
“You probably don't know about them,	「おまえたちは知らないだろうから、教えといてやる。
but there are conditions of	【ステータス】に、【怒り】と【悲しい】という
[fury] and [sadness].”	状態がある」
“When you have [fury],	「【怒り】は、【ＬＩＭＩＴゲージ】の上がり方が早くなるが
your limit gauge builds up sooner,	攻撃の命中率は低下する」
but your attacking accuracy is lower.”	
“Keep in mind that [sadness] makes	「【悲しい】は、【ＬＩＭＩＴゲージ】の上がり方が
your limit gauge build up slower,	遅くなるが、敵の攻撃から受けるダメージは低下する。
but the damage you receive is also lessened.”	ついでに、おぼえておくといいだろう」
“The [barrier gauge] shows your defense barriers.”	「【ＢＡＲＲＩＥＲゲージ】は
	特定の魔法の効果時間をあらわす」
“The top gauge displays [barrier] or	「上のゲージは、なぐられ攻撃を防ぐ魔法【バリア】
magic defense against attacks.	下のゲージは、魔法攻撃を防ぐ魔法【マバリア】」
The bottom gauge displays [magic barrier] or	「両方ともダメージを半分にしてくれるが
defenses against magic attacks.”	時間が経つと消えてしまう」
“Both will cut the damage you receive in half.	
However, over time they will disappear.”	
“Whenever you use [barrier] or	「【バリア】と【マバリア】の魔法をつかったときは
[magic barrier]	【ＢＡＲＲＩＥＲゲージ】に注目だな」
make sure to pay attention to the	「以上だ、次の戦闘で確認してくれ」
[barrier gauge].”	
“That's it. Remember that for the next battle.”	
CLOUD	CLOUD
“Looks like you didn't get it	「この俺の説明でもわからんようならしかたない。
the last time I told you.	おまえたちの理解する能力がたりないようだ」
What's wrong with you?	
You touched in the head?”	
“Well, don't worry.	「だが、安心しろ。
You just need to push [ASSIST]	そんなおまえたちは、戦闘中、セレクトボタンを
in battle.”	押してみるといいだろう」
“Do that, and the [Help] message will walk you	「【ヘルプメッセージ】が、俺にかわって
through the commands.”	いろいろとコマンドの説明をしてくれるはずだ」
“It also shows you the name of your enemy,	「敵のモンスター名なども表示されるから
so even I use it once in a while.	俺も気分転換に見ることもある。
Make good use of it.”	はずかしがらずに使うといい」
CLOUD	CLOUD
“[wiped out].	「【全滅】か……
This is one I've never personally used.	俺の記憶にはないから、これは人から聞いた話だ」
But I heard from someone	
what it was about.”	
“When you are wiped out,	「【全滅】したときには
you start back from the last save point.”	前の【セーブポイント】からはじまる」
“Even a weakling like you	「おまえたちのような弱いヤツでも
can make it out of the roughest places	地道に戦えば、どんな難所でも脱出できるはずだ。
as long as you hang in there and fight.	ありがたいことだな」
You should be glad!”	
CLOUD	CLOUD
“[Status] means just that.	「【ステータス】とはキャラクターの状態のことだ」
The status of each character.”	
“I'll probably wind up repeating myself,	「これまで説明したことと重なるかもしれんが
but let me go over a few basic points.”	代表的なものをまとめといてやる」
“Sleep	すいみん　起きるまでコマンド入力不可になる。
You cannot put in a command until you get up.”	
“Poison	どく　　　　戦闘中にどんどんＨＰが減っていく。
Steals your HP in battle.”	
“Fury	いかり　　ダメージ倍、命中率低下。鎮静剤でもどる。
Damage is increased,	
attack accuracy decreased.	
Tranquilizers will remedy it.”	
“Sadness	かなしい　ダメージ低下。興奮剤でもどる。
Damage is decreased.	
Hyper will remedy it.”	
“Petrify	せきか　　石になり、動けなくなる。全員石で全滅だ。
Will petrify and become immobilized.	
Every member will be wiped out.”	
“Confuse	こんらん　頭が混乱し、敵味方の区別がつかなくなる。
Will attack enemy and ally alike.”	
“Silence	ちんもく　全ての魔法をとなえられなくなる。
Will be unable to cast magic.”	
“Paralyze	マヒ　　　　タイムゲージ停止、コマンド入力不可
Stops time gauges, commands.”	
“Darkness	くらやみ　なぐり攻撃の命中率低下。
Accuracy of hitting attacks decreases.”	
“Frog	カエル　　カエルになる。俺はだいきらいだ。
Become a frog. I hate this one!”	
CLOUD	CLOUD
“Hoo…I'm beat.”	「フッ……さすがにつかれたな」
“Your [Status] can be changed with magic	
and items, so you should check	「【ステータス変化】はアイテムや魔法で直せるから
it whenever you buy things.”	物を買うときに確認しておくのがいいだろう」
CLOUD	CLOUD
“[elemental] is the special effect that	「【属性】は魔法や武器などに
comes with certain weapons and magic.”	ついてくる特別な効果のことだ」
“It's necessary to move ahead effectively.	「有利に戦闘を進めるためには不可価だが
If you pay attention to	【属性】を気にして戦えるようになれば
the types of elementals you use	もう立派な中級者とよべるな」
you'll become intermediate in no time.”	
“I put together this list,	「代表的なものの一例をまとめといてやる。
but remember, it's just a partial list	あくまでも一例だ、うのみにするな」
don't take it too literally.”	
“Fire	炎　　火の効果。けもの、氷のモンスターにきく。
Fire effect. Works best on animals	
and water monsters.”	
“Ice	冷　　氷の効果。寒がり、火のモンスターにきく。
Ice effect. Works best on fire monsters	
and things that hate the cold.”	
“Lightning	雷　　電撃の効果。機械でできたヤツにきく。
Lightning effect.	
Works best on mechanical things.”	
“Earth	土　　大地の力の攻撃。飛んでるヤツにはきかない。
Attacks using the earth's power.	
Doesn't work on flying enemies.”	
“Poison	毒　　毒状態にする。もともと毒のヤツにはきかない。
Poisons enemies. Doesn't work on	
any poison-based enemies.”	
“Gravity	重　　重力を使った攻撃。当たるといたいな。
Gravity-based attack.	
These hurt if they hit.”	
“Water	水　　大地の恵みの水を呼ぶ。火のモンスターにきく。
Calls on the earth's water.	
Works well on fire monsters.”	
“Wind	風　　大気の風をよびおこす。飛んでるヤツにきく。
Calls up the winds.	
Works well on flying enemies.”	
“Holy	聖　　星の力をよびおこす。暗黒のモンスターにきく。
Calls up the Planet's power.	
Works well on dark monsters.”	
CLOUD	CLOUD
“If you use reciprocal elementals	「相反する【属性】を
in your attacks, the effect is huge!”	攻撃に使用することで大きな効果を得られる」
“Also, if you use the same elemental,	「また、同じ属性なら防御の効率があがる。
your defenses are raised.	だが……逆もまた真なり。
But, you have to be careful	気をつけることだな」
because the opposite is also true.”	
“To see what elementals an enemy has,	「敵のもっている【属性】をみぬくためには
you need [Sense] Materia.	【みやぶる】ことが必要だ。
If you get that Materia,	マテリアを手にいれたら、使ってみてくれ」
you should try using it.”	
“……smack……knock……!!”	「ポカポカ
	ポカポカ……！！」
“Help!”	「たしゅけて～！」
CLOUD	CLOUD
“You've got to hang in there.	「そこでがまんだ。
Your limit gauge is just starting to build.”	おまえの【リミットゲージ】はたまりはじめている」
“Waaaah!!”	「びえ～ん！！」
CLOUD	CLOUD
“OK! Now your limit gauge is full,	「よしっ、【リミットゲージ】はいっぱいだ！
go ahead and use it!	えんりょはいらない。
Fight with your limit technique.”	【リミット技】で勝負だ！」
“Magic!!	「まほう！！
Magic!!”	まほう！！」
CLOUD	CLOUD
“Calm down!	「おちつけ！
When your enemy uses magic	相手が魔法を使うときには
counter with [Magic Barrier] or [reflect].”	【マバリア】か【リフレク】で対抗するのだ」
“[Magic Barrier] reduces the damage	「【マバリア】は魔法のダメージを
received from magic by half.”	半分にする魔法だ」
“[reflect] bounces the attacks off you.	「【リフレク】は魔法をはねかえすが
But the number of times you can use it	はねかえす回数に制限があるから
is limited so be careful.”	気をつけろ」
“Wow! You sure are strong!	「さっすが、元ソルジャ！
I'm going to be strong, too !”	どちたら、強くなるの～！」
“Me too!”	「なるの～！」
CLOUD	CLOUD
“If you want to get as strong as me	「俺みたいに強くなりたければ
you need to use Materia.	マテリアを効率よく育て
And you have to find the best combinations	最適な組み合わせをさがすことだな」
of them.”	
“The type of Materia you put in	「装備する武器や防具のしゅるいによって
your weapons and armor will determine	マテリアの成長のスピードはちがう」
how quickly your Materia grows.”	
“Put Materia into the open slots	「武器や防具にあいている穴の形によって
in your weapons and armor.	マテリアの組み合わせは無限に広がる」
The possible combinations are limitless.”	
“That's about all I can tell you.	「俺にアドバイスできるのはそのくらいのことだ。
If you want to be like me, you have	もっとも生まれついた素質がなければ
to have some natural talent.”	俺のようにはなれんがな」
“I still don't get it!”	「わかんな～い！」
CLOUD	CLOUD
“Listen kids, don't piss me off!”	「俺を怒らせるな！」
“That's all right. Just give it a try.	「大丈夫だ、まずはやってみろ。
Little by little, you'll get used to it.”	そのうち、なれてしまう」
CLOUD	CLOUD
“Great!”	「上出来だ」
“How to use the buttons.”	『基本的なボタン操作方法』
[Directional button][CONTROL]	【方向キー】　　　　　　【ボタン】
up [MENU]: menu	上　　　　　　　　　　　△：メニュー
leftright: walk  [OK]: speak/execute	左　　　右：歩く　　　□　　○：話す／決定
down [CANCEL]: run	下　　　　　　　　　　　×：走る／取り消し
[PAGEUP]/[PAGEDOWN]: turn.	Ｌ１／Ｒ１ボタン：チョコッとまがる
[How to restart]	『ソフトリセット方法』
You must quit the game in order to restart.	Ｌ１＆Ｌ２＆Ｒ１＆Ｒ２＆セレクト＆スタート
To quit the game, either select QUIT	以上のボタンを同時に押すとリセットがかかります。
in the Main Menu or press CTRL+Q.	（フィールド上のみ有効）
CLOUD	CLOUD
“Huh? Finger!?	「ん？　指！？
What the hell?”	なんだ、おまえ？」
“I'm the position cursor!!	「ボク、【ポジションカーソル】！！
Call me whenever you're walking	歩いている時、迷ったらボクを呼び出して！」
around confused!”	
“Push [ASSIST]	「セレクトボタンを押せば
and I'll appear over your shiny little head.”	ボクが君のツンツン頭のうえにつきまとうよ」
CLOUD	CLOUD
“Geez, you stand out even more than I do…”	「俺より目立つな……」
“Am I in the way?	「ボクがじゃまかい？
If so, just push [ASSIST]	そんなときはもう一度セレクトボタンを押してね」
one more time.”	
“I'm pretty busy myself,	「それから、ボクはこう見えてもけっこういそがしいから
and can't always come when you need me.	いつでも登場はできないんだ。
If I don't show up sometimes, don't get mad.”	でてこなくても怒らないで！」
“Later!”	「それじゃね、バイバ～イ！」
[Position Cursor]	【ポジションカーソル】
“Push [ASSIST]	「フィールドで迷ったときにはセレクトボタンを
when you're lost in the field.	押してください。
Usually, the [Position Cursor] will	ポジションカーソルが表示されます。」
appear on the screen.”	
But wait!!	さらに！！
“[Red triangles] mark the exits and	「入口をあらわす『赤サンカク』と
[Green triangles] mark ladders.”	はしごなどをあらわす『緑サンカク』も表示されます。」
	
“These will help you safely make it through even	「これで、暗い夜道も険しい山道もご安心！
the darkest streets or dangerous mountains!	なお、フィールドによっては表示されないことがあります。
But, there are times when they won't appear,	御注意ください。」
so be careful.”	
Johnny's Home	ジョニーの家
“Ha, Ha!…… Well,	「ハッハッ……。
there's nothin' wrong with that, I'd say.”	まあ、それもいいでしょうなあ」
“Ha!  Ha!……	「ハッハッ……。
I wonder if my son's already left?”	息子はもう旅立ちましたかな？」
“When it's just my wife and I here,	「こうして家内と私、二人きりになってみると
you have no idea how lonesome it gets.”	いやはや、さびしいものですなあ」
“We want him to be happy	「ハッハッ……　若いうちはね
and do other things while he's young,	好きなことをやらせてみようと思っていても
but we can't help but worry…”	やっぱり心配なのは、いけませんなあ」
“I guess we always will.”	「親として修行がたりませんなあ」
“By the way……”	「ところで、あなた」
“Where are you from?”	「故郷はおありですかな？」
A village called Nibelheim	ニブルヘイムという村だ……
Who cares?	そんな面倒なものはすてたさ
“But if you still have a family,	「でも、もし、あなたにも家族がおありなら
you outta at least write them.”	手紙ぐらい書いてあげるのが、いいですなあ」
“You may leave	「故郷はね、知らんぷりをしていても
your home, but	いつでも、あなたを待ってますよ」
it'll always be there for you.”	「ハッハッ……
“At least that's how I see it.”	まあ、そんなもんですなあ」
“Hmm…did you say Nibelheim?	「ほう……あのニブルヘイム村ですか。
Wasn't it in the news a while back?”	ほら、何年か前にニュースになったことが
	ありましたなあ」
“Something to do with a reactor accident…”	「あのときは、たしか……
	魔晄炉の事故でしたか」
“That was the first major Mako accident,	「当時は、最初の大きな魔晄炉事故ということで
I remember it was all over the news.”	すいぶん話題になりましたなあ」
“This might sound rude, but…”	「ハッハッ……ぶしつけな質問ですが」
“Is your family still living?”	「ご家族は健在ですかな？」
I forgot about them long ago	いたとしても忘れたな
I'm just an ex-SOLDIER	俺は孤独なソルジャーだ
“Well, you really outta go home again.	「ハッハッ……。
And if you can't do that,	まあ、たまには帰ってあげなさい。
try and at least remember them sometimes.”	それができないなら
	ときどき思い出すのがよろしい」
“Our boy acted like you,	「ハッハッ……。
When he was a kid.”	私も若いころはそんな風に
	かっこつけたこともありましたよ」
“You seem to be about his age.”	「ハッハッ……
	あなたは、まだそんな年ごろかな」
“Well,	「ハッハッ……。
would you mind leaving us alone?”	そろそろ、二人っきりにしてくれませんか」
	
“I want to enjoy some quiet time	「家内と二人きりの時間というのをね。
together with my wife.”	しみじみすごしたいのですよ」
“He used to give us nothing but headaches	「あんな子でもいなくなってみるとね。
when he was here, but now that	なんだか、落ちつかなくて。
he's gone…we kind of miss him.	……不思議なものね」
…Strange, isn't it?”	