Nibelheim	ニブルヘイム
TIFA	TIFA
“What!?”	「え～っ！！」
TIFA	TIFA
“This was all burnt down, wasn't it?”	「燃えちゃったはず、だよね？」
CLOUD	CLOUD
“…I thought so.”	「……そのはずだ」
TIFA	TIFA
“Then why…	「それなのに、どうして？
My house is still here too…”	私の家もある……」
BARRET	BARRET
“The hell's goin' on!?	「どうなってるんだよ！
This a dream or somethin'?”	おまえ夢でも見てたのか？」
AERIS	AERIS
“…Something's strange?”	「……なんだか、変？」
RED XIII	RED XIII
“I wonder what's going on…”	「どういうことなんだろう……」
CAIT SITH	CAIT SITH
“CLOUD, maybe you	「CLOUDさん、夢でも見とったんと
were just dreaming…?”	ちゃいますか？」
CID	CID
“Hey, it isn't like	「聞いてた話とちがうぜ！」
what you told me!”	
YUFFIE	YUFFIE
“What the…?”	「なになに！？」
BARRET	BARRET
“You said the whole town burnt down, right?”	「おまえ、この村は
	全部燃えちまったって
	言ってたよな」
AERIS	AERIS
“This is Nibelheim, right?	「ここ、ニブルヘイムだよね？
But the town's all here.”	村、ちゃんとしてるよ」
RED XIII	RED XIII
“This is Nibelheim?	「ここがニブルヘイム？
I heard it burnt down.”	燃えて全滅って聞いてたけど」
CAIT SITH	CAIT SITH
“The whole town was destroyed by Sephiroth.	「セフィロスのせいで村は全滅。
At least that's what I heard…”	そう聞いてましたけど……」
CID	CID
“Didn't you say that your hometown	「おめえ、故郷は燃えてなくなったとか
burned down?”	言ってなかったか？」
YUFFIE	YUFFIE
“I thought someone said	「村、なくなったって
this town burnt down!”	誰かから聞いたよ！」
CLOUD	CLOUD
“…Yeah.”	「……ああ」
BARRET	BARRET
“You tryin' to fool us?”	「おまえ、オレたちを
	だましやがったのか！？」
AERIS	AERIS
“Hey, what's going on?”	「ね、どうなってんのかな？」
RED XIII	RED XIII
“CLOUD…	「CLOUD……
Did you lie to us?”	オイラたちにウソついた？」
CAIT SITH	CAIT SITH
“CLOUD, did you make up that story	「CLOUDさん
just to get our support?”	同情でもひこ思て、つくり話ですか？」
CID	CID
“Yo, CLOUD.	「CLOUDよう。
It's not good to lie.”	ウソはいけねえぜ」
YUFFIE	YUFFIE
“What happened?”	「どしたの？」
CLOUD	CLOUD
“I'm not lying!”	「俺はウソなんか言ってない」
CLOUD	CLOUD
“I remember…the intense heat of the flames…”	「俺はおぼえてる……
	あの炎の熱さを……」
“Wooow…	「うぁぁぁあああ……
He's…calling…Sephiroth…	呼んで……る……セフィロスが……
is…calling…”	呼んでる……」
Got "Mind Plus!"	『マインドアップ』を手にいれた！
“The…Great…Se…phi…roth…	「セフィ……ロス……さま……
is…near..."	ちかくに……いる……」
“In…side…inside…the Mansion…	「……屋敷……の……なか……
Urrrrrrrgh…the great…Sephi…roth”	おおぉぉぉ……セフィ……ロス……さま」
“Great…Sephi…roth…	「セフィ……ロス……さま……
…left us…”	……行って……しまった……」
“Over…mountains…	「山……こえて……
…gone…”	行って……しまった……」
“What is it?”	「なんだい、あんた？」
Nothing	なんでもないんだ
I want to hear your story	話が聞きたい
CLOUD	CLOUD
“I lived in this house	「俺はこの家に１４歳まで
until I was 14…”	住んでいた……」
CLOUD	CLOUD
“No, but this town was burned down.”	「いや、それよりこの村は
	全部燃えたはずだ」
“You're sick, saying such things…”	「なにをネボケたこと
	言ってるんだい！」
“Get out of here!”	「顔あらってから
	おとといおいで！」
“Oh, really.	「そうかいそうかい。
Then, it'll help me too.”	そりゃぁ、私も助かるよ」
“What's going to happen to this Planet!?	「この星はどうなっちまうんだい！
What the hell's Shinra doing!?”	神羅カンパニーは
	何をしてるんだい！」
CLOUD	CLOUD
“A man with a black cape!?”	「黒マントの男！？」
CLOUD	CLOUD
“He has a tattoo of the number '11'…”	「『１１』のイレズミがある……」
Received "Turbo Ether!"	『エーテルターボ』を手にいれた！
“…Must…go…	「……行かな……くては……
…Reun…ion…”	……リユニ……オン」
“…Must…get…it…	「あれ……を……手にい……れ
and bring…to…Se…phi…roth…”	セ……フィロスに……とどけるの……だ」
“Then…become…one…	「そ……して……おぉ……
with…Se…phi…roth…”	セフィ……ロスと……ひとつ……に」
CLOUD	CLOUD
“This guy's number '5'…”	「この男はナンバー『５』……」
TIFA	TIFA
“CLOUD…	「CLOUD……
CLOUD was playing.”	CLOUDが弾いてた」
“I wonder what…this is?”	「なんだろう……これ」
Received "Elemental" Materia!	『ぞくせい』のマテリアを手にいれた
“It looks like Materia, but I can't hold any more.”	「マテリアみたいだけど、もうもてない」
“TIFA's secret savings,	「ピアノのけんばんの間から
1 gil came out of the keyboard.”	TIFAのへそくり１ギルがでてきた」
“I've heard this melody somewhere before.	「どこかで聞いたメロディ。
I played it well.”	なんとなくうまく弾けた……」
TIFA	TIFA
“I have the sheet music for that song.”	「その曲なら、がくふがあるわ」
“Huh? Wait a minute!	「あれ？　ちょっと待って！
There's something inside the music sheet.”	がくふの間に何かはさまってる」
“TIFA,	「TIFAよ
what's happened to our town?	この村はいったいどうなっているのだ？
Was it all an illusion, or just a dream?	あれは幻、それとも夢だったのか？
No, it was neither.	いや、そんなはずはない。
I remember trying to get people	私ははっきりと覚えている。
out of the flames, but not having the strength…	炎の中から無事な者を救いだそうとしたが
Burning with anger, I went to the	力およばず……
reactor to kill Sephiroth.”	怒りに燃えた私はセフィロスを倒すべく
	魔晄炉へ向かった。」
“But he was nowhere to be found.	「セフィロスの姿は見えなかった。
“Instead, I found you, collapsed inside.	「そのかわり魔晄炉の中で倒れていた
	TIFA、おまえをみつけたのだ。
“I felt saving you was far more important	「セフィロスを倒すよりも
than going after Sephiroth.	おまえの命を救う方が大切だと私は考えた。
“There were several others that were still	「魔晄炉の中には他にも何人か
alive inside,	まだ息のある者がいたのだが
but I was only able to save you.”	救うことができたのはおまえだけだった」
	
“As I was coming out of the reactor,	「魔晄炉から出ると、神羅の軍隊が
Shinra troops were just arriving.	到着したところだった。
“I recall a scientist named Hojo was in charge.	「指揮をとっていたのは、たしか宝条という
He ordered the troops to gather up	科学者だったと記憶している。
everyone still alive for the experiment.	宝条は【少しでも息のある者は実験用に
I didn't know what type of experiment	集めておけ】と兵士たちに命令していた。
he was talking about,	何の実験だか知らないが、かわいい弟子を
but I wasn't about to let them have	渡すわけにはいかない。」
my dearest student.”	
“Putting you on my back, I headed down	「私はおまえを背負って山をおり
the mountain to the village.	そして村を出た。
I used the Cure spell on you many times.”	私は道中何度もおまえにケアルをかけつつ」
“And started to head for Midgar	「おまえの命を救ってくれる医者を求めて
to look for a doctor for you.	ミッドガルを目指した。
I didn't like that city,	あの街は好きではないが、私のケアルだけでは
and my Cure spells weren't helping.”	どうしようもなかった。」
“I decided to go to Midgar to find	「ミッドガルの信頼できる医者におまえをあずけて
a doctor I could trust.	私は再び旅に出ることにした。
I'm worried about you, but I can't	おまえのことは心配だったが
settle down in one place for very long.”	ひとつ場所にとどまっていられないのが
	私の性分だ。」
“Have you recovered fully? Are you well?”	「傷はすっかり良くなっただろうか？
	元気にしているだろうか？」
“I wonder how many years have	「あれから、何年がすぎたのだ？
passed since then?	私はふらりとこの村に戻ってきたが
I just got into town again,	正直なところ、おどろいている。
but I can't believe it…	村は元通りだが、黒い服の不気味な者たちが
The whole town is back to normal,	うろついている……。」
except for the strange people	
with black clothes all around.”	
“The town reeks of Shinra,	「神羅のにおいがぷんぷんするが
but I won't go after them.	私は深追いするつもりはない。
You may think I'm running from them,	逃げていると言われればそれまでだが
but it's just that	神羅にかかわるのは、もういやなのだ。
I don't want anything to do	さて、TIFA。
with Shinra anymore.	この家の者が戻って来ないうちに
Feels like time is running out.”	ここを立ち去らなくてはならない。
	時間はなさそうだ。」
“I'm sure you'll find this letter.	「おまえは必ずこの手紙を見つけるにちがいない。
And this gift for you. It should come in handy.	それを信じてここに私からのおくりものを
	隠しておく。
	きっと役に立つだろう。」
“I want to give it to you myself,	「直接渡したいところだが弟子に老いた自分を
but it's hard for my students to see me as an old man.	見られるのはつらい。
I can't even jump anymore.	もう私はジャンプさえ出来なくなってしまった。
But I hope you continue to sharpen	私の技、おまえがみがきあげてくれることを
your skills and remember what I taught you.”	ねがっている。」
“To my most precious student,  From Zangan”	最愛の弟子へ　ザンガン
Tifa's Final Mystery?	TIFAの最終奥義
Received "Final Heaven"	『ファイナルヘブン』を手にいれた
TIFA	TIFA
“Did you play my piano?”	「私のピアノを弾いたの？」
No, I didn't	いや、弾かなかった
Yeah, I jammed on it	ギンギンに弾いた
Just a little…	ちょっとだけ
CLOUD	CLOUD
“I can read sheet music too, you know.	「俺だって、がくふくらい読め……
Ummm, let's see…”	えっと……
“Do…\ Re…> Mi…> Ti…\ La…\	「ド…レ…ミ…シー…ラー…
> Do…> Re…> Mi…> So…> Fa…> Do…> Re…> Do…\	ド…レ…ミ…ソ…ファ…ド…レ…ド…
Forget it…”	いいや、もう」
CLOUD	CLOUD
“Play the piano?”	「ピアノでも弾くか……」
No, forget it	いや、やめておこう
Aw, go for it	ちょっとだけ
“…Now, how did this go?”	「……どうやって弾くんだったかな？」
I forgot	忘れた
I remember	おぼえてる
Do [CANCEL]	×　ド
Re [SWITCH]	□　レ
Mi [MENU]	△　ミ
Fa [OK]	○　ファ
So [PAGEUP]/[PAGEDOWN] + [CANCEL]	Ｒ１かＬ１と×　ソ
La [PAGEUP]/[PAGEDOWN] + [SWITCH]	Ｒ１かＬ１と□　ラ
Ti [PAGEUP]/[PAGEDOWN] + [MENU]	Ｒ１かＬ１と△　シ
Do [PAGEUP]/[PAGEDOWN] + [OK]	Ｒ１かＬ１と○　高いド
Do Mi So (C)Directional key Down	方向キー下　ドミソ（Ｃ）
Do Fa La (F)Directional key Left	方向キー左　ドファラ（Ｆ）
Re So Ti (G)Directional key Up	方向キー上　レソシ（Ｇ）
Mi So Do (C)Directional key Right	方向キー右　ミソ高いド（Ｃ）
End[START]	スタートボタン　終了
Use [START] to end.	スタートボタン　終了
CLOUD	CLOUD
“But…I definitely remember	「あのとき……
playing the piano then.	確かにこのピアノを弾いた。
So why wasn't it burnt down?”	でも、なぜ焼けなかったんだ」
CLOUD	CLOUD
“A man in a black cape?”	「黒マントの男！？」
CLOUD	CLOUD
“Tattoo number '4'”	「『４』のイレズミだ」
Received "Platinum Fist!"	『プラチナフィスト』を手にいれた！
“…Where…are…you?	「……どこ……で……す……か？
Great…Se…phi…roth…”	セフィ……ロス……さま」
“Periodic Report to Professor Hojo”	定期報告　宝条博士へ
	
1  Clone Activity Report	１　コピー行動記録
	
“Unfortunately, no 'CLONES' have left	「残念ながら今期も村を出て行った
this town this quarter.	【コピー】はいません。
As previously reported, the 'CLONES 'seem	すでに報告させていただいたとおり
to be sensing something.”	【コピー】たちは確かに何かを
	感じてはいるようです。」
“But all they say is, 'Reunion' or 'Sephiroth'	「しかし、うわごとのように
and show no other signs of activity.”	【リユニオン】【セフィロス】などと
	言うだけであり、どこかに旅立つという
	気配はまったくありません。」
2  Confidentiality Report	２　機密保持関係報告
	
“A total of eight people have visited	「今期に村をおとずれた人間は計８名。
this town this quarter.	
	
“Fortunately, none knew about	「さいわい、今期も、５年前の事件を
the incident five years ago.	知っている者はいませんでした。
“Therefore, no one knows the town was restored	「ですから、村が燃える前と同じように
exactly as it was five years ago.	再建されたことに気づいた者はいません。
Our staff, disguised as townspeople,	村人のふりをしているスタッフの
have improved their acting skills,	演技もなかなか上手くなりましたので
and we do not report any problems	こちらの方は間題なしと思われます。」
at this time.”	
	
That is all.	以上、報告いたします
“Hi, welcome.”	「はい、いらっしゃい」
Give me a room	とめてくれ
What's your story?	話が聞きたい
“It'll be 100 gil a night.	「１泊１００ギルになります。
Is that all right with you?”	よろしいですか？」
Yes.	たのむ
Never mind.	やっぱりやめる
“Enjoy your stay.”	「では、ごゆっくりどうぞ」
“You don't have enough money.”	「お金……足りないですね」
“Well, maybe next time…”	「では、またの機会に……」
“Oh, I'm so sorry.	「あ、すいません。
I've got lots to do…”	ちょっと仕事が
	たてこんでますので……」
CLOUD	CLOUD
“This town was supposed to have	「この村は５年前に
burnt down five years ago.”	全部燃えてしまったはずだ」
“What the hell is going on?”	「いったいどうなってるんだ？」
“Sir, don't say such awful things.”	「お客さん、変なこと
	言わないで下さい！」
“I was born and raised in this town.	「私はこの村で生まれ育ちました。
What you say never happened.”	そんなことは全然なかったですよ」
TIFA	TIFA
“You're lying…”	「おじさん、ウソついてる……」
“EXCUSE ME! That's so rude…”	「失礼だなぁ……」
“If you're going to talk like that,	「変なこと言うなら
I'm going to have to ask you to leave.”	出ていってもらいますよ」
“I'm checking the Mako boiler.	「魔晄ボイラーの調子が見てるんです。
Please don't bother me now.”	ジャマしないでくださいよ」
“…Welcome.	「……いらっしゃい。
It's 100 gil a night…”	１泊１００ギルですが……」
Spend the night.	とまる
Don't stay.	やめる
CLOUD	CLOUD
“Man in a black cape?”	「黒マントの男！？」
CLOUD	CLOUD
“He has a tattoo number '6'.	「『６』のイレズミがあるな。
Hmm? He has something…”	ん？　何か持ってる……」
Received "Luck Source!"	『ラックアップ』を手にいれた！
“Urrr…rrrrr…rrrgh…	「う……あ……ぁああ……
Must…go to…Re…union…”	リユ……ニオン……行きたい……」
Nibelheim House	小さな姉弟がいた家２階
	
“Re…union.”	「……リュ……ニヨン」
“….”	「………………」
“Re…union.”	「………………ヨン」
CLOUD	CLOUD
“…The Black Cape…”	「黒マントの……」
Received "Luck Source!"	『ラックアップ』を手にいれた！
“Nice town, huh?”	「ここはいい村でしょ？」
“We've been in business here	「あたしらは昔っから
for a long time…”	ここで商売してますけどね……」
CLOUD	CLOUD
“…You're lying.”	「……ウソだ」
“Do you have anything to do	「もしかして……
with this town?”	あなた、この村の関係者？」
How about bein' born and raised here?	そう、この村で生まれ育った
Nope, guess not	いや、ちがう
CLOUD	CLOUD
“I was here until I was 14,	「１４歳までここにいた。
and I don't remember you.”	俺はあんたなんか知らない」
CLOUD	CLOUD
“…Nothing.”	「……なんでもない」
“It's not nice to lie!!”	「ウソはいけませんよ！！」
“Oh yeah?”	「ホッ……」
“How can you shop at a time like this?”	「あんたら、こんな時に
	買い物なんかして、どうするの？」
“What? Me, in business?”	「えっ？　商売だろうって？」
“Don't worry, it's all right.	「いいのいいの、ウチは会社から
I get paid by the company.”	給料出てるから」
“But my real job is protecting	「ニブルヘイムの秘密を守るのが
Nibelheim's secret.”	ウチらの本当の仕事なんだよ」
“What? Secret?”	「えっ？　秘密？」
“We don't have a clue.	「ウチらは知らないな。
But it's all right.”	でも、いいのいいの」
“It's all over anyway!”	「もう全部終わりなんだからさ！」
“Finished, finito, over!!	「終わり終わり終わり！！
Even as we speak Meteor…	ああ、こうしてる間にも
This is the end!”	メテオが～！　終末が～！！」
CLOUD	CLOUD
“A man in a black cape!?”	「黒マントの男！？」
CLOUD	CLOUD
“He has a tattoo of the number'12'.	「『１２』のイレズミがあるな。
Mmm? He has something.”	ん？　何か持ってるぞ」
Received"Elixir"!	『エリクサー』を手にいれた！
“Can…you…hear?	「聞こ……え……る？
The…voice…of…Se…phi…roth?”	セフィ……ロスの……声……」
“Something is written on the back	「ふたのウラに文字がきざまれている」
of the lid.”	
(1)Right 36	【１】　…　右　３６
“Something is written on the floor.”	「ゆかに文字がきざまれている」
(2)Left 10	【２】　…　左　１０
“Something is written on the floor.”	「ゆかに文字がきざまれている」
(3)Right 59	【３】　…　右　５９
“Something is written on the back	「ふたのウラに文字がきざまれている」
of the lid.”	
(4)Right 97	【４】　…　右　９７
“I have a bad feeling about this…”	「いやな予感が……」
Open the safe	それでも金庫をあける
Don't open it	やめる
[Empty Entry]	メモリ
[Empty Entry]	メモリ
Success	せいこう
Fail	失敗
Received Key Item "Key to the Basement"!	キーアイテム『地下室のカギ』を手にいれた！
C project	ＣーＰＲＯＪ
specimen(B)  codeC	サンプル　ー　Ｂ（コードＣ）
“A scratch left by a fingernail inside	「ビーカーの内がわにツメで
the beaker…	キズつけたあとが……
Let's get out of here…'.”	『ここから逃げよう……』」
C project	ＣーＰＲＯＪ
specimen(A)  codeZ	サンプル　ー　Ａ（コードＺ）
“A scratch left by a fingernail inside	「ビーカーの内がわにツメで
the beaker…	キズつけたあとが……
Feeding Time'…that's our chance…!”	『エサの時間が…チャンスだ……』」
“Escapee Report no. 1	「逃亡者に関する報告書　１
X Month X Day	Ｘ月Ｘ日
Two escapees were located	当施設から逃亡した２名を
near Midgar.”	ミッドガル近辺で発見しました]
“Escapee Report no. 2	「逃亡者に関する報告書　２
Description at the time of capture.	発見時の状態
“A  Former member of SOLDIER/Number(   )	「Ａ　元ソルジャー／ナンバー【無】
No effect could be detected from	魔晄照射およびジェノバの影響は
either Mako Radiation Therapy	見受けられませんでした。
or Jenova on him.	
“B  Regular/Number (   )	「Ｂ　一般／ナンバー【無】
Reaction to Jenova detected.”	ジェノバへの反応過多が見受けられました」
“Escapee Report no. 3	「逃亡者に関する報告書　３
Status.”	：処分に関して」
A  Shot for resisting.	Ａ　抵抗したため、射殺。
B  Escaped during A's resistance.	Ｂ　Ａが抵抗する間に逃亡
“Escapee Report no. 4	「逃亡者に関する報告書　４
Other	：その他
“B's whereabouts is currently unknown.	「現在、Ｂの行方は不明です。
But pursuit is unnecessary due to	しかし、Ｂは意識の乱れが
his diminishing consciousness.	かなり進行している様子でしたので
Awaiting further instructions.”	このまま放置しておいても
	間題は無いというのが我々の見解です。
	今後に関する指示をおねがいします」
CLOUD	CLOUD
“Sephiroth!”	「セフィロス！」
Sephiroth	セフィロス
“Being here brings back memories.”	「なつかしいな、ここは」
Sephiroth	セフィロス
“Are you going to participate in the Reunion?”	「ところで、おまえはリユニオンに
	参加しないのか？」
CLOUD	CLOUD
“I don't even know what a Reunion is!”	「俺はリユニオンなんて知らない！」
Sephiroth	セフィロス
“Jenova will be at the Reunion.	「ジェノバはリユニオンするものだ。
Jenova will join the Reunion,	ジェノバはリユニオンして
becoming a calamity from the skies.”	空から来た厄災となる」
CLOUD	CLOUD
“Jenova, a calamity from the skies?	「ジェノバが空から来た厄災？
You mean she wasn't an Ancient!?”	古代種じゃなかったのか！？」
Sephiroth	セフィロス
“…I see.	「……なるほど。
I don't think you have the right to participate.”	おまえには参加資格はなさそうだ」
“I will go North past Mt. Nibel.	「わたしは【ニブル山をこえて北】へいく。
If you wish to know…then follow…”	もしお前が自覚するならば……
	わたしを追ってくるがよい」
CLOUD	CLOUD
“…Reunion?	「……リユニオン？
Calamity from the skies?”	空から来た厄災？」
Hojo's Letter	宝条の手紙
“I must get rid of all those	「私の研究の邪魔をする者を全て
that stand in the way of my research.	取り除かなければならない。
Even that one from the Turks.”	タークスのあの男も例外ではない」
“I scientifically altered him	「私はタークスの男に生体学的な改造を
and put him to sleep in the basement.	ほどこし、地下に眠らせた。
If you want to find him, search the area.”	もし興味があるなら探してみるがよい」
“But…this is merely a game I thought of.	「ただし……これはあくまで私がきまぐれで
It is not necessary	おもいついたゲームにすぎない。
for you to participate	むりにつきあってくれる必要はない」
if you don't want to.”	
“There seems to be another letter.”	「手紙は２まいあるようだ」
Read it	もう１まいの用紙をみる
Ignore it	無視して旅を急ごう
“Move the dial on the safe carefully	「金庫のダイヤルはしんちょうに
but quickly. You have 20 seconds.	かつ、すばやくまわす。２０秒以内だ。
You can not go past the numbers while turning.	少しでも行き過ぎてはいけない。
The 4 hints for the numbers are…”	４つのダイヤルのヒントは……」
dial (1)	ダイヤル　【１】　のヒント
dial (2)	ダイヤル　【２】　のヒント
dial (3)	ダイヤル　【３】　のヒント
	
The lid of the box with the most oxygen.	酸素が一番多いハコのふた
Behind the Ivory's short of tea and ray.	空のない黒と白のウラ
“The creek in the floor near the chair	「２階のイスのそばのユカのきしみ……
on the second floor…	そこから左５歩、上９歩、左２歩、上６歩」
then to the left five steps, up nine steps,	
left two steps, and up six steps.”	
The fourth row has been written in invisible ink…	４行目があぶりだされた……
Dial (4) is  (Right 97)	ダイヤル　【４】　は　【右　９７】
“Look, something is written on the back…”	「よく見るとウラにも文字がかいてある……」
Look at the back	ウラを見てみよう
Ignore	無視しよう
“You still don't get it?	「まだわからないのかね？
Don't give up if you've only checked it once.	一度調べたからって安心してはだめだよ。
You have to be persistent.”	しつこく調べなくては」
“Look, this letter could be in invisible ink.”	「よく見るとこの手紙はあぶりだしのようだ」
Read it	あぶりだしてみよう
Ignore it	無視しよう
“There are four things in this mansion…	「この屋敷の中で４つあるもの……
Check more closely.”	それをもっとよく調べてみてくれ」
“Something is written on the back of the lid.”	「ふたのウラに文字がきざまれている」
(1)   Right 36	【１】　…　右　３６
“There's a carving in the floor.”	「ゆかに文字がきざまれている」
(2)   Left 10	【２】　…　左　１０
“There's a carving in the floor.”	「ゆかに文字がきざまれている」
(3)Right 59	【３】　…　右　５９
“Something is written on the back of the lid.”	「ふたのウラに文字がきざまれている」
(4)  Right 97	【４】　…　右　９７