“Better ask the Captain about this town.	「この村のことなら艇長に聞いてくれ。
He's the one in charge of it.”	ここを仕切ってるのはアイツだからな」
Captain?	艇長って？
Did you see a man in a black cape?	黒マントの男を見たか？
“The Captain was a pilot	「艇長は神羅カンパニーが
when Shinra was still interested	まだ宇宙開発に手を出していたころの
in their Space Program.”	パイロットさ」
“He was going to be the world's	「世界初の宇宙飛行士になる
first astronaut,	予定だったのだが
but there was an accident…”	ま、ちょっとした事故があってな」
“Ever since then, he's been wasting	「で、まあ、それ以来ここで
his life away here dreaming about	宇宙に飛び立つ夢を見ながら
going into outer space.”	くすぶってるってわけよ」
“A man in a black cape?	「黒マントを着た男？
Nope…never seen him.”	さあ……知らないなあ」
“This used to be a Shinra base	「ここは元々神羅の
where they used to launch rockets.”	ロケット打ち上げ基地だったのじゃ」
“You saw the leaning rocket, right?	「かたむいたロケットを見たじゃろ？
That's Shinra No. 26.	あれが神羅２６号じゃ。
It never got off the ground though.”	一度も飛んだことはないんじゃが」
“Everyone in this town was a mechanic	「ここの住人は
back when they were planning to	みんなロケット打ち上げ計画のときの
launch the rocket.”	メカニック仲間なんだ」
CLOUD	CLOUD
“Rocket launch plan?	「ロケット打ち上げ計画？
What do you mean?”	何のことだ？」
“You don't know?”	「君たち、知らないのかい？」
“There was a plan to send a man	「神羅の宇宙開発部門の長であるパルマーの
into outer space.	主導で、人間を宇宙におくろうとした
It was headed up by the leader of	計画があったのさ」
the Shinra Space Program, Palmer.”	
“This town is the result of the plan,	「でも、その計画も中断しちゃってね……
but the plan got cut…”	この村は、その計画のなごりなのさ」
CLOUD	CLOUD
“Who's the 'Captain'?”	「艇長とは、誰のことだ？」
CLOUD	CLOUD
“Did you see a man in a black cape?”	「黒マントを着た男を
	見なかったか？」
“Did you meet the Captain already?	「艇長には、もう会ったかい？
He's really the town's representative,	この村の顔とも言える男だから
so you should really talk with him.”	一度会っておくといいよ」
“Welcome to the Shanghai Inn!”	上海亭に、ようこそっす！
“It's 100 gil a night.	一泊１００ギルですけど、とまるっすか？
Would you like to spend the night?”	
Yes	はい
No	いいえ
“Yes sir. Thank you!”	「へいっ、まいどっす！」
“Well then, come by again sometime.”	「ん～、また来てくださいっす」
“Excuse me.	「お客さん、困るっすよ。
Please don't come in here.	こっちには台帳や部屋の鍵とかが
Our books and the room keys are in here,	置いてあるんで、入ってこないで
so I'll have to ask you to please stay out.”	ほしいんすけど」
CLOUD	CLOUD
“The books…	「台帳……宿泊客の名前がわかるかもな」
Maybe we could find out who's been here?”	
Was there a man in a black cape?	黒マントの男はいないか？
Not interested	興味ないね
“Look, we're all adults here,	「そうそう、お客さんもオトナなんすから
so I'd appreciate it	フンベツってものをもってほしいっす」
if you used some discretion.”	
“A man with a black cape?	「黒マントの男っすか？
No, no one like that	そんな人は泊まってないっす」
has ever stayed here.”	
“Would you like something to drink?”	「何か飲んでいかれますか？」
Let me hear your story	話を聞かせてくれ
Not interested	興味ないね
“CID's had some bad breaks.	「CIDもかわいそうにな。
It's really no one's fault	あいつが宇宙に行けなかったのは
he couldn't go into space.”	誰が悪いのでもない」
“Just bad luck, I guess…”	「ただ、ツキがなかっただけさ……」
“If he keeps up like that,	「そんなふうに心の余裕がないのでは
he's gonna collapse someday.	いつか倒れてしまいますよ。
Y'know what I mean?	心の重圧にたえかねて、ね」
I'm talkin' heart attack.”	
“…That's too bad.	「…………残念です。
Please come again.”	また、おいで下さい」
“A drink will ease your heart…”	「１杯の酒は
	こころの安らぎ……」
“Welcome!	「ようこそ！
This is the Item Shop.”	ここはアイテム屋です。」
“…Hey now!	「……困りますねぇ。
I would appreciate it	こーゆーとこには入ってこないで
if you wouldn't come in.”	いただきたいのですが」
CLOUD	CLOUD
“What's that?”	「あれは……！？」
CLOUD	CLOUD
“A rusty old rocket…	「サビついたロケット……
Wonder why they made	何のために、こんな巨大なものが……？」
something so huge?”	
“That rusted out rocket is	「あのサビついたロケットは
all that remains of	神羅カンパニーが宇宙開発に
the Shinra's Space Program.”	力を入れていたころのなごりさ」
“It just looms there.	「あすこにそびえるが
That's how the town got its name…	この村の名前の由来
Shinra No. 26'.”	宇宙ロケット『神羅２６号』じゃ」
“Want to look at the rocket with me?”	「どうじゃ？
	わしと一練に見上げてみるか？」
Yeah, let's take a look	見上げる
No, not interested	見上げない
“I get so impressed	「何度見ても、感動するのぉ」
every time I look at it.”	
“Oh, how boring…”	「なんじゃ、つまらん……」
“All gramps does is	「ウチのじいさんったら
gaze at that rocket all day long.”	一日中ロケットばかりながめておるのぉ」
“Well, he really	「ありゃあ、機械が大好きな
loves machinery…”	男じゃからのぉ」
Locked	カギがかかっている……
“Excuse me…	「お客さん……
You don't have enough money.”	お金、足んないっすよ」
“Let me handle	「武器やアクセサリーの事なら
all your weapon and accessory needs!”	まかせてくんな！」
“There's a bunch of Shinra people	「なんか、神羅の人間が
here messin' with the rocket…”	ぎょ～さんやってきて
“Is my rocket…all right?”	ロケットをいじりまわしちょるが……」
“The Shinra serious 'bout launching	「わしのロケット……大丈夫かの？」
that piece of crap rocket?	「あのボロロケットを打ち上げるって
But why now?”	神羅のやつら、本気なのかね？
	何をいまさら……」
“…I'm in here.”	「……入ってるよ」
“Urrrrgh, urrrgh”	「う～ん、う～ん」
“P…	「くーーーっ
Urrrrgh…aaaaaghh…”	つ、つらい……」
“There's a lot happenin'	「なんか、外の世界では
in the world outside,	色々起こっているようじゃが
but as long as I got this rocket	わしはこのロケットさえあれば
I'm satisfied.”	じゅ～ぶんマンゾクじゃ」
“Anyways.”	「と・こ・ろ・で」
“How 'bout it?	「どうじゃ、あんた？
Want to look at the rocket with me?”	わしと一練にロケット見上げんか？」
Look up	見上げる
No	見上げない
“My, my precious rocket…	「わ、わしの愛しいロケットが……
It's gone.”	行ってしもうた」
“Hmph, I know.	「ふっ、わかっておるさ。
No matter how much I look,	いくら見上げても
the rocket's still gone.”	もうあのロケットがないことはな」
“But I just can't stop it.	「しかし、あきらめきれんのじゃよ。
Just call it an old man's	老人のグチと思うて笑ろうてくれ」
folly if you will.”	
“What's young President Rufus	「ルーファウスの若社長
doing by getting	メカニックたちを集めて
all those mechanics together?”	どーするつもりなんだろ？」
Guard	警備兵
“Those terrorists are here!”	「テロリストどもが来たぞ！」
Guard Captain	警備隊長
“Don't let them get any further!	「ここより一歩も進ませるな！
Everyone, ATTACK---!”	総員、突撃ィ～～！」
Oh, I'm getting excited.	わくわくしちゃう
“Mmm, a SPECTACLE.”	「ん～、スペクタクル～」
Guard Captain	警備隊長
“Urrrgh, you're not going anywhere!"	「ぬうう、行かせはせん！
Uh un, nowhere!”	行かせはせんよ！」
CID	CID
“Goddammit, what the hell do they think	「チクショウ、あいつら！
they're gonna do to my rocket!?”	オレ様のロケットに何しやがる気だ！」
CID	CID
“I'm outta here, CLOUD!	「行くぜ、CLOUD！
I'm gonna kick those $^%$# Shinra	神羅のクソッタレ野郎どもを
right out of my rocket!”	オレ様のロケットから、たたきだしてやる！」
CID	CID
“Wait, CLOUD!”	「待ってくれ、CLOUD！」
CID	CID
“If you're gonna kick those *#$% Shinra	「オレ様のロケットから
out of my rocket,	神羅のクソッタレ野郎どもをたたきだすんだろ？
then take me with you!”	オレも連れてってくれ！」
CID	CID
“ALL RIGHT!	「よっしゃ！
Let's show those &$!@& Shinra!”	神羅どもに目にもの見せてやろうぜ！」
CID	CID
“CLOUD, what are you doin'!?	「CLOUD、何してる！
They're gonna launch the rocket!!”	ロケットが発射されちまうぞ！！」
Rude	ルード
“You again?”	「……おまえたちか」
Rude	ルード
“We will eliminate everyone who	「……神羅の計画を
gets in Shinra's way.”	邪魔するものは、排除する」
Rude	ルード
“…They got us.”	「……やられた」
Rude	ルード
“…Hmm.”	「……ふむな」
“What?	「なに、なに？
You guys are terrorists?	あなたたち、テロリストなの？
Wow, that's kinda exciting!”	わくわくしちゃう」
“Mmm, here comes some hard action!”	「ん～、ハードアクション～」
“Hmm.	「う～ん。
Is it real or fake?”	本物なのかニセ物なのか？」
“I'm so curious I can't sleep.”	「気になって、気になって
	夜もねむれないよ～」
“Mmm…	「う～ん。
I'm starting to see it now…	そろそろ見あきてきたなぁ
Sorry to get you into this.	わしの趣味につきあわせてしまって
For me, it's a kinda hobby.”	すまんのぉ」
“But, out of appreciation,	「お礼と言ってはなんじゃが
let me give you this.”	これをあんたにあげよう」
“I wish you'd	「だいじに使ってもらえると
take care of it and use it…”	わしもうれしいんじゃが……」
“Maybe it's time for me to	「わしも、そろそろ新しい趣味を
get a new hobby…”	探してみようかのぉ……」
“Oh, it's you?	「ああ、あんたたちか。
I heard you and the Captain	艇長と組んで、ハデにやったようだね」
really made a BANG!”	
“I also heard that Rufus was so pissed off	「あの後、ルーファウスはカンカンで
he went on a rampage and that	手がつけられなかったそうだよ。
no one's been able to get near him!”	ふふふ、久々にスッとしたよ」
“If things go on like this,	「このままだと、メテオがふってきて
then Meteor's just going to smash	みんな死んでしまうんだって？
right into us and kill us all, right?	……まあ、人生そんなもんかもね」
…I guess that's life?”	
“I get so restless with the rocket gone.	「ロケットがなくなってしまったから
And now that we can see Meteor clearly,	どうも落ち着かないんだよね。
…I can't stand it.”	前よりもメテオがはっきりと
	見えるようになったし……たまんないね」
“I heard Tiny Bronco broke…”	「タイニー・ブロンコを壊してしまった
	って話を聞いたけど……」
“That sucks.	「困っちゃうなぁ。
I was secretly eyeing that thing.	ひそかに僕が狙っていたのになぁ。
Broke, huh? What a drag.”	壊れちゃったのかぁ。残念」
“Look up at the sky.	「空を見てみるといいよ。
The bigger Meteor gets,	メテオがあんなに大きく見えるようでは
the less time we have to live.”	もう、われわれの命も長くはないね」
“I still can't believe that	「しかし、信じられないよ。
piece of crap rocket	あのボロっちいロケットが
actually made it into space…	宇宙に行ったとはねぇ……」
“I guess the mechanic was a genius.”	「やっぱり、メカニックが優秀だった
	ってことだな、きっと」
“Because those Shinra creeps locked us	「この前、神羅のヤツらが来たときに
up in our houses, we couldn't	わしらを家におしこめてくれたおかげで
even watch the rocket lift off.”	あの日はロケットを見上げられなかったわい」
“I never thought that my only hobby	「ルーファウスごとき若造のせいで
would be destroyed by that	わしのコウショウなシュミが。
arrogant young Rufus!”	邪魔されるとは……！」
“Mmm. You know that Shinra sports car	「う～む。CIDの家にある
at CID's house?	神羅のスポーツカー……
It might be fun to try and restore	あいつをレストアしてみるのも
that thing…”	おもしろいかもしれんな……」
“Welcome to the Shanghai Inn!	「上海亭に、ようこそっす！
Only 300 gil a night?”	一泊３００ギルですけど、とまるっすか？」
Yes	はい
No	いいえ
“Y'know, I heard Rufus rushed back	「そういえば、ルーファウスさんは
to headquarters in Midgar…”	あわててミッドガルの本社ビルに
	帰ったようでしたが……」
“Even though they failed to blow up	「ロケットによるメテオ爆破が
Meteor with the rocket,	失敗におわっても、神羅はまだ
the Shinra haven't given up yet…”	あきらめてはいないようですね」
“Looks like they're gathering all the weapons	「各地の施設からいろいろな兵器を
from all their bases and	集めて、最後の抵抗をしようと
are preparing for a final showdown.”	しているようです」
“I heard a rumor that a Shinra airship	「そういえば、秘密兵器を運んでいた
carrying a secret weapon was attacked by	神羅の飛空艇が、モンスターにやられて
a monster and sunk to the bottom of the sea…”	海底に沈んだ、というウワサですが……」
“You don't feel comfortable here?	「ここにいると、落ち着きませんか？
Then, everytime you look in the sky	空を見上げると、イヤでも
you see Meteor.”	メテオが目に入りますからね」
“How long's that guy gonna be	「向かいの席にすわっていたヤツ
in the bathroom?	いつまでトイレに入っているのかな？
I need to go, too…”	オレも使いたいのによぉ……」
“Seems like Palmer of Shinra, Inc.	「神羅のパルマーさんが
ordered soldiers	兵士を引き連れてロケットを
to restore the rocket…”	整備しているようですが……」
“Meteor's coming toward us!?	「メテオがふってくるんだって！？
And I can't even go to the bathroom…!?”	おまけに、いつまでたってもトイレは
	使えないしよ……」
“OK, which is gonna happen first?	「こうなりゃ意地だ。
Meteor hits us,	メテオがふってくるのが早いか
or that guy comes out of the bathroom?”	あいつがトイレから出るのが早いか」
“I'm not movin' from this spot	「オレは、この目で見とどけるまで
till I see it with my own eyes.”	ここから離れないぞ」
“Even with all this goin' on outside,	「こんな騒ぎになっても
that guy still won't come out	トイレから出てこない……
of the bathroom?	実はあいつ、すごい大物なのかも！？」
He must be a damn water tank!?”	
“Is Gramps gonna stay like that	「ロケットもなくなったってのに
even though rocket's gone?”	ウチのジイサンは
	いつまであーしとるつもりなんじゃろ？」
“Geeeeez, it's boring!	「ああ、つまらないわ……
Isn't anything exciting going to happen here?”	何かおもしろいことはないかしら？」
“Now that one of Shinra's greatest events is over,	「神羅の一大イベントも終わってしまったし
I guess it's back to	また、つまらない毎日が始まるのね……」
the same old boring life again…”	
“Mmm, I'm so bored.	「うーん、ヒマだなぁ。
Isn't there anything that can excite me?”	何かワクワクすることはないかな？」
“Even the rocket launch wasn't all THAT great.”	「ロケット打ち上げも、終わってしまえば
	たいしたことでもなかったなぁ」
Shera	シエラ
“I'll take care of everything at home.	「この家のことは
But please take care of the Captain.”	わたしにまかせておいてください。
	……艇長をよろしくおねがいします」
Shera	シエラ
“What's going to happen?”	「……この世界は
	どうなってしまうのでしょう？」
Shera	シエラ
“Now all we have to take care of	「あとは、あのメテオをなんとかすれば
is Meteor, right?	いいのですね。
You should be able…”	あなたたちなら、きっと……」
“Excuse me…	「あの……
…Please take care of the Captain.”	……艇長をよろしくおねがいします」
There're tons of what look	こっとう品と言ってもいいような
like antique guns.	銃が、山のようにかざってある。
…I bet the owner of this store	……きっと、この店のオーナーは
was a real gun fanatic.	かなりのガンマニアなのだろう。
“A gun is a MAN'S weapon!	「男の武器は、銃だ！
Nuthin' else'll do!”	それ以外は認めん！」
“Hmm, let's see…	「ん～、何かおもしろいシャレは
do I know any good jokes?”	ないかな？」
“It's my job to make people laugh	「世界の人々を笑わせること。
all over the world…”	それがわたしの使命……」
“Hey CID!	「おっ、CID！
I just thought of the best joke!	ついに究極のシャレを考えついたんだ！
Listen to this one.”	ぜひ聞いてくれよ」
CID	CID
“I'm so sick of hearing these dumb puns,	「おまえのダジャレは聞きあきたが
but okay…let's get it over with.	しかたないから聞いてやる。
Go on…let me hear it.”	ホレ、言ってみろ」
“Uh, now, let's see,	「ええと、なんだったっけな……」
how did it go?”	
“…'He's crude an' a jerk'…	「『みんな、のたうち回ってるど』
I mean,	じゃなくて
He's 'Rude of the Turks'!”	『神羅のタークスのルード』
	って奴がきてるぜ」
“'President Rufus, lathers Tantrics'…	「『ルーファウスの若社長は目がみっつ』
Uh, I mean…	じゃなくて
President Rufus, gathers mechanics'…”	ルーファウスの若社長はメカニックを集めて」
“'Raunchy meat, a pocket full, at the cafeteria'.	「『あんたのブランケットにまったりとしたハム』
Uh, I mean…	じゃなくて
Launch a beat up rocket full of Materia'.”	あんたのボロロケットにマテリアボムを積んで
	打ち上げるつもりらしいぜ」
CID	CID
“And I thought it might be fun to hear some of	「……久しぶりに会って
your stupid puns again for old times sake…	おめえのくだらねぇダジャレも
my mistake.”	なつかしいと思ったが……」
“Oh, 'crap-again'(oh, captain).”	「いやいや
	そんなていちょう（艇長）にほめるなよ～」
CID	CID
“Dammit! That does it!”	「やっぱムカつくぜ！」
“How rude…”	「ひ、ひどい……」
CID	CID
“Rude, hell!	「けっ！
You're the one who always cracks	おめえがつまらねぇこと言うからだ」
those #$##@& jokes!”	
CID	CID
“Sorry, 'bout that, now lesse…”	「いらん邪魔が入ったが……」
“Looks like that *&%$#^$ Rufus wants to	「ルーファウスのボンボン野郎が
use my rocket for somethin'.”	オレさまのロケットを使って
	何かやらかすつもりらしいな」
“Let's go to the launching pad!”	「ロケットの発射台の方に
	行ってみるとすっか！」
“(A fearful sense of humor…)”	「（お、恐るべしギャグセンス……）」
“(A fearful sense of humor…)”	「（お、恐るべしギャグセンス……）」
CLOUD	CLOUD
“…??”	「……？？」
“Ugh…	「ぐぅ……
Nice kick.”	ナイスキック」
“I got to learn more…	「もっと、修行せねば……
Devotion, devotion.”	精進、精進」
CID	CID
“DAMMIT!	「けっ！
No more of them ^$#%$@# puns!”	おめぇのダジャレなんぞ、聞きたくもねぇ」
CID	CID
“And?”	「で？」
CLOUD	CLOUD
“(The problem starts way	「（センス以前の間題さ……）」
before his sense of humor.)”	
“Would you like a drink?”	「何か飲んでいかれますか？」
Let's hear your story	話を聞く
No thanks	えんりょしておく
“Shinra's trying to gather the Huge Materia from	「神羅は【コレル】、【コンドルフォート】の
Corel and Fort Condor.	ヒュージマテリアを回収しようとしちょる。
There are four left,	最終的には４つ集めて
and they're transporting them here.”	この村に運んでくるらしいわい」
“I can't stand the thought of them using my	「わしの大事なロケットを
rocket for something like this.”	こんな事に使おうとするとは……
	たまらんのぉ」
“Shinra's trying to gather the Huge Materia from	「神羅は【ジュノンの海底魔晄炉】の
the Junon Underwater Reactor.	ヒュージマテリアを回収しようとしちょる。
There are four left,	最終的には４つ集めて
and they're transporting them here.”	この村に運んでくるらしいわい」
“I can't stand them using my precious rocket for	「わしの大事なロケットを
a thing like this.”	こんな事に使おうとするとは……
	つらいのぉ」
“Authorized personnel only.”	「えっと、ここは
	関係者以外立入禁止っす」
Shera	シエラ
“Excuse me…CLOUD?”	「あ……CLOUDさん」
Shera	シエラ
“Did the Captain say anything?”	「艇長、何か言ってました？」
CLOUD	CLOUD
“Nope…”	「いや……」
Shera	シエラ
“Welcome home.”	「おかえりなさい」
CID	CID
“^%$#! Shera.	「ケッ！　シエラよう。
What are you, blind!?”	どうしてテメエはそんなに
	どんくせえんだよ！」
CID	CID
“We got guests!!	「客が来たら茶くらい
GET SOME TEA! ^%$#!”	出せよな、このウスノロ！」
Shera	シエラ
“I…I'm sorry.”	「ご、ごめんなさい」
CLOUD	CLOUD
“Really, don't mind us.”	「俺たちのことは気にしないでくれ」
CID	CID
“Shut up!	「うるせぇ！　ウダウダ言うな！
Sit your butts down in those chairs	客は、イスにすわって
and drink your goddamn TEA!”	おとなしくしてろ！」
CID	CID
“Arggggggh!	「あ～～っ！
DAMN, I'm pissed!”	ハラが立ってきた！」
BARRET	BARRET
“…Damn, man. Wassup with	「けっ、いけ好かねぇ野郎だ」
that guy's attitude?”	
AERIS	AERITH
“Sheesh!!	「むっか～～！！
What bad manners!”	たいど、悪いわよ」
TIFA	TIFA
“Poor Shera.”	「シエラさん、かわいそう」
RED XIII	RED XIII
“Who does he think he is?”	「なんてヤツだよ……！」
YUFFIE	YUFFIE
“Man, this sucks!”	「なんか、ヤなかんじ～！」
CAIT SITH	CAIT SITH
“Man, he sure seems wound up tight.”	「なんや、ごっつうキツい人やなぁ～」
VINCENT	VINCENT
“…”	「…………」
CLOUD	CLOUD
“Sorry.	「悪かったな。
It's our fault.”	俺たちのせいで」
Shera	シエラ
“No, no.	「とんでもない。
He's always like this.”	いつものことです」
Shera	シエラ
“Oh?”	「そうですか……」
CID	CID
“Shera!	「おい、シエラ！
I'll be in the backyard	オレ様はタイニー・ブロンコを整備しに
tunin' up Tiny Bronco!”	裏庭に行ってるからな！」
“An' make sure to	「客に茶ぁ、出しとけよ！！
serve them some tea!	わかったな！」
All right!?”	
BARRET	BARRET
“He always like this?	「いつもだって？
That's pretty bad!”	そりゃ、ひでえな！」
AERIS	AERITH
“Is it like this all the time?	「いつも？
You keep quiet even when	いつもあんなこと言われて
he's like that to you?”	だまってんの？」
TIFA	TIFA
“Is it always like this?	「いつものこと……」
“Why is CID so hard on you?”	「どうしてCIDはあなたに
	あんなにつらく当たるの？」
RED XIII	RED XIII
“I think it's a bit too harsh.”	「それはひどすぎると思う」
CAIT SITH	CAIT SITH
“Is he like this all the time?	「いっつも～？
Bitin' your head off like that?	いっつもあんなに
I could never stand it…”	ガーガー言われてますんか？
	たまらんなぁ……」
YUFFIE	YUFFIE
“What's his prob!?	「なんだよ、それ！？
I'm gonna go clean that guy's clock!!”	アタシならぶんなぐってやるよ！」
VINCENT	VINCENT
“…It's amazing that	「……よくたえてるな」
you can live with it.”	
Shera	シエラ
“No…	「いいえ……
It's because of	私がドジだからしょうがないんです」
my stupid mistake.”	
“I was the one	「私があの人の夢を
who destroyed his dream…”	つぶしてしまったから……」
CLOUD	CLOUD
“What happened?”	「なにがあったんだ？」
Shera	シエラ
“He pushed	「あの人は、私を助けるために
the Emergency Engine Shut Down switch,	エンジンの緊急停止スイッチを押したのです」
aborting the mission, to save my life.”	「それ以後、宇宙計画縮小が決まって
“After that, the Space Program was cut back	ロケット発射は中止になりました」
and the launch was canceled.”	「私のせいで、あの人の夢が
“It's my fault his dream was destroyed…”	逃げていったんです……」
Shera	シエラ
“That's why…it's all right.	「だから……いいんです。
I don't care what the Captain says,	艇長がどう思おうと、私はあの人に
I'll live my life for him.”	つぐなわなくてはなりません」
CID	CID
“Shera!	「シーエラッ！
You still haven't served 'em tea!”	ま～だ茶をだしてねえな！」
CID	CID
“Hurry up and sit down!	「ほれ、とっととすわれ！
Or ain't my hospitality good	オレ様のもてなしが
enough for you!?”	受けられねえってのか！」
CID	CID
“They're late…	「おそいな……
Where is Rufus?”	ルーファウスはよ」
Palmer	パルマー
“Hey-HEY! Long time no see!	「うひょ！　ひさしぶり！
So CID, how ya been?”	CIDちゃん、元気してた？」
CID	CID
“Well, if it ain't fat man, Palmer.	「よう、ふとっちょパルマー。
How long were you figurin' on	待ってたぜ！」
keepin' me waitin'!?”	
Palmer	パルマー
“Hey-hey!  I don't know.	「うひょひょ！　わし、知らないな～。
The President's outside,	外に社長がいるから聞いてみれば？」
so why don't you ask him?”	
CID	CID
“^$#&!	「ケッ！
Good for nothing, fat &$#$^@!”	あいかわらずの
	役立たずふとっちょめ」
Palmer	パルマー
“Don't say 'fat'!”	「ふとっちょって言うな～！」
Palmer	パルマー
“Hey-hey! Tea!”	「うひょ！　お茶だ！」
“Can I have some too?	「わしにもちょうだい。
With lotsa sugar and honey and…	サトウとハチミツたっぷりで
oh yeah, don't forget the lard!”	ラードも入れてね」
Palmer	パルマー
“Hey-hey?	「うひょひょ？
Have we met before?”	どこかで会ったかな？」
CID	CID
“So?	「で、いつなんだ？
When's the Space Program	宇宙開発計画の再開はよぉ？」
gonna start up again?”	
Shera	シエラ
“Is President Rufus here to announce	「ルーファウス社長が来たのは
that he's going to restart	宇宙開発を再開するためなのでしょうか？」
the Space Program?”	
Palmer	パルマー
“Hey-hey!	「うひょ！
Is the tea ready yet?”	お茶はまだかな～？」
“With plenty of sugar and honey.	「サトウとハチミツたっぷりで
Oh yeah,	ラードもどっさり入れてね。
and don't forget the lard, too.”	うひょひょ！」
CID	CID
“What the!?	「な、な、な、なんでい！
You got me all excited	期待させやがって！」
for nothing!?”	
CID	CID
“Then, what'd you come here for?”	「そんなら今日は何の用で来た？」
Rufus	ルーファウス
“I want to borrow	「タイニー・ブロンコを
the Tiny Bronco.”	返してもらおうと思ってな」
CID	CID
“&^#^%!	「ケッ！
First the Airship, then the Rocket,	最初は飛空艇、次はロケット
and now, the Tiny Bronco.”	こんどはタイニー・ブロンコか」
“Shinra took outer space away from me	「神羅カンパニーはオレ様から
and now you want to	宇宙を奪っただけでは足りずに
take the sky away from me too!?”	今度は空まで奪う気だな！」
Rufus	ルーファウス
“Oh my…”	「おやおや……」
“You seem to forget it was	「いままで、君が空を飛べたのは
because of Shinra, Inc.	神羅カンパニーのおかげだ。
that you were able to fly	それを忘れないでくれたまえ」
in the first place.”	
CID	CID
“What!?”	「なんだと！」
Shera	シエラ
“Uh, excuse me…”	「あ、あの、あなたたち……」
Shera	シエラ
“This way…”	「こちらへ……」
Shera	シエラ
“You wanted to use the Tiny Bronco,	「あなたたちタイニー・ブロンコを
right?”	使いたがっていましたよね」
Shera	シエラ
“I believe Palmer's going to take it.	「パルマーが持っていくそうです。
Why don't you talk to him?”	お話ししてみたら？」
Rufus	ルーファウス
“We're going after Sephiroth.	「我々はセフィロスを追っている。
But seems like we've been going	ただ、どうやら今まで見当違いの方向を
in the wrong direction.”	探していたようだ」
“But now,	「だが今はだいたい行く先が
we think we know where he's headed.	つかめてきたのでな。
But, we have to cross the ocean.	我々は海を越えなくてはならないんだ。
That's why we want your plane…”	それでお前の飛行機を……」
“What're you guys doin' here?”	「おまえたち、なんだ？」
CLOUD	CLOUD
“We heard the Captain was here.”	「艇長がここにいるって
	聞いてきたんだ」
“Captain?	「艇長だと？
I'm the Captain!”	艇長とはオレ様のことだ！」
CID	CID
“The name's CID.	「親からもらった名前はCID。
Everyone calls me 'Captain', though.”	みんなは艇長って呼ぶけどな」
CID	CID
“What d'ya want?”	「で、なんの用でい？」
Tell me about this rocket	このロケットのこと、教えて
Is Rufus coming?	ルーファウス、来るって？
Can we borrow the "Tiny Bronco"?	タイニー・ブロンコ、貸して
CID	CID
“Wow!	「おっ！　若いモンにしちゃ
Not bad for a kid.”	なかなか感心じゃねえか」
CID	CID
“Alright then,	「よし、ここはオレ様自ら
I'll explain it to you.”	説明してやることにしよう」
CID	CID
“You know Shinra developed	「長くてくだらない戦争中に
a lot of technological gadgets	神羅カンパニーがいろんな技術を
during the meaningless war, right?”	開発したのは知ってんだろ？」
“Now it's a Mako company,	「今は魔晄屋だが、むかしは
but in the old days it	兵器開発会社だったからな」
was a weapons manufacturer.”	
CID	CID
“Well,	「そんなかでよ、ロケットエンジンが
they came up with a Rocket Engine.”	できちまったんだ」
CID	CID
“There was so much excitement about	「こりゃ宇宙へ行けるってんで大騒ぎよ。
the thought of going into outer space.	夢はどんどん広がった」
Our dreams got bigger and bigger.”	
CID	CID
“They put a major budget into it	「予算もバカスカつぎこんで
and made prototype after prototype!	試作、試作、また試作！
Finally, they completed Shinra No. 26.”	で、完成したのが、この神羅２６号」
“They chose the best pilot in Shinra…	「パイロットには神羅一、いや世界一の
no, in the world--me.	ウデを持つオレ様が選ばれた。
I mean, come on.”	ま、当然と言えば当然だわな」
CID	CID
“And finally we get to the day of the launch.	「いよいよ迎えた打ち上げの日。
Everything was goin' well…”	何もかも上手くいってた」
CID	CID
“But, because of that dumb-ass Shera,	「ところがあのノロマのシエラのせいで
the launch got messed up.	打ち上げはおじゃん。
That's why they became so anal!”	それがケチのつきはじめよ」
CID	CID
“And so, Shinra nixed	「神羅は宇宙開発計画をすてやがった」
their outer space exploration plans.”	
“After they told me	「あれだけ、これからは宇宙だ！
how the future was Space Exploration	な～んて言って
and got my damn hopes up…DAMN THEM!”	希望持たせてやがったクセによっ！」
CID	CID
“Then, it was all over once they	「魔晄エネルギーが金になると
found out Mako energy was profitable.	わかったらもう終わりだ。
They didn't even so much as	宇宙計画なんて誰も見向きもしねえ」
look at space exploration.”	
CID	CID
“Money, moola, dinero!	「かね、金、カネだぁ？
My dream was just a financial	オレ様の夢をソロバンかんじょうだけで
number for them!”	ぼうにふるない！」
CID	CID
“Look at this rusted Rocket.	「見ろい……このサビだらけのロケットを。
I was supposed to be the first man	こいつで、オレ様は宇宙へ飛び出す
in space with this.”	最初の男になるはずだった」
CID	CID
“Everyday, it tilts a little bit more.”	「いまじゃ、毎日にちょこっとずつ
	かたむいてらあ」
“At this rate,	「このぶんだとコイツが倒れるのが先か
I don't know which'll be first,	オレ様がおっちぬのが
this thing falling over or	先かってくらいだ……」
me gettin' outta here.”	
CID	CID
“Yeah! It must be news about	「おう！　きっとよ、宇宙計画が
restarting the Space Program.”	再開されるって話にちげえねえ」
“A young President,	「やっぱり若い社長にかぎるぜ！
that's what we needed!	夢があっていいやね」
He still has dreams, too!”	
CID	CID
“You out of your *&$^$# mind!?	「な～にバカなこと言ってやがるんだ！
That's my most cherished possession.	あれは大切なもんなんだ。貸せねぇよ」
I can't let you take it.”	
CID	CID
“Ummm…	「ん～、そのへん
Just look around.”	適当に見て回ってな」
CID	CID
“My last hope is	「今回の、若社長が来るって話だけが
to talk to the President.”	オレ様に残された最後の望みさ……」
CID	CID
“Hey! Get your ass in gear!	「おら、そんなカメみたいに
You work like a snail!”	ちんたら仕事してるんじゃねえよ」
“Even the moon'd get tired	「お月さんがまちくたびれて
waitin' around for your ass!”	そっぽ向いちまうぜ！」
Shera	シエラ
“I'm…I'm sorry.”	「す、すみません」
CID	CID
“Don't take so much time checkin'	「そんな酸素ボンベなんかを
that *%$^# oxygen tank!”	いつまでもガチャガチャ
	チェックしてんじゃねえよ！」
“Shera, bein' careful's good,	「おいシエラよう、お前がマジメなのは
but no matter how many times	いいんだけどよ、そんな酸素ボンベ
you check that oxygen tank,	いくらチェックしてもムダだぜ」
it won't matter.”	
“That thing wouldn't break	「そんなもん、天地がひっくり返ったって
even if hell froze over.”	壊れやしねえんだから」
Shera	シエラ
“But…”	「え……でも」
CID	CID
“No buts!!”	「でももヘチマもねえ！！」
“You're not stupid,	「おめぇはバカじゃねぇんだから
so be more efficient!”	もちっと、手ぎわよくやれよ」
Shera	シエラ
“I'm sorry…”	「ごめんなさい……」
CID	CID
“Instrument panel…all clear.	「計器オールクリア。
Shinra No. 26, ready for launch.”	神羅２６号、発射準備よし」
Control	管制官
“Engine pressure rising.	「エンジン圧力上昇中。
Shinra No. 26, 3 minutes to launch.	神羅２６号、発射３分前。
Beginning countdown.”	カウントダウン開始」
CID	CID
“…Finally.”	「……いよいよだな」
CID	CID
“What the? What happened!?”	「な、なんだ？　何が起った！？」
Control	管制官
“CID!	「パイロット・CID
We have an emergency situation!”	緊急事態です！」
“A mechanic is still in the	「まだ船内のエンジン部に
engine section of the rocket!”	メカニックが残っています！」
CID	CID
“What!?	「何だって！？
Who is the little ^%$@!?”	どこのバカやろうだ？」
Control	管制官
“I don't know.	「わかりません。
Activating the intercom	エンジン部と音声つなぎます！」
in the engine section.”	
CID	CID
“Hey goddammit!!	「おい、コラ！！
Who the &%$#'s still in there?”	そんなところにいるのは
	どこのバカやろうだ！？」
Shera	シエラ
“It's Shera, Captain.	「艇長、私です、シエラです。
Don't mind me, go ahead with the launch.”	私にかまわず、打ち上げを行なって下さい」
CID	CID
“Shera!?	「シエラぁ！？
What are you still doin' in there!?”	いまごろ、なにしてやがんだ！」
Shera	シエラ
“I was still concerned.	「どうしても心配だったんです。
The results of the oxygen tank test	酸素ボンベのテストで満足いく結果が
weren't satisfactory.”	えられなくて」
CID	CID
“You stupid little $#^%!”	「バカやろう！」
“It's gonna get so hot in there that	「そこはなあ、打ち上げのとき
there ain't gonna be #$!%	うんこッカスも残んねぇほど
left when we blast off!”	バカ熱くなるんだ！」
“You're gonna be burnt to a crisp!	「そんなとこにいたら一瞬で黒コゲだぞ！
You're gonna die! You know that,	おまえ、死んじまうんだぞ。
doncha!?”	わかってんのか！」
Shera	シエラ
“I don't mind.”	「いいんです」
“If I can just fix this,	「これさえ直ればロケットは
the launch will be a success.	打ち上げできるんです。
I'm almost done.”	もう少しで終わりますから」
CID	CID
“Almost done!?	「何がもう少しだ！
You're gonna die!”	おまえ、死んじまうんだぞ！」
Control	管制官
“CID,	「CID、カウントダウン開始だ。
We must start the countdown.	もう、間に合わない！」
We won't make it if we don't!”	
Control	管制官
“What are you going to do, CID?	「どうするCID？
If we cancel now, it'll be another	ここで中止すれば、次の打ち上げまで
six months until the next launch!”	６ケ月もかかっちまうぞ！」
Control	管制官
“Starting engine!”	「エンジン始動する！」
CID	CID
“GODDAMMIT, Shera…	「くっ……
you wanna make me a murderer?”	シエラのヤロウめ……
	オレ様を人殺しにする気か？」
Shera	シエラ
“Tank Number 7 check is complete.	「７番ボンベまでチェック終わりました。
Once I complete Tank Number 8,	８番ボンベが終わればオールクリアです」
it's all clear.”	
CID	CID
“Oh man, the moon…outer space…	「ああ、月が……宇宙が……
my dreams…”	オレ様の夢が……」
Control	管制官
“Ignite Engine!”	「エンジン点火！」
Control	管制官
“15 seconds until ignition.	「エンジン点火まで１５秒。
Internal temperature rising.”	船内温度上昇中」
CID	CID
“SH-------#%!!”	「ンガーーーーーーッ！！」
“Captain!	「艇長！
Our dreams are finally coming true!”	いよいよ私たちの夢が
	かないますね！」
“We are so proud to be a part	「ボクたちもハナが高いですよ。
of the launch of Shinra No. 26.”	この神羅２６号の打ち上げに
	関われたなんて」
“All right, Captain!	「さあ、艇長！
Fly our dreams into outer space!”	私たちの夢を乗せて、宇宙へ！」
CID	CID
“Yeah! Leave it all to me!	「おう！　まかせとけ！
I'll be back in a few!”	ちょっくら、いってくるぜ！」
“We're praying for your safety!”	「ご無事をおいのりしています！」
“Captain, preparations are complete!	「艇長、整備はカンペキです！
All that's left is lift off!”	あとは、ゆくだけです！」
CID	CID
“Thanks, guys!”	「ありがとうよ、おめぇら！」
CID	CID
“Hey, wait a minute!	「お、おい、ちょっと待て！
Shera's still in here!”	まだシエラが残ってるんだぞ！」
Shera	シエラ
“Captain!”	「艇長！」
CID	CID
“Shera!?”	「シエラか！？」
Control	管制官
“30 seconds until ignition.	「エンジン点火３０秒前。
Beginning countdown.”	カウントダウンを開始する」
Control	管制官
“CID!	「CID！
Forget about her.	シエラの事はあきらめろ。
We won't make it in time!”	もう、まにあわない！」
CID	CID
“Come on, Shera…hurry up…	「シエラ……はやくしろ……
You're gonna die…”	このままじゃ死んじまうんだぞ……」
CID	CID
“What…what am I…	「オレは……オレ様は……
What am I supposed to do?”	オレはどうしたらいい……？」
CLOUD	CLOUD
“There's a Shinra logo on it.	「神羅のマークがついている。
Tiny Bronco…	タイニー・ブロンコか……
This is cool.”	いいな、これ」
BARRET	BARRET
“Shinra always keeps the	「神羅はよ、こういう便利な物は
best things for themselves.	絶対に独り占めしちまうんだよな。
Let's take it!”	いただいちまおうぜ！」
TIFA	TIFA
“I wonder if we can borrow it…”	「貸してもらえないかしら……」
AERIS	AERITH
“Let's take it, OK CLOUD?”	「もらっちゃお？　ね、CLOUD！」
RED XIII	RED XIII
“Will it fly?	「空を飛べるのかな？
Is it all right to just take it?”	勝手に乗っちゃマズイかな？」
CAIT SITH	CAIT SITH
“CLOUD!	「CLOUDさん！
If we steal it, we'll get in deep trouble!”	こんなもんとったら
	えらいことになるで！」
VINCENT	VINCENT
“…Want me to keep watch?”	「……見張っていようか？」
YUFFIE	YUFFIE
“CLOUD, let's steal it!	「CLOUD、盗もうよ！
I love stealing from the Shinra!”	神羅の物盗むのは大好きなんだ！」
“Um…may I help you?”	「あの……何か？」
CLOUD	CLOUD
“No…	「いや、なんでもないんだ。
We're just looking at it.”	見せてもらっていただけだ」
“…If you would like to use it,	「……もしそれが使いたいなら
please ask the Captain.	艇長に聞いて下さい。
The Captain should be in the rocket.”	艇長はきっとロケットのところに
	いると思います」
“I'm Shera.	「私、シエラといいます。
And what are your names?”	あなたたちは？」
CLOUD	CLOUD
“I'm CLOUD.”	「俺はCLOUDだ」
BARRET	BARRET
“I'm BARRET, of AVALANCHE.”	「アバランチのBARRETだ」
TIFA	TIFA
“TIFA. Nice to meet you.”	「TIFA。　よろしくね」
AERIS	AERITH
“I'm AERIS.”	「わたし、AERITH」
RED XIII	RED XIII
“Nanaki,	「ナナキ、またの名をRED XIII」
otherwise known as RED XIII.”	
CAIT SITH	CAIT SITH
“Fortune telling machine	「占い屋、CAIT SITHいいます」
CAIT SITH, here.”	
VINCENT	VINCENT
“VINCENT.	「VINCENT。
I am…nevermind.”	仕事は……まあ、いいだろう」
YUFFIE	YUFFIE
“I'm YUFFIE!”	「アタシ、YUFFIE！」
Shera	シエラ
“Hmm…	「はぁ……
So you're not with the Shinra?”	神羅の人たちじゃないんですね」
“I thought you were bringing approval	「私、宇宙開発再開の知らせが
for the Space Program.”	きたのかと思って」
CLOUD	CLOUD
“…!?”	「……！？」
Shera	シエラ
“President Rufus is scheduled to come here.	「新社長のルーファウスさんが
The Captain's been so restless all morning.”	ここへいらっしゃるそうなんです。
	艇長は朝からそわそわしてますわ」
CLOUD	CLOUD
“Rufus!!?”	「ルーファウスが！！」
Palmer	パルマー
“Hmm…	「うひょ……
Why do I have to do this…?	なんでわしがこんなこと……
I'm the head of the Space Program…”	わし、宇宙開発部門統括……」
Palmer	パルマー
“I've seen you somewhere before…”	「お前らどこかで見たな……」
Palmer	パルマー
“I know! The Shinra building!	「そうだ！　神羅ビル！
When the President was killed! Ulp!”	プレジデントが殺されたときだ！
	うひょ！」
CLOUD	CLOUD
“We'll be taking the Tiny Bronco.”	「そのタイニー・ブロンコは
	俺たちがもらう」
Palmer	パルマー
“Se…se…security!!”	「け、け、け、警備兵！！」
BARRET	BARRET
“I can't stop it!”	「とまらねえぜ！」
AERIS	AERITH
“I can't stop it!”	「とまらないの！」
TIFA	TIFA
“I can't stop it!”	「とまんないっ！」
RED XIII	RED XIII
“It's taking off.”	「とびあがっちゃうよ」
CAIT SITH	CAIT SITH
“No! It's taking off!”	「あかん！とんでまう！」
YUFFIE	YUFFIE
“No!! It's gonna take off!”	「ダメ！！とんじゃう！」
VINCENT	VINCENT
“I can't stop…”	「とまらないな……」
CLOUD	CLOUD
“Forget it! Get in!!”	「かまうな！　のりこめ！！」
CLOUD	CLOUD
“All right, here we go!”	「よし、出発だ！」
BARRET	BARRET
“Gimme that!”	「オレにやらせろ！」
AERIS	AERITH
“I want to try it!”	「わたし、やってみたい！」
TIFA	TIFA
“I wanna try!”	「私にやらせて！」
RED XIII	RED XIII
“Leave it to me.”	「オイラにまかせて」
CAIT SITH	CAIT SITH
“Let me handle it.”	「ボクにまかせて～な」
YUFFIE	YUFFIE
“Let me be the pilot!”	「アタシにパイロットやらせて！」
VINCENT	VINCENT
“I'll do it.”	「私の出番だな」
CLOUD	CLOUD
“CID! Get on!”	「CID！　乗ってくれ！」
CID	CID
“Godammit!	「バカやろう！
What are you amateurs doing!”	シロウトが何やってんだよ！」
Rufus	ルーファウス
“CLOUD!?	「CLOUD！？
Don't let 'em get away!	逃がすな！　撃ちおとせ！」
Shoot 'em down!”	
CID	CID
“%#^@!!	「シィィーット！！
The tail's been hit!”	尾翼がやられてるじゃねえか！」
CLOUD	CLOUD
“Emergency landing…”	「不時着か……」
CID	CID
“This's gonna be a big splash.	「さあ、でっけぇ衝撃がくるぜ。
Hold on to your drawers	チビらねえようにパンツをしっかりおさえてな！」
and don't piss in 'em!”	
CID	CID
“She won't fly anymore.”	「こいつはもう飛べねえな」
CLOUD	CLOUD
“Can't we use it as a boat?”	「ボートのかわりに使えるんじゃないか？」
CID	CID
“$#&%! Do whatever you want!”	「ケッ！　好きにしろい！」
CLOUD	CLOUD
“CID,	「CID、あんたはこれから
what will you do now?”	どうするんだ？」
CID	CID
“I dunno.	「さあな。
I'm history with the Shinra	神羅とはきれちまったし
and I've given up on that town.”	村はあきちまった」
CLOUD	CLOUD
“How about your wife? Shera?”	「奥さんは？　シエラはいいのか？」
CID	CID
“Wife? Don't make me laugh!	「奥さん？　笑わせるない！
Just thinkin' 'bout marryin'	シエラが女房だなんてトリハダがたつぜ」
her gives me the chills.”	
CID	CID
“What're you guys gonna do?”	「おまえらはどうすんだ？」
CLOUD	CLOUD
“We're going after a man named Sephiroth.	「セフィロスという男を追っている。
We'll have to get Rufus	神羅のルーファウスも
of the Shinra someday too.”	いつか倒さなくちゃならない」
CID	CID
“I don't know about any of that, but…”	「なんだかわからねえが……」
CID	CID
“What the hell!?	「おもしろそうじゃねえか！
Sign me up!”	オレ様も仲間に入れろ！」
CLOUD	CLOUD
“How 'bout it, everyone?”	「みんな、どうだ？」
BARRET	BARRET
“I don't care.”	「かまわないぜ」
TIFA	TIFA
“Of course, no problem!”	「もちろん、いいわよ」
AERIS	AERITH
“I'm all for it.”	「さんせい、よ」
RED XIII	RED XIII
“I don't really care.”	「オイラはかまわないよ」
CAIT SITH	CAIT SITH
“I don't mind.”	「かまへんのと、ちゃいますか」
YUFFIE	YUFFIE
“Whatever!”	「いいんじゃないの～」
VINCENT	VINCENT
“…Do whatever you like.”	「……好きにしろ」
CID	CID
“Glad to be aboard, numbskulls!”	「よろしくな、クソッタレさんたちよ」
CLOUD	CLOUD
“Numbskulls…?”	「クソッタレ……」
CID	CID
“Yeah. Anyone stupid enough to go up against	「この時代、神羅にさからおうなんて
Shinra nowadays, has GOTTA be a numbskull!	バカヤロウのクソッタレだ！
I like it!”	気に入ったぜ！」
CID	CID
“So, where we headed?”	「で、どこへ行くんだ？」
“Rufus was goin' after Sephiroth to	「ルーファウスのヤツはセフィロスを追って
the Temple of the Ancients.”	【古代種の神殿】に行くってほざいていたが」
CLOUD	CLOUD
“Really!?…Where is it?	「本当か？！……どこだ？
That Temple of the Ancients?”	その【古代種の神殿】っていうのは？」
CID	CID
“Dunno. That numbskull kid was tellin' me	「さあな。あのクソむすこは
he was headin 'The wrong direction'…	『見当違いの方向』って言ってたから
so maybe it's off this way?”	ここからかなり離れた所じゃないのか？」
CLOUD	CLOUD
“Let's just head for land and	「情報をとるためにとにかく陸地をさがそう。
get some information.	【古代種の神殿】……
Temple of the Ancients…	気になる名前だな……」
that name bothers me.”	
YUFFIE	YUFFIE
“…Hm.	「…………エヘ。　西へ行くっての、どう？」
How 'bout goin' west?”	
“No, no reason.	「ぜ～んぜん理由なんかないけどね。
NO reason at all!”	もう、ぜ～んぜん！」